------------------------------------------------------------------------------------------------------------------------------------------------------
------------------------------------------------------------------------------------------------------------------------------------------------------
------------------------------------------------------------------------------------------------------------------------------------------------------
------------------------------------------------------------------------------------------------------------------------------------------------------
------------------------------------------------------------------------------------------------------------------------------------------------------
------------------------------------------------------------------------------------------------------------------------------------------------------
------------------------------------------------------------------------------------------------------------------------------------------------------
------------------------------------------------------------------------------------------------------------------------------------------------------
-----------------------------------------------------------%------------------------------------------------------------------------------------------
-------------------------------------------%---------%%----|--------------------%---------------------------------------------------------------------
-------------------------------------------|---------||----|-----------------S--|-----------------------------%---------------------------------------
-----------------------------------------%S|---------||----|--------------------|-----------------------------|---------%-----------------------------
-----------------------------------------|-|--%%-----||----|----------------%---|%%---------------------------|----%%---|-----------------------------
---------%--------------------------G----|-|--||%%%%%||%%%-|%%%%%%%%%-%%%%--|-%-|||-------------------%%%-%%--%-%--||---|---%%%%%%%%%%-%-%%-%---%-%--%
%%%%%%%%%|-----%%%%%----------------%-%-%|-|--||||||||||||-||||||||||-||||--|%|%|||-----%%----------%%|||-||-%|-|--||--%|-%%||||||||||-|-||-|%--|-|--|
||||||||||-----|||||X-XXXX--XXXXXXXX|X|X||X|--||||||||||||-||||||||||X||||-X|||||||XXXXX||XXXXXXXXXX|||||X||X||X|XX||X-||X||||||||||||X|X||-||--|-|XX|