------------------------------------------------------------------------------------------------------------------------------------------------------
------------------------------------------------------------------------------------------------------------------------------------------------------
------------------------------------------------------------------------------------------------------------------------------------------------------
------------------------------------------------------------------------------------------------------------------------------------------------------
--------------------------------------------------------------------------------------------------------------------------------D---------------------
------------------------------------------------------------------------------------------------------------------------------------------------------
------------------------------------------------------------------------------------------------------------------------------------------------------
------------------------------------------------------------------------------------------------------------------------------------------------------
------------------------------------------------------------------------------------------------------------------------------%-%---------------------
------------------------------------------------------------------------------------------------------------------------------|-|---------------------
------------------------------------------------------------------------------------%-----------------------------------------|-|--------------%------
-------------------------------------------------------t----------------------------|------------------%%%%%%--%-----C--------|-|--------------|------
-----------%%%%%%---%%-%%%-%---------%--%%%%%----------t-----------------------%%%-%|------------------||||||-%|------%--%-%%-|-|--------------|-%---%
-----------||||||%%-||-|||-|-%-------|--|||||%---%%%---t%%---------------------|||-||------------------||||||-||%-----|--|-||-|-|--------%-----|-|---|
%%%%%%%%%--||||||||%||-|||-|%|-------|--||||||--%|||%%%%||---------------%%%%%-|||-||------------------||||||-|||-----|--|-||-|%|--------|-----|-|-%%|
|||||||||XX|||||||||||-|||X|||XXXXXXX|XX||||||XX||||||||||-X-XX---XXX-XXX|||||X|||X||XX-XX--XXXXXXXXXXXXXXXXXX|X|XX--X|XX|X||X|||XXXXXXXX|XXXXX|X|-|||