------------------------------------------------------------------------------------------------------------------------------------------------------
------------------------------------------------------------------------------------------------------------------------------------------------------
------------------------------------------------------------------------------------------------------------------------------------------------------
------------------------------------------------------------------------------------------------------------------------------------------------------
------------------------------------------------------------------------------------------------------------------------------------------------------
------------------------------------------------------------------------------------------------------------------------------------------------------
------------------------------------------------------------------------------------------------------------------------------------------------------
-----------------------------------------------------------------------------------------D------------------------------------------------------------
------------------------------------------------------------------------------------------------------------------------------------------------------
------------------------------------------------------------------------------------------------------------------------------------------------%%----
-----------------------------------------------------------------------------------------%---------------------------------%--------------------||----
-------------------------------------------------------------------g---------------------|---------------------------------|--------------------||----
---------%-------------------------------------------------------------------------------|------------------------%%%---%%-|---------%--%-------||%---
---------|%%%%%%%%%%%--%%%%%%%----------------------------%---%-----%%%%%%%--------------|--%---------------------|||---||-|---------|--|-------|||-%%
%%%%%%%%%||||||||||||--|||||||------------%-----%%%%%%-%%-|-%%|%%---|||||||----------%%%-|--|------%---%----------|||---||-|-----%--%|--|-------|||-||
|||||||||||||||||||||XX|||||||XXXXXXXXXXXX|XXXXX||||||X||X|X|||||XXX|||||||XXXX-XXXXX|||-|XX|----XX|X--|XX----XX-X|||XXX||X|XXXXX|XX||XX|X--XXXX|||X||