------------------------------------------------------------------------------------------------------------------------------------------------------
------------------------------------------------------------------------------------------------------------------------------------------------------
------------------------------------------------------------------------------------------------------------------------------------------------------
------------------------------------------------------------------------------------------------------------------------------------------------------
------------------------------------------------------------------------------------------------------------------------------------------------------
------------------------------------------------------------------------------------------------------------------------------------------------------
------------------------------------------------------------------------------------------------------------------------------------------------------
---------------------------------------------------%--------------------------------------------------------------------------------------------------
---------------------------------------------------|--------------------------------------------------------------------------------------------------
---------------------------------------------------|----------------%---------------------------------------------------------------------------------
-------------------------S-------------------------|----------------|-----------%---------------------------------------------------------------------
---------------------------------------------------|----------------|-----------|---------------------------------------------------------------------
--------%%%------%%%---%%-----------%%-------------|-----%------%%--|-----%----%|%--%%----%-%%%-------%%%------%----------------------%%%%%---%%%%%---
--------|||------|||---||%%-%------%||---%%%%%%%%--|%%%--|------||--|-----|--%-|||--||----|-|||-------|||------|%------%-----%--------|||||---|||||---
%%%%%%%%|||-%-%%-|||---||||-|%--%%%|||--%||||||||--||||--|-%----||--|---%%|%%|%|||%%||-%--|%|||-------|||-%%%%%||------|-----|--------|||||---|||||---
|||||||||||X|-||X|||XXX||||X||-X||||||XX|||||||||X-||||XX|X|XXXX||X-|XXX||||||||||||||X|--|||||XXXXXXX|||X|||||||XXXXXX|----X|XX-XXXXXXXX||XXX|||||XXX