------------------------------------------------------------------------------------------------------------------------------------------------------
------------------------------------------------------------------------------------------------------------------------------------------------------
------------------------------------------------------------------------------------------------------------------------------------------------------
------------------------------------------------------------------------------------------------------------------------------------------------------
------------------------------------------------------------------------------------------------------------------------------------------------------
------------------------------------------------------------------------------------------------------------------------------------------------------
------------------------------------------------------------------------------------------------------------------------------------------------------
------------------------------------------------------------------------------------------------------------------------------------------------------
------------------------------------------------------------------------------------------------------------------------------------------------------
-------------------------------------------------%----------------------------------------------------------------------------------------------------
-------------------------------------------------|-------------------%--------------------------------------------------------------------------------
-------------------------------------------------|-------------------|-------------------K----------------------------------------------%-------------
------------------------------------------------%|-------------------|------%%%-%%%------%%-------------------------------%%%%%%%--%----|------------%
------------------------------------------------||-----%%%-----%-----|%-----|||%|||%%-%--||%%-%------%----%%%%%%----------|||||||--|----|------------|
%%%%%%%%%%%%%%%%%---%-%-----------%-------%%----||--%%-|||-----|-%%--||-----|||||||||-|--||||-|-----%|----||||||----------|||||||--|----|------%%-%%-|
|||||||||||||||||--X|X|XXXXXXXXXXX|XXXXXXX||XXXX||-X||-|||XXXXX|X||XX||-XXXX|||||XX||X|-XXX||X|XXXX-||----||||||XXXXXXXXXX||X||||--|XXXXXXXXXXX||X||-|