------------------------------------------------------------------------------------------------------------------------------------------------------
------------------------------------------------------------------------------------------------------------------------------------------------------
------------------------------------------------------------------------------------------------------------------------------------------------------
------------------------------------------------------------------------------------------------------------------------------------------------------
------------------------------------------------------------------------------------------------------------------------------------------------------
------------------------------------------------------------------------------------------------------------------------------------------------------
---------------------------------------------------------------------------------------------------------------------------%--------------------------
---------------------------------------------------------------------------------------------------------------------------|--------------------------
---------------------------------------------------------------------------------------------------------------------------|--------------------------
------------------------------------------------------------------------------%----t--------------------------------%------|--------------------------
------------------------------------------------------------------------------|----t--------------------------------|------|--------------------------
------------------------------------------------------------------------%-----|----t--------------------------------|------|--------------------------
-----------------------------------%-------------%%%-----%%%--%---------|-----|----%--------------------------------|------|--------------------------
--------%------------------------%-|--%%-%--%%-%%|||-----|||--|---------|%----|----|-------%--%%----%%%------%%-----|-%----|-----------#--------------
%%%%%%%%|%%%%%-------------------|-|--||-|--||-|||||-----|||--|---------||----|----|-------|--||----|||%%%%%-||%%%%%|%|%--%|-----%----%%-%%---%%---%%-
||||||||||||||XXXXXXXXXXXXXXXX--X|X|XX||XXXXXX-XX|||XXXX-|||XX|XXXXXXXXX|XXXXX|XXXXXXX---X-|X-||XXXX||||||||-|||||||||||XX||XXXXX|--XX||-||XXX||---||X