------------------------------------------------------------------------------------------------------------------------------------------------------
------------------------------------------------------------------------------------------------------------------------------------------------------
------------------------------------------------------------------------------------------------------------------------------------------------------
------------------------------------------------------------------------------------------------------------------------------------------------------
------------------------------------------------------------------------------------------------------------------------------------------------------
------------------------------------------------------------------------------------------------------------------------------------------------------
------------------------------------------------------------------------------------------------------------------------------------------------------
---------------------------------------------------------------------------------------------------------------------------------S--------------------
------------------------------------------------------------------------------------------------------------------------------------------------------
------------------------------------------------------------------------------------------------------------------------------------------------------
---------------------------------------------------------------------------------------------------------------------------------%--------------------
------------------------------------------------------------------%--%--------------------------------------%--------------------|--------------------
---------------------------------------------------------%--------|--|----%%-%%--%---%%%%-----------%-------%--------------------|-------%---%%%%%---%
-----------------%-----------%---%%----------------------|--------|--|----||-||--|--%||||--%-%%%%%%%|-%%%%%%|%-%%%%%%%-----------|-------|---|||||%%%|
%%%%%%%%%%%%%%%%%|-----------|-%-||%-%---%%%%%%----------|--------|--|----||-||--|--|||||--|-||||||||-||||||||-|||||||----------%|-------|---|||||||||
||||||||||||||||||XXXXXXXXXXX|X|X|||X|X--||||||-----XXXXX|XXXXXXXXXXXXXXXX||XXXXX|XX|||||XX|X|||||||XX||||||X|X|||||||XXXX-XX-XX||---XXX-|---|||||||||