------------------------------------------------------------------------------------------------------------------------------------------------------
------------------------------------------------------------------------------------------------------------------------------------------------------
------------------------------------------------------------------------------------------------------------------------------------------------------
------------------------------------------------------------------------------------------------------------------------------------------------------
------------------------------------------------------------------------------------------------------------------------------------------------------
------------------------------------------------------------------------------------------------------------------------------------------------------
------------------------------------------------------------------------------------------------------------------------------------------------------
------------------------------------------------------------------------------------------------------------------------------------------------------
------------------------------------------------------------------------------------------------------------------------------------------------------
----------------%-------------------------------------------------------------------------------------------------------------------------------------
----------------|----%--------------------------------------------------------------------------------------------------------------------------------
----------------|----|---------------------------------------------------------------------------------------------------------------%-S--------------
----------------|%---|G--------------------------------------------------------------------------------------------------%%%---------|%---------------
----------------||---|%------------------------------------%%------------------------------------------------------------|||---------||---------------
%%%%%%%%%%%-----||---||--------%%%-%-%%%%------------------||----------%%-----------------------------------------%F%---%|||---------||%--------------
|||||||||||-XXXX||XXX||XXXXX-X-|||X|X||||XXXXXXXXXXXXXXXXXX||XXXXXXXXXX||XXXXXXXXXXXXXXXXXXXXXXXXXXXXXXXXX--XXXXXX|X|XXX||||XXXXXXXXX|||XXXXXXXXXXXXXX