------------------------------------------------------------------------------------------------------------------------------------------------------
------------------------------------------------------------------------------------------------------------------------------------------------------
------------------------------------------------------------------------------------------------------------------------------------------------------
------------------------------------------------------------------------------------------------------------------------------------------------------
------------------------------------------------------------------------------------------------------------------------------------------------------
------------------------------------------------------------------------------------------------------------------------------------------------------
------------------------------------------------------------------------------------------------------------------------------------------------------
---------------------------------------------------------------------------%--------------------------------------------------------------------------
------------------------%--------------------------------------------------|--------------------------------------------------------------------------
------------------------|-------------------------------------------%------|--------------------------------------------------------------------------
------------------------|-------------------------------------------|------|--------------------------------------------------------------------------
-----------------G------|-------------------------------------------|------|--------------------------------------------------------------------------
-----------------%------|-------------------------------%-----------|------|----------------%-%%%----%%%--%%%%%----------------------------------%----
---------------%-|------|--------%-%%----%--------------|-----------|------|-%---%%%%%%%%%--|-|||----|||--|||||----------------------------------|%%--
%%%%%%%%-------|-|------|--------|-||%%--|-------------%|---%-------|------%-|---|||||||||%-|-|||----|||-%|||||-------%--------------------------|||%-
||||||||XXXXXXX|XXXXXXXX|XXXXXXXXXXXX||XX|--XXXXXXXXXXX||-XX|XXXXXXX|XXXXXX|X|XXX||||||||||-|X|||XXXX|||X||||||XXXXXXX|XXXXXXXXXXXXXXXXXXXXXXXXXX||||X