------------------------------------------------------------------------------------------------------------------------------------------------------
------------------------------------------------------------------------------------------------------------------------------------------------------
------------------------------------------------------------------------------------------------------------------------------------------------------
------------------------------------------------------------------------------------------------------------------------------------------------------
------------------------------------------------------------------------------------------------------------------------------------------------------
------------------------------------------------------------------------------------------------------------------------------------------------------
------------------------------------------------------------------------------------------------------------------------------------------------------
------------------------------------------------------------------------------------------------------------------------------------------------------
----------------------------------------------%--------------------------k----------------------------------------------------------------------------
----------------------------------------------|--------------------------%----------------------------------------------------------------------------
----------------------------------------------|--------------------------|----------------------------------------------------------------------------
------------------------------------------%---|--------------------------|----------------------------------------------------------------------------
------------------------------------------|---|--%%---------------------%%%%%%%%----------------------------------------%-%---%%%%%%-%%---------------
---------%%%%%---%------------%%%%--------|---|--||---------------------||||||||----------------------%----------%------|-|---||||||-||---------------
%%%%%%%%%|||||--%|------------||||--------|---|%%||%%%%%%%%%%%%%%%-----%||||||||----------------------|-----%----|%-----|%|---||||||-||-%--%----------
||||||||||||||XX||XXX-XXX-XXXX||||-XXXXXXX|XX-||||||||||||||||||||XXXXX|||||||||--XXXXXXXXXXXX-XXXXXXX|XXX--|XXXX||XXXXX|||---||||||X||X|XX|XXXXX-X-XX