------------------------------------------------------------------------------------------------------------------------------------------------------
------------------------------------------------------------------------------------------------------------------------------------------------------
------------------------------------------------------------------------------------------------------------------------------------------------------
------------------------------------------------------------------------------------------------------------------------------------------------------
------------------------------------------------------------------------------------------------------------------------------------------------------
------------------------------------------------------------------------------------------------------------------------------------------------------
------------------------------------------------------------------------------------------------------------------------------------------------------
------------------------------------------------------------------------------------------------------------------------------------------------------
------------------------------------------------------------------------------------------------------------------------------------------------------
------------------------------------------------------------------------------------------------------------------------------------------------------
-----------------------------------------%%%--%%------------------------------------------------------------------------------------------------------
-----------------------------------------|||%%||-----------------------------------------------------------------------------%------------------------
----------%-%----%------------------%----|||||||----------------------------------------%-------------------------------%-%--|----------%-------------
----------|-|%---|%%%---%%%----%%%--|----|||||||--%----------%--------------------------|---------------------%%%%%-----|%|%-|%%%%-%---%|%%%%%%%%%%%%%
%%%%%%%%%%|-||---||||--%|||-%--|||--|----|||||||--|----------|-%-----%-----------------%|-------------%-------|||||---%-||||-|||||-|---|||||||||||||||
|||||||||||-||XXX||||XX||||X|--|||XX|XXXX|||||||XX|XXXXXXXXXX|X|XXXXX|XXXXXXX-XXXXXXXXX||XXXXXXXXXXXXX|XXX----|XXXXXXX|X||||XX||||X|X-XX||||||||||||||