------------------------------------------------------------------------------------------------------------------------------------------------------
------------------------------------------------------------------------------------------------------------------------------------------------------
------------------------------------------------------------------------------------------------------------------------------------------------------
------------------------------------------------------------------------------------------------------------------------------------------------------
------------------------------------------------------------------------------------------------------------------------------------------------------
---------------------------D--------------------------------------------------------------------------------------------------------------------------
---------------------------------------------------%--------------------------------------------------------------------------------------------------
---------------------------------------------------|--------------------------------------------------------------------------------------------------
---------------------------------------------------|--------------------------------------------------------------------------------------------------
---------------------------%-----------------------|-------------C---------------------------%--------------------------------------------------------
---------------------------|-----------------%-----%-----------------------------------------|---------------------------------%----------------------
------------%--------------|-----------------|-----|-----%-----------------------------------|---g-----------------------------|----------------------
------------|--------%----%|---------------%-|-----|----%|%%-%%%%----%%%---------------------|---|-----------------%--------%--|-%-------------------%
---------%--|--------|%---||---G-----------|-|-----|----||||-||||%%--|||-%%%%%----%%%%%------|---|----------------%|%%%%%---|%%|-|%%%%-%%%-%%%---%---|
%%%%%%%%%|%-|----%---%%-%-||---%-----%%%---|-|-----|----||||-||||||--|||-|||||----|||||------|---|----------------|||||||---||||-|||||-|||-|||---|--%|
|||||||||||-XX-XX|XXX||-|X||XXX|XXXXX|||XXX|X|XXXXX|XXXX||||X||||||--|||X|||||----|||||---XXX|XXXXXXXXXXXXXXXXXXXXX||||||XXX||||-|||||X|||-|||XXX|--||