------------------------------------------------------------------------------------------------------------------------------------------------------
------------------------------------------------------------------------------------------------------------------------------------------------------
------------------------------------------------------------------------------------------------------------------------------------------------------
------------------------------------------------------------------------------------------------------------------------------------------------------
------------------------------------------------------------------------------------------------------------------------------------------------------
------------------------------------------------------------------------------------------------------------------------------------------------------
----------------------------------------------------------------------------------------------------------------------C-------------------------------
---------------------------------%----------------------------------------------------------------------------------------------------------------%---
---------------------------------|----------------------------------------------------------------------------------------------------------------|---
---------------------------------|----------------------------------------------------------------------------------------------------------------|---
---------------------------------|------------------%-----------------------------------------------------------------%---------------------------|---
---------------------------------|------------------|-----------------------------------------------------------------|---------------------------|---
---------------------------------|-----------------%|-----------%-----%-----------------------------------------------|---------------------------|---
---------------------------------|----%------------||-%------%-%|----%|----------------------------------------------%|----------------%-%%%%%%%%%|---
%%%%%%%%%%%%%%%%%%%%%%-%%%%%%%%%%|----|---------%--||-|------|%||----||----------------------------------------------||----------------|%||||||||||---
||||||||||||||||||||||X|||||||||||XXXX|XXXXXXXXX|XX||X|X-XXXX||||XXXX||XXXXXXXXXXXXXXXXXXXXXXXXXXXXXXXXXXXXXXXXXXXXXXX|XXXXX-XXXXXXXX-X||||||||||||XXX