------------------------------------------------------------------------------------------------------------------------------------------------------
------------------------------------------------------------------------------------------------------------------------------------------------------
------------------------------------------------------------------------------------------------------------------------------------------------------
------------------------------------------------------------------------------------------------------------------------------------------------------
------------------------------------------------------------------------------------------------------------------------------------------------------
------------------------------------------------------------------------------------------------------------------------------------------------------
------------------------------------------------------------------------------------------------------------------------------------------------------
----------------------------%-------------------------------------------------------------------------------------------------------------------------
----------------------------|-------------------------------------------------------------------------------------------------------------------------
---------------------%------|-------------------------------------------------------------------------------------------------------------------------
---------------------|------|-------------------------------------------------------------------------------------------------------------------------
---------------------|------|------------------------------------%-----------------------------------C-------------------------%----------------------
---------------------|------|----------------------------%%%-----|-------------------------------------------------------------|%--------------%%-----
----------%-----%%%%%|-%----|----------%-----------%----%|||%----|---------------------%%--%%-------------%-------------%%%%---%|--------------||-----
%%%%%%%%%%|%%%%%||||||%|---%|----------|-----------|----|||||%%--|-%--%%%%%------------||--||-------------|%%-----------||||--X%|------------%%||-%---
||||||||||||||||||||||||XXX||XXXXXXXXXX|XXXXXXXXXXX|X-XX|XXX|||XX|-|XX|||||XXXXXXXXXXXX||XX||XXXXXXXXXX-XX|||-XXXXXX-XXXXXXXX-X||XXXXXXXXXXXX||||X|--X