------------------------------------------------------------------------------------------------------------------------------------------------------
------------------------------------------------------------------------------------------------------------------------------------------------------
------------------------------------------------------------------------------------------------------------------------------------------------------
------------------------------------------------------------------------------------------------------------------------------------------------------
------------------------------------------------------------------------------------------------------------------------------------------------------
------------------------------------------------------------------------------------------------------------------------------------------------------
------------------------------------------------------------------------------------------------------------------------------------------------------
------------------------------------------------------------------------------------------------------------------------------------------------------
------------------------------------------------------------------------------------------------------------------------------------------------------
------------------------------------------------------------------------------------------------------------------------------------------------------
---------------------------------------------------------------------------------------------%%---------------------------%---------------------------
---------------------------------------------------------------------------------------------||-------------------%-------|---------------------------
-----------%%%----%%--------------%--%-------------------------------------------------------||---%%%--%%%%%%%%---|-------|-----------%---------------
-----------|||----||%%%-----------|-%|-----------------------------------------%----%%%%----%||---|||--||||||||-%-|-------|-------%%%-|%--------------
%%%%%%%%%%-|||%%%%|||||------%%%--|-||---------------%%------%-----------------|----||||---%|||---|||--||||||||%|%|%%%----|%----%-|||-||--------------
||||||||||X||||||||||||---XXX|||--|-||-XXXXXXXXXXXX--||-XXXXX|X--XXXXXXXXXX-XXX|XXXX||||XXX||||XXX|||--|||||||||||||||XXXX||XXXX|X|||X|XXXXXXXXXXXXXXX