------------------------------------------------------------------------------------------------------------------------------------------------------
------------------------------------------------------------------------------------------------------------------------------------------------------
------------------------------------------------------------------------------------------------------------------------------------------------------
------------------------------------------------------------------------------------------------------------------------------------------------------
------------------------------------------------------------------------------------------------------------------------------------------------------
------------------------------------------------------------------------------------------------------------------------------------------------------
------------------------------------------------------------------------------------------------------------------------------------------------------
------------------------------------------------------------------------------------------------------------------------------------------------------
------------------------------------------------------------------------------------------------------------------------------------------------------
--------------------------------------%---------------------------------------------------------------------------------------------------------------
--------------------------------------|---------------------------------------------------------------------------------------------------------------
-------------------------------%------|---------------------------------------------------------------------------------------------------------------
------------------------------%|------|-----------------%------------------------%--------------------------------%-----------------%%----------------
------------------------------||------|--%-------------K|------%%----------------|-------------------------------%|------%%%-%---%%%||%%----%%%------%
%%%%%%%%%-------------%-------||------|--|-------------%|------||-------------%%%|-%%%%%%%%%%%%%-----------------||------|||-|---|||||||%%%%|||%%%%%%|
|||||||||XXXXXXXXXXXXX|XXXXXXX|XXXX-XX|XX|XXXXXXXXXXXXX||XXXXX-||XXXXXXXXXXXXX||||X|||||||||||||XXXXXXXX-XXXXXXXX||XXXXXX|||-|X--|||||||||||||||||||||