------------------------------------------------------------------------------------------------------------------------------------------------------
------------------------------------------------------------------------------------------------------------------------------------------------------
------------------------------------------------------------------------------------------------------------------------------------------------------
------------------------------------------------------------------------------------------------------------------------------------------------------
------------------------------------------------------------------------------------------------------------------------------------------------------
------------------------------------------------------------------------------------------------------------------------------------------------------
------------------------------------------------------------------------------------------------------------------------------------------S-----------
------------------------------------------------------------------------------------------------------------------------------------------------------
------------------------------------------------------------------------------------------------------------------------------------------------------
------------------------------------------------------------------------------------------------------------------------------------------------------
-------------------------------------%--------------------------------------------------%-------------------------------------------------%-----------
-------------------------------------|------------------------%%-----------------------%|-------------------------------------------------|-----------
-------------%----------------------%|-----------%-%----------||-------%%%%%----%%---%%||----%-----------------------------%%-------------|-----------
-------------|-----%%%%--%%%%%%-%F-%||-%---------|-|----------||------%|||||%%%%||%%%||||----|------------%---%%%----------||--%%%%-------|----%%%-%%-
%%%%%%%%-----|-----||||--||||||-|%%|||%|%%%%%%%%-|%|---%------||%----%||||||||||||||||||%%%%%|-%%%%-------|---|||----------||--||||%%%%%--|----|||-||-
||||||||XXXXX|XXXXX||||XX||||||X||||||||||||||||X|||XXX|XXX--X|||----|||||||||||||||||||||||||-||||XXXXXXX|---|||XXXX-XXXXX||XX|||||||||--|-XXX|||-||-