------------------------------------------------------------------------------------------------------------------------------------------------------
------------------------------------------------------------------------------------------------------------------------------------------------------
------------------------------------------------------------------------------------------------------------------------------------------------------
------------------------------------------------------------------------------------------------------------------------------------------------------
------------------------------------------------------------------------------------------------------------------------------------------------------
------------------------------------------------------------------------------------------------------------------------------------------------------
--------------------------------------------------------------------------------------------------------------------------S---------------------------
------------------------------------------------------------------------------------------------------------------------------------------------------
------------------------------------------------------------------------------------------------------------------------------------------------------
--------------------------------------------------------------------------------------------------------------------------%------------D--------------
----------------------------------%-k%-----%-------------------------------------S----------------------------------------|---------------------------
---------------------------------%|--|-----|--------------------------------%-----------------%%%-------------------------|-------------%-------------
--------------------------------%||%-|-----|--------------------------------|-----------------|||-------------------------|----%------%%|-------------
--------%-----%%----------------||||-|-----|--------------------------------|----%------%-%---|||------------------%%-----|----|%-----|||---------%%%%
%%%%%%%%|%%%%-||----------------||||%|-%%%%|----%%--------------------------|----|------|-|---|||-------------%----||-----|----||-----|||%%%%-%%--||||
|||||||||||||X||XXXXXXXXXXXXXXXX||||||X|||||XXXX||XXXXXXXXXXXXXXXXXXXXXXXXXX|-XXX|XXX-XX|X|XXXXXXXXX-XXXXXXXX-|XXXX||XXXXX|XXXX||XXXXXXX|||||X||XXXXXX