------------------------------------------------------------------------------------------------------------------------------------------------------
------------------------------------------------------------------------------------------------------------------------------------------------------
------------------------------------------------------------------------------------------------------------------------------------------------------
------------------------------------------------------------------------------------------------------------------------------------------------------
------------------------------------------------------------------------------------------------------------------------------------------------------
------------------------------------------------------------------------------------------------------------------------------------------------------
------------------------------------------------------------------------------------------------------------------------------------------------------
----------------------------------------------%-------------------------------------------------------------------------------------------------------
----------------------------------------------|-------------------------------------------------------------------------------------------------------
----------------------------------------------|-------------------------------------------------------------------------------------------------------
----------------------------------------------|--------#----------------------------------------------------------------------------------------------
---------%------------------------------------|-------K#--------------------------------------------------------------------------------%-------------
---------|--%---%%%%-%------------------------|------%%#----------------%%----------------------------%%%--%%-----%%--------------------|-------------
---------|--|--%||||-|%--------------------%%%|------||%-------%---%----||----------------------------|||--||-----||%%%%%%--%%------%--%|-%--------%--
%%%%%%%%%|-%|--|||||-||-----------------%%%||||%%%---|||-%-----|--%|----||%%%%%%----------------------|||--||-----||||||||--||%%----|%%||%|%%%%%%%-|--
|||||||||XX||XX|||||X||XXXXXXX-XXXXXXXXX||||||||||XXXXX|-|XXXXX|XX||XXXX||||||||XXXXXXX--XXXXXXXXXXXXX|||XX||XXXXX||||||||XX||||----||||||||||||||X|XX