------------------------------------------------------------------------------------------------------------------------------------------------------
------------------------------------------------------------------------------------------------------------------------------------------------------
------------------------------------------------------------------------------------------------------------------------------------------------------
------------------------------------------------------------------------------------------------------------------------------------------------------
------------------------------------------------------------------------------------------------------------------------------------------------------
------------------------------------------------------------------------------------------------------------------------------------------------------
------------------------------------------------------------------------------------------------------------------------------------------------------
--------------------------------------------------------------------------------------D---------------------%-----------------------------------------
------------------------------------------------------------------------------------------------------------|-----------------------------------------
------------------------------------------------------------------------------------------------------------|-----------------------------------------
------------------------------------------------------------------------------------------------------------|---------%-------------------------------
--------------------------------------------------------------------------------------%---------------------|---------|-------------------------------
-----------------------------------%-----%-------%%-----%%%----%----------------------|---------------------|---------|---------%---------------------
-------------%------------%--------|-----|-------||%----|||----|-----%-----%%%%-------|---------------------|---------|--------%|%--------------------
%%%%%%%%%%%--|------------|--------|----%|-------|||%%%-|||----|-----|---%%||||%%%%---|------------%--------|---------|--------|||--------%%%---------
|||||||||||XX|-XXXXXXXXXXX|XXXXXXXX|XXXX||XXXXXXX||||||X|||XXXX|XXXXX|-X-||||||||||XXX|--XXXX--XXXX|XXXXXXXX|-XXXXXXXX|XXXXXXXX|||XXXXXXXX|||XXXXXXXXX