------------------------------------------------------------------------------------------------------------------------------------------------------
------------------------------------------------------------------------------------------------------------------------------------------------------
------------------------------------------------------------------------------------------------------------------------------------------------------
------------------------------------------------------------------------------------------------------------------------------------------------------
------------------------------------------------------------------------------------------------------------------------------------------------------
------------------------------------------------------------------------------------------------------------------------------------------------------
------------------------------------------------------------------------------------------------------------------------------------------------------
------------------------------------------------------------------------------------------------------------------------------------------------------
------------------------------------------------------------------------------------------------------------------------------------------------------
------------------------------------------------------------%-----------------------------------------------------------------------------------------
------------------------------------------------------------|---------------------------------------------------------------------------------------%-
------------------------------------------------------------|------------------------%%-------------------------------------------------------------|-
---------%%%%%%-----------------------%---------------------|----------%%%-----------||-----------------------%-------------------------------------|-
---------||||||----%----%-%-----------|---------------------|----------|||-----------||------------%%-------%-|---%%%%--%------------------%--------|-
%%%%%%%%%||||||%---|----|-|-----------|%%-%-%---------------|-----%%---|||%---%------||--%%%%%%%%%-||%------|-|---||||-%|-%%-----%----%%%%%|%-------|-
||||||||||||||||XXX|XXXX|X|XXXXXXXXXXX|||-|X|XXXX-XXXXXXXXXX|X--XX||XXX||||XXX|XXXXXXXXXX|||||||||-|||XXXXXXXX|XXX||||X||-||-----|----|||||||-XXXXXX|X