------------------------------------------------------------------------------------------------------------------------------------------------------
------------------------------------------------------------------------------------------------------------------------------------------------------
------------------------------------------------------------------------------------------------------------------------------------------------------
------------------------------------------------------------------------------------------------------------------------------------------------------
------------------------------------------------------------------------------------------------------------------------------------------------------
------------------------------------------------------------------------------------------------------------------------------------------------------
------------------------------------------------------------------------------------------------------------------------------------------------------
---------------------------------------------------------------------------%--------------------------------------------------------------------------
---------------------------------------------------------------------------|----------------------------------------------------------------%---------
---------------------------------------------------------------------------|----------------------------------------------------------------|---------
---------------------------------------------------------------------------|----------------------------------------------------------------|---------
--------------------------------------------------------%------------------|-------------------%%%%%%-------%--------%%----%----------------|---------
----------%%%%--------------------%---------------------|------------------|------%%-----------||||||------%|--------||----|---------%%%%%%%%%%%%%----
----------||||-%%%%----%%---------|----------%----------|-------%%---------|------||-----------||||||------|%--------||%%--|%--------|||||||||||||----
%%%%%%%%%%||||-||||-%%%||%--------|----------|-----%%%%%|%%----%||--%%%----|------||----%------||||||%%%%%-||--------||||--||--------|||||||||||||%---
||||||||||||||X||||X||||||----X--XXXXXXXXXXXX|XXXXX|||||X||XXXX|||XX|||XXXX|XXXXXX||XXXX|-XXX--XXXXXX|||||X||XXXXXXX-XX||XXX|X--XXXXX||||||||||||||XXX