------------------------------------------------------------------------------------------------------------------------------------------------------
------------------------------------------------------------------------------------------------------------------------------------------------------
------------------------------------------------------------------------------------------------------------------------------------------------------
------------------------------------------------------------------------------------------------------------------------------------------------------
------------------------------------------------------------------------------------------------------------------------------------------------------
------------------------------------------------------------------------------------------------------------------------------------------------------
------------------------------------------------------------------------------------------------------------------------------------------------------
------------------------------------------------------------------------------------------------------------------------------------------------------
------------------------------------------------------------------------------------------------------------------------------------------------------
------------------------------------------------------------------------------------------------------------------------------------------------------
--------------------------------------------------------------------------------------------U---------------------------------------------------------
-------------------------------------------------------------2----------------------------------------------------------------------------------------
-------------------------------------------%%%---%%%-%%---------------------%%--%%%%%------%-%-%----------------%----------------------%--------------
-----------------------%%-------%%--%%%%%%%|||---|||-||---------------------||-%|||||------|-|-|----------------|----------------------|------------%%
%%%%%%%%%%%%-----------||-------||--||||||||||---|||-||---------------------||%||||||-%---%|%|%|%%%%%%%%%%%-%%--|%%%%%%%%%%%-----------|------------||
||||||||||||XXXXXXXXXXXXXXXXXXXX||--||||||||||---|||X||XXXXXXXXXXXXXXXXXXXXX|||||||||X|--X|||||||||||||||||-||XX||||||||||||XXXXXXXXXXX|XXXXXXXXXXXX||