------------------------------------------------------------------------------------------------------------------------------------------------------
------------------------------------------------------------------------------------------------------------------------------------------------------
------------------------------------------------------------------------------------------------------------------------------------------------------
------------------------------------------------------------------------------------------------------------------------------------------------------
------------------------------------------------------------------------------------------------------------------------------------------------------
------------------------------------------------------------------------------------------------------------------------------------------------------
------------------------------------------------------------------------------------------------------------------------------------------------------
-------------------------------%------%---------------------------------------------------------------------------------------------------------------
-------------------------------|------|---------------------------------------------------------------------------------------------------------------
-------------------------------|------|---------------------------------------------------------------------------------------------------------------
-------------------------------|------|---------------------------%-----------------------------------------------------------------------------------
-------------------------------%------S---------------------------|-----------------------------------------------------------------------------------
------------------------------%|-------------------%%-%-%------%--|----------------------------------%-----------------------------%------------------
-------------------%-----%%--%||-%%%%-------%%%--%%||-|-|%-----|--|-----%-------------------%%-------|--%---%-----------%%%%%%-----|----------%%%---%%
%%%%%%%%%%%%%%%-%%%|-%%--||--|||-||||%-%----|||--||||%|-||-----%--|%----|%%%%%%-%%%%%%--%%-%||---%---|--|---|-----------||||||%%%%-|%---------|||---||
|||||||||||||||-||||X||XX||XX|||X|||||-|XXXX|||X-||||||X||XXXXX|XX||XXXX|||||||X||||||-X||X|XXXX-|XXX|-X|XXX|XXXXXXXXXXX||||||||||X||XXXXXXX-X|||---||