------------------------------------------------------------------------------------------------------------------------------------------------------
------------------------------------------------------------------------------------------------------------------------------------------------------
------------------------------------------------------------------------------------------------------------------------------------------------------
------------------------------------------------------------------------------------------------------------------------------------------------------
------------------------------------------------------------------------------------------------------------------------------------------------------
------------------------------------------------------------------------------------------------------------------------------------------------------
------------------------------------------------------------------------------------------------------------------------------------------------------
------------------------------------------------------------------------------------------------------------------------------------------------------
------------------------------------------------------------------------------------------------------------------------------------------------------
------------------------------------------------------------------------------------------------------------------------------------------------------
----------S-----------------------------------------------------------%-----------------------%---%---------------------------------------------------
----------------------------------------------------%-----------------|-----------------------|---|---------------------------------------------------
----------------------------------------------------|------------%----|------%---%%-----%-%---|---|-------------------------%%%---------------%%--%---
-----------%----------------------------------------|------------|----|-%%---|%%%||-%%-%|-|---|---|-------------------------|||-----------%---||%-|--%
%%%%%%%%%%%|-%%%---------------%---------%%%---%----|------------|%---|-||%%-||||||-||-||-|---|--%|-----%%%-----------------|||-----%-----|---|||-|--|
||||||||||||X|||XXXXXXXXXXXXXXX|XXXXXXXXX|||XXX|XXXX|XXXXX-XXXXX-||XXX|-||||X|X||||-||X|XXXXXX|-X||XXXXX|||XXX--XXXXXXX--XXX||XXX-XX|XXXXXXXXX|||X|XX|