------------------------------------------------------------------------------------------------------------------------------------------------------
------------------------------------------------------------------------------------------------------------------------------------------------------
------------------------------------------------------------------------------------------------------------------------------------------------------
------------------------------------------------------------------------------------------------------------------------------------------------------
------------------------------------------------------------------------------------------------------------------------------------------------------
------------------------------------------------------------------------------------------------------------------------------------------------------
------------------------------------------------------------------------------------------------------------------------------------------------------
------------------------------------------------------------------------------------------------------------------------------------------------------
------------------------------------------------------------------------------------------------------------------------------------------------------
------------------------------------------------------------------------------------------------------------------------------------------------------
---------------------%--------------------------------------------------------------------------------------------------------------------------------
-------------%%------|--------------------------------%-----------------------------------------------------------------------------------------------
-------------||------|--------------------------------|-----------%%-------------------------%%----%----%------------%---------%%---------------------
-------------||------|--%--------%--------------%%-%--|---%%%%%--%||---%---------------------||----|----|--%------%--|---------||---------------------
%%%%%%%%-----||-%%%--|--|--%-----|-%%%%%%--%-%%%||-|--|%--|||||--|||---|---------------------||----|----|--|---%%%|--|---------||---------------------
||||||||X-XXX||X|||XX|XXXXX|-XXXX|X||||||XX|X||||XX|-X||X-|||||XX|||XXX|-XXXXXXXXXXXXXXXXXXXX||XXXX|XXXX|XX|XXX|||XXXXXXXXXX-XX||XXXXXXXXXXX-XXXXXXXXX