------------------------------------------------------------------------------------------------------------------------------------------------------
------------------------------------------------------------------------------------------------------------------------------------------------------
------------------------------------------------------------------------------------------------------------------------------------------------------
------------------------------------------------------------------------------------------------------------------------------------------------------
------------------------------------------------------------------------------------------------------------------------------------------------------
------------------------------------------------------------------------------------------------------------------------------------------------------
--------------%---------------------------------------------------------------------------------------------------------------------------------------
--------------|---------------------------------------------------------------------------------------------------------------------------------------
--------------|---------------------------------------------------------------------------------------------------------------------------------------
--------------|---------------------------------------------------------------------------------------------------------------------------------------
--------------|------------------------------------------------------------------------%-------------------------------------------------------%------
--------------|------------------------------------------------------------------------|-------------------------------------%-----------------|------
--------------|------%%%%---%%---------------%%%----%---------%-------------G----------|%%-------%%------%%%%----------------|-------------%---|------
--------------|------||||--%||-%%------------|||----|---------|----%--------%----------|||------%||----%-||||--%%%-----------|-----------%-|---|%-----
%%%%%%%%%-----|------||||%-|||-||---%%%%%%%--|||-%--|---------|----|-------%|-----%----|||------|||----|-||||--|||%%---------%%----------|-|%--||-----
|||||||||XXXXX|XXXXXX|||||X|||X||XXX|||||||--|||X|XX|-XX----X-|XXXX|XXXXXXX||XXXXX|XXXX|||XXXXXX|||---X|-||||X-|||||XXXXXXXXX||XXXXXXXXXX|XX|X-|XXXXXX