------------------------------------------------------------------------------------------------------------------------------------------------------
------------------------------------------------------------------------------------------------------------------------------------------------------
------------------------------------------------------------------------------------------------------------------------------------------------------
------------------------------------------------------------------------------------------------------------------------------------------------------
------------------------------------------------------------------------------------------------------------------------------------------------------
------------------------------------------------------------------------------------------------------------------------------------------------------
------------------------------------------------------------------------------------------------------------------------------------------------------
----------------------------------------------------------------------------------------%-------------------------------------------------------------
----------------------------------------------------------------------------------------|-------------------------------------------------------------
----------------------------------------------------------------------------------------|-------------------------------------------------------------
----------------------------------------------------------------------------------------|-------------------------------------------------------------
----------------------------------------------------------------------------------------|-------------%---%%---%--------------------------------------
-----------------------------------------%-----------%-------%%-------------------------|-------------|---||---|--------------------------------------
------------------------%--------U%%%%%%%|-%%%---%%-%|-------||-------------------------|--------%%%--|---||---|-%%--%-------%%%-%--%-%------%--------
%%%%%%%%%-----%---------|----%%%--||||||||%|||---||-||-------||----------------%%-------|----%%%-|||--|---||---|%||-%|%%%%%%%|||-|--|%|------|%----%%%
|||||||||---XX|-XXXXXXXX|XXXX|||-X||||||||||||---||X|XXXXXXXX||X-XXXXXXXXXXX--X||XXXXXXX|XXXX|||-|||XXXXXXXXXXX||||X||||||||||||X|-X|||X-XXXX||XXXX|||