------------------------------------------------------------------------------------------------------------------------------------------------------
------------------------------------------------------------------------------------------------------------------------------------------------------
------------------------------------------------------------------------------------------------------------------------------------------------------
------------------------------------------------------------------------------------------------------------------------------------------------------
------------------------------------------------------------------------------------------------------------------------------------------------------
------------------------------------------------------------------------------------------------------------------------------------------------------
---------------------------------S--------------------------------------------------------------------------------------S-----------------------------
------------------------------------------------------------------------------------------------------------------------------------------------------
------------------------------------------------------------------------------------------------------------------------------------------------------
---------------%S----------------------------------------------------%--------------------------------------------------%-----------------------------
---------------|--------------------------------%-%------------------|--------------------------------------------%%----|-----------------------------
---------------|--------------------------------|-|------------------|-----------------------#------S-------------||----|-------------------------%-%-
---------------|-----------------%------------%%|%|%%%%%%------------|----------%%--%-%-%%%%%%%---------------%---||%--%|---------%------%-----%%-|-|%
---------------|-----------------|-----%------|||||||||||%%%%---%--%%%----------||-%|-|-|||||||---------------|---|||--||---------|------|-----||-|-||
%%%%%%%%%%%%---|-----------------|-----|------|||||||||||||||---|--|||----------||-||-|-|||||||-----%---------|---|||-%||%%%%%%%%-|------|-----||-|-||
||||||||||||XXX|XXXXXXXXXXXXXXXXX|XXXXX|--XXXX|||||||||||||||--X|XX|||XXXXXXXXXX||X||X|-|||||||XXXX-|XXXXXXXXX|XXX|||-|||||||||||X|----XX|XXXXX||XXX||