------------------------------------------------------------------------------------------------------------------------------------------------------
------------------------------------------------------------------------------------------------------------------------------------------------------
------------------------------------------------------------------------------------------------------------------------------------------------------
------------------------------------------------------------------------------------------------------------------------------------------------------
------------------------------------------------------------------------------------------------------------------------------------------------------
------------------------------------------------------------------------------------------------------------------------------------------------------
------------------------------------%-----------------------------------------------------------------------------------------------------------------
------------------------------------|-----------------------------------------------------------------------------------------------------------------
------------------------------------|-----------------------------------------------------------------------------------------------------------------
------------------------------------|-------------------------------------------------------------------------------------%---------------------------
---------------%--------------------|---------%----------------------------------------------%----------------------------|---------------------------
---------------|--------------------|---------|--------------------%-------------------------|----------------------------|----------K------2---------
---------------|----%--%%%%%---%%%--|--%------|----------------%---|---------------%%%%%%----|----------------------------|----------%-------%--------
----------%%---|----|--|||||---|||--|--|------|---------------%|-%%|%%%-----%%-----||||||----|---------%%%%%%--%----------|-%--------|-------|%%%%%%%%
%%%%%%%%%%||---|-%--|--|||||---|||%%|--|------|---------------||-||||||%%%-%||--%--||||||----|---------||||||--|-------%%-|-|--------|-------|||||||||
||||||||||||XXX|X|XX|XX|||||X-X||||||--|XXXXXX|XXXXXXX-XX--XXX||X|||||||||X|||--|--||||||XXXX|XXXX-XXXX||||||XX|XXXXXXX||X|X|XXXXXXXX|X--XXXX|||||||||