------------------------------------------------------------------------------------------------------------------------------------------------------
------------------------------------------------------------------------------------------------------------------------------------------------------
------------------------------------------------------------------------------------------------------------------------------------------------------
------------------------------------------------------------------------------------------------------------------------------------------------------
------------------------------------------------------------------------------------------------------------------------------------------------------
------------------------------------------------------------------------------------------------------------------------------------------------------
------------------------------------------------------------------------------------------------------------------------------------------------------
------------------------------------------------------------------------------------------------------------------------------------------------------
-------------------------------------------------------------------S----------------------------------------------------------------------------------
------------------------------------------------------------------------------------------------------------------------------------------------------
----------------------------------%------------%------------------------------------------------------------------------------------------------------
------------------------------%%--|------------|-------------------%-------------------g--------------------------------------------------------------
--------------%---------------||--|------------|-------------------|-----%----%-------%---------------------------------------------%%-%-%---%%%%%-%%-
------------%-|---------------||--|------------|----------------%--|-----|%%%%|--%----|----%-%%%%-%-------------------%-------------||-|%|-%-|||||-||-
%%%%%%%%----|-|%--%%-----%----||--|--------%---|--%-------------|-%|%%---||||||--|----|----|-||||-|---------------%%%-|%-%----------||-|||-|-|||||-||-
||||||||XX-X|X||--||XXXXX|-XXX||XX|XXXXXXXX|XXX|XX|XXXXXXXXXXXXXXX||||---||||||XX|XXXX|XXXX|X||||X|X---XXXXXXXXXXX|||-X|X|XXXXXXXXX-||X|||X|X|||||X||X