------------------------------------------------------------------------------------------------------------------------------------------------------
------------------------------------------------------------------------------------------------------------------------------------------------------
------------------------------------------------------------------------------------------------------------------------------------------------------
------------------------------------------------------------------------------------------------------------------------------------------------------
------------------------------------------------------------------------------------------------------------------------------------------------------
------------------------------------------------------------------------------------------------------------------------------------------------------
------------------------------------------------------------------------------------------------------------------------------------------------------
------------------------------------------------------------------------------------------------------------------------------------------------------
------------------------------------------------------------------------------------------------------------------------------------------------------
------------------------------------------------------------------------------------------------------------------------------------------------------
------------------------------%-----------------------------------------------------------------------------------------------------------------------
------------------------------|---------------------U---------------------------------------------------------------%-------------------%-------------
-------------%--------------%-|---------------------------------%------------------------------------%%----%--------|-------%-----------|%-%----------
-------------|------------%%|-|--------------------%------------|%%%%--------------------------------||----|--------|-------|-----------||-|---%%%-%%-
%%%%%%%%%%%%%|%--%%%---%-%|||-|------------%%------|------------|||||%%%%%%%%%-----------------%-----||----|-------%|%%---%-|-----------||-|%--|||%||-
|||||||||||||||XX|||X--|X||||X|XXXXXXXXXXXX||XXXXXX|XX-XXXXXXXXXX|||||||||||||XX-XXXXXXXXXXXXXX|XXXXX|X-XXX|XXXXXXX||||---|-|XXXXXXXXXXXX|X||XX||||||X