------------------------------------------------------------------------------------------------------------------------------------------------------
------------------------------------------------------------------------------------------------------------------------------------------------------
------------------------------------------------------------------------------------------------------------------------------------------------------
------------------------------------------------------------------------------------------------------------------------------------------------------
------------------------------------------------------------------------------------------------------------------------------------------------------
-----------------------------------D------------------------------------------------------------------------------------------------------------------
------------------------------------------------------------------------------------------------------------------------------------------------------
------------------------------------------------------------------------------------------------------------------------------------------------------
--------------%---------------------------------------------------------------------------------------------------------------------------------------
--------------|----------------------------------------------------------------------------------------------------------t----------------------------
--------------|----------------------------------------------------------------------------------------------------------t----------------------------
--------------|--------------------------------------------------%-------------------------------------------------------t----------------------------
--------------|-----------------------------%---%---%------------|---------------%%----%--%----%%--%%%%%%-%%%%-----------%------------------%--%%-----
--------------|---%%%---------%-------------|-%%|---|------------|---------------||----|--|----||--||||||%||||-----------|------------------|--||%%%%-
%%%%%%%%------|--%|||%%%------|----%--------|-|||-%-|---%--------|---------------||----|--|----||--|||||||||||-%%%--%%%%%|%-----------------|--||||||%
||||||||XXXXXX|XX|||||||------|XX-X|XXXXX---|X|||-|X|XXX|XXXXXXXX|XXXXXXXXXX-----||X--X|XX|---X||XX|||||||||||X|||--|||||||XXXXXXXXXXXXX-XXXXXXXX|||||