------------------------------------------------------------------------------------------------------------------------------------------------------
------------------------------------------------------------------------------------------------------------------------------------------------------
------------------------------------------------------------------------------------------------------------------------------------------------------
------------------------------------------------------------------------------------------------------------------------------------------------------
------------------------------------------------------------------------------------------------------------------------------------------------------
---------------------------------------------------------------------------------------%--------------------------------------------------------------
---------------------------------------------------------------------------------------|--------------------------------------------------------------
---------------------------------------------------------------------------------------|--------------------------------------------------------------
---------------------------------------------------------------------------------------|--------------------------------------------------------------
-------------------------------------------------------------g--------------------S----|--------------------------------------------------------------
-------------------------------------------------------------%-------------------------|--------------------------------------------------------------
-------------------------------------------------------------|-------------------------|------%%------------------------------------------------------
-----------%%---%-----------------------------%--%-%%--------|------------%%--%---%-%--|------||------------------%%%%---------------------------%----
-----------||---|-----------------------------|--|-||--------|-----%------||--|---|-|--|------||---%--------------||||%%%%%%%%%%%%%%%%-----------|----
%%%%%%%%---||---|-----------------------------|%%|%||-------%|-----|--%%%%||--|%--|-|--|------||---|--------------||||||||||||||||||||%%%%%%--%--|----
||||||||XXX||XXX|XXXXXXXXXXXXXXXXXXXXXX--XXX-X|||||||-----XX||XXXXX|XX||||||XX||X-|X|X-|XX-XXXXX--X|XXXXXXXXXXXXXX||||||||||||||||||||||||||XX|XX|-X--