------------------------------------------------------------------------------------------------------------------------------------------------------
------------------------------------------------------------------------------------------------------------------------------------------------------
------------------------------------------------------------------------------------------------------------------------------------------------------
------------------------------------------------------------------------------------------------------------------------------------------------------
------------------------------------------------------------------------------------------------------------------------------------------------------
------------------------------------------------------------------------------------------------------------------------------------------------------
------------------------------------------------------------------------------------------------------------------------------------------------------
------------------------------------------------------------------------------------------------------------------------------------------------------
--------------------------------------------------------------------------------------S---------------------------------------------------------------
------------------------------------------------------------------------------------------------------------------------------------------------------
------------------------------------------------------------------------------------------------------------------------------------------------------
--------------------------------------------------%%%%%-----------------------------------------------------------------------------------------------
--------------------------------------------%-----|||||%------------------%%---------%%-------%%%-%%%-------------%-----------------------------------
-------------%%%%----%%%--------------------|-----||||||------------------||---------||-%%%%%%|||-|||---------%%--|-%%-%----------g----%----------%---
%%%%%%%%%%%%-||||----|||----%%%%%%%%%%%%%%%%|%%%%%||||||-%%%%%%----%%%%%--||---------||-|||||||||-|||---------||%%|-||-|%---------X----|-%-------%|-%%
||||||||||||X||||---X|||----||||||||||||||||||||||XXXXX|-||||||XXXX|||||--||XX-XXXXXX||XXXXXXX|||X|||XXXXXXXXX|||||X||X||XXXXX-XX-XXXX-|X|XXXXXXX||X||