------------------------------------------------------------------------------------------------------------------------------------------------------
------------------------------------------------------------------------------------------------------------------------------------------------------
------------------------------------------------------------------------------------------------------------------------------------------------------
------------------------------------------------------------------------------------------------------------------------------------------------------
--------------------------------------------------------------------------------------------%---------------------------------------------------------
--------------------------------------------------------------------------------------------|---------------------------------------------------------
--------------------------------------------------------------------------------------------|---------------------------------------------------------
--------------------------------------------------------------------------------------------|---------------------------------------------------------
--------------------------------------------------------------------------------------------|---------------------------------------------------------
--------------------------------------------------------------------------------------------|---------------------------------------------------------
----------------------------------------------------------------------------------------%---|---------------------------------------------------------
---------------------------------------------2------------------------------------------|---|-----------------------%--------------------%------------
--------------%------%%%--------------------------------------%---%%%%%%%%%%%%--%-%-%%%%|---|-----------------------|%-------------------|------------
--------%-----|--%%-%|||%-%-------------%------%%%%---------%-|---||||||||||||--|-|%|||||---|--------------------%%%||----%-----%--------|------------
%%%%%%%%|%-%%%|%%||-|||||-|%%%%%%%%-%%%-|------||||--%------|%|%--||||||||||||--|-|||||||---|%--------%---%%%%---|||||----|%%---|%-%-----|------------
||||||||||X||||||||X|||||X|||||||||-|||X|XXX-X-||||XX|XXXXXX||||-X||||||||||||XX|X|||||||-XX||XXXXXXXX|XXX||||XXX||||XXX--|||XX-||X|XXXXX|XXX--X-XXXXX