------------------------------------------------------------------------------------------------------------------------------------------------------
------------------------------------------------------------------------------------------------------------------------------------------------------
------------------------------------------------------------------------------------------------------------------------------------------------------
------------------------------------------------------------------------------------------------------------------------------------------------------
------------------------------------------------------------------------------------------------------------------------------------------------------
------------------------------------------------------------------------------------------------------------------------------------------------------
------------------------------------------------------------------------------------------------------------------------------------------------------
----------------------------------------------------------------------------------------------------------------%-------------------------------------
----------------------------------------------------------------------------------------------------------------|-------------------------------------
----------------------------------------------------------------------------------------------------------------|-------------------------------------
----------------------------------------------------------------------------------------------------------------|-------------------------------------
-----------%-----------------------------%-----%---------------------------%%-----------------------------------|-------------------------------------
-----------|-----------------------------|-----|----------------------%%---||%%---------%--------------%--%---%-|---------------------------%%--%%----
--------%%-|---------------%%%--%%--%---%%---%%|----------------------||---||||---------|--------------|--|---|-|-%------%%%-%%%%%%%%-------||2-||-%%%
%%%%%%%%||-|---------------|||--||--|%%%||-%%|||----------------------||---||||-%-------|---%%---------|%%|%%%|%|%|%%%%-%|||-||||||||%%-----||--||%|||
||||||||||X|XXXXXXXXXXXXXXX|||XX||-X||||||-||||X-XXXXXXXXXXXXXXXXXXXXX||XXXXX||X|XXXXXXX|XXX||XX-XXXXXX||||||||||||||||X||||X||||||||||-XXXX||X-||||||