------------------------------------------------------------------------------------------------------------------------------------------------------
------------------------------------------------------------------------------------------------------------------------------------------------------
------------------------------------------------------------------------------------------------------------------------------------------------------
------------------------------------------------------------------------------------------------------------------------------------------------------
------------------------------------------------------------------------------------------------------------------------------------------------------
------------------------------------------------------------------------------------------------------------------------------------------------------
-----------------------%------------------------------------------------------------------------------------------------------------------------------
-----------------------|-----------------------------------------------------------------------------------------------------------------------------%
------------------%----|-----------------------------------------------%-----------------------------------------------------------------------------|
------------------|----|-----------------------------------------------|-----------------------------------------------------------------------------|
------------------|----|-----------------------------------------------|S----------------------------------------------------------------------------|
------------------|----|-----------------------------------------------|-----------------------------------------------------------------------------|
------------------|----|--%%%------------------------------------------%--%%---%%%%%--%--------%---------------------------------------------t-------|
-----------------%|--%%|%-|||------------------------------------------|--||---|||||--|%%F%%%--|-----%%-------------------------%%%----------t-------|
%%%%%%%%%%%------||--||||-|||---%%---------%--%---------------------%%%|%-||%%%|||||--|||%|||--|-%%%%||-------------------------|||----------%-------|
|||||||||||XXXXXX||--||||-XX|XXX||---XXXX--|XX|XXXXXXXXXXXXXXXXXXXXX|||||X||||||||||-X|||||||XX|-||||||XXXXX-XX-XXXXXXXXXXXX-XXX|||XXXXXXXXXX|-XXXXXX|