------------------------------------------------------------------------------------------------------------------------------------------------------
------------------------------------------------------------------------------------------------------------------------------------------------------
------------------------------------------------------------------------------------------------------------------------------------------------------
------------------------------------------------------------------------------------------------------------------------------------------------------
-----------------------------------------------------------------------------------------------------------------------------------------------D------
------------------------------------------------------------------------------------------------------------------------------------------------------
------------------------------------------------------------------------------------------------------------------------------------------------------
------------------------------------------------------------------------------------------------------------------------------------------------------
------------------------------------------------------------------------------------------------------------------------------------------------------
------------------------------------------------------------------------------------------------------------------------------------------------------
-----------------------------------------------%-----------------------------------------------------------------------------------------------%------
---------------------------------t-------------|-----------2----------------------------------------------------------------%-----------------%|------
-------------%-------------------t-------------|------------------------------------------------%-------------%---%---------|--------------%%-||------
-----------%%%--%%%%----F%%%%%%%%%%%%%-%%%%%%--|----------------------------------------%%%%----|%%%--%%%-----|---|---------|--------------||-||%%%%--
%%%%%%%%%%-|||%%||||%%%%%|||||||||||||-||||||%%|-----%%%%------------%%%%%%%%%%%--%%----||||----||||%-|||-%%-%|---|---------|--------------||-||||||--
||||||||||X||X||||||||||||||||||||||||X|||||||||-----||||XXXXXXXXXXXX|||||||||||XX||XXXX||||XXXX|||||-|||X||X||XXX|XXXXXXXXX|--XXXXXXXX-XXX||-X|||||XX