------------------------------------------------------------------------------------------------------------------------------------------------------
------------------------------------------------------------------------------------------------------------------------------------------------------
------------------------------------------------------------------------------------------------------------------------------------------------------
------------------------------------------------------------------------------------------------------------------------------------------------------
------------------------------------------------------------------------------------------------------------------------------------------------------
------------------------------------------------------------------------------------------------------------------------------------------------------
------------------------------------------------------------------------------------------------------------------------------------------------------
------------------------------------------------------------------------------------------------------------------------------------------------------
------------------------------------------------------------------------------------------------------------------------------------------------------
-------------------%--%-------------------------------------------------------------------------------------------------------------------------------
-------------------|--|-------------------------------------------------------------------------------------------------------------------------------
-------------------|%%|--------------------------------------------------%------------------k---------------------------------------------------------
----------------%-%||||-----------------------------%%%%%----------------|%%%-------------%-----------%--%--------------------------%%%%%%-%%----%%%%%
----------------|-|||||-----------%%---------------%|||||---%%-----------||||------------%|%%%%-%%%%--|--|--------------------------||||||-||----|||||
%%%%%%%%%%%%----|-|||||---%--%%%%%||-%-------%%%%--||||||%%%||%%%--------||||------------||||||-||||%%|-%|%%------------------------||||||-||----|||||
||||||||||||XXXX|X||XX|XXX|XX|||||||X|X-XXX--||||-XX|||||||||||||XX-XXXX-X|||XXXXXXXXXXXXX|||||X|||||||-||||-XXXX-X---XXXXXX--XXXXXX||||||X||XX--|||||