------------------------------------------------------------------------------------------------------------------------------------------------------
------------------------------------------------------------------------------------------------------------------------------------------------------
------------------------------------------------------------------------------------------------------------------------------------------------------
------------------------------------------------------------------------------------------------------------------------------------------------------
------------------------------------------------------------------------------------------------------------------------------------------------------
------------------------------------------------------------------------------------------------------------------------------------------------------
-----------------------------------------------------------------------------------------------------------------D------------------------------------
-----------------------------------------------------------------------------------------------------------------------S------------------------------
-------------------------------------------------------------------------------------------g----------------------------------g-----------------------
------------------------------------------------------------------------------------------------------------------------------------------------------
---------------------------------------------%---------------------------------------------%%%--------------------------------------------------------
---------------------------------------------|---------------------------------------------|||-%%-------------------------------------------%---------
--------%%%-%--------------------------------|--%--------------------------%-----%%%%%%-%%%|||-||-------------%%%%----------%---------------|---------
--------|||-|----%-----------------%---------|--|----------------%%-%%%%%--|%%%%%||||||-||||||-||%%---------%-||||%%%%%%%---|%--%%%-%%%%--%%|--%%%%%--
%%%%%%%%|||-|----|-------------%%%%|----%----|--|----------------||%|||||%%||||||||||||-||||||%||||---------|-|||||||||||---||--|||-||||%%|||-%|||||--
|||||||||||X|-XXX|XXXXXXXXXXXXX|||||XXXX|X-XX|XX|XXXXXXXXXXXXXXXX||||||||||||||||||||||-|||||||XX||XXXX-XXXX|X|||||||||||XXX||--|||X|||||||||X||||||XX