------------------------------------------------------------------------------------------------------------------------------------------------------
------------------------------------------------------------------------------------------------------------------------------------------------------
------------------------------------------------------------------------------------------------------------------------------------------------------
------------------------------------------------------------------------------------------------------------------------------------------------------
------------------------------------------------------------------------------------------------------------------------------------------------------
------------------------------------------------------------------------------------------%-----------------------------------------------------------
-------------%----------------------------------------------------------------------------|-----------------------------------------------------------
-------------|----------------------------------------------------------------------------|-----------------------------------------------------------
-------------|----------------------------------------------------------------------------|-----------------------------------------------------------
-------------|----------------------------------------------------------------------------|-----------------------------------------------------------
-------------|----%%----------------------------------------------------------------------|-------------------------------%---------------------------
----------%%%|----||%---------------------------------------------------------------------|-------------------------------|---------------------------
----------||||--%-|||--------%-------------%----------------------------------------------|-%--------%-%--------%---%%%%%%|%%-%%-----------------%-%%%
----------||||--|-|||--------|-----------%-|-------------%-------------%%%%%%%%%%%%-%--%--|%|%%------|-|--------|---|||||||||-||-----------------|-|||
%%%%%%%%%-||||--|-|||-----%%-|#%--%%%%%--|%|-----------%-|-------%%%%--||||||||||||-|--|--|||||%--%%-|-|--------|---|||||||||-||--%----%%%-%-----|-|||
|||||||||XXXX|XX|X|||XXXX-||-|X|XX|||||X-|||XXXXX---XX-|X|XXXXXXX||||XX||||||||||||X|XX|X-||||||XX||X|X|XXXXXXXX|XXX|||||||||X||XX|XXXX|||X|XXXXX|X|||