------------------------------------------------------------------------------------------------------------------------------------------------------
------------------------------------------------------------------------------------------------------------------------------------------------------
------------------------------------------------------------------------------------------------------------------------------------------------------
------------------------------------------------------------------------------------------------------------------------------------------------------
------------------------------------------------------------------------------------------------------------------------------------------------------
------------------------------------------------------------------------------------------------------------------------------------------------------
------------------------------------------------------------------------------------------------------------------------------------------------------
------------------------------------------------------------------------------------------------------------------------------------------------------
------------------------------------------------------------------------------------------------------------------------------------------------------
------------------------------------------------------------------------------------------------------------------------------------------------------
------------------------------------------------------------------------------------------------------------------------------S-------------%--%%%%%%%
------------------------------------------------------------------------------------K-----------------------%---S--%------------------------|--|||||||
-------------------------%-----------------------------%----------------------------%--%--------%-----%%----|------|------------------%%%%%-|-%|||||||
--------%%-%%%-----------|-%%%%-%%%-----%---%-%%----%%%|----------------------------|--|--------|-----||%-%-|----%%|----%%%%--%-------|||||-|-||||||||
%%%%%%%%||-|||%%%-%%-----|-||||-|||-----|--%|-||----||||---%------------------------|--|--------|-----|||-|-|----|||----||||--|------%|||||-|-||||||||
||||||||||-||||||X||XXXXXXX||||-|||--XX-|XX||X||XXXX||||---|XXXXXXXXXXXXXXXXXXXXX---|X-|XXXXXX-X|XXXX-|||X|X|--XXXXXXXXX||||XX|XXXXXX||||||-|X||||||||