------------------------------------------------------------------------------------------------------------------------------------------------------
------------------------------------------------------------------------------------------------------------------------------------------------------
------------------------------------------------------------------------------------------------------------------------------------------------------
------------------------------------------------------------------------------------------------------------------------------------------------------
------------------------------------------------------------------------------------------------------------------------------------------------------
----------------------------------------------%-------------------------------------------------------------------------------------------------------
----------------------------------------------|-------------------------------------------------------------------------------------------------------
----------------------------------------------|-------------------------------------------------------------------------------------------------------
----------------------------------------------|-------------------------------------------------------------------------------------------------------
----------------------------------------------|-----------%-------------------------------------------------------------------------------------------
----------------------------------------------|-----------|--------------%----------------------------------------------------------------------------
----------------------------------------------|-----------|--------------|-----------%-----------------------------------------------------%----------
-----------%%%%--%%%%%%%%-%%--%%%%--%--------%|%---------%|------%----%%%|--------%--|-----%--------------%%-----------%--------------%----|----------
-----------||||--||||||||-||-%||||-%|--------|||-%-------||---%--|----||||%%--%%%%|--|%----|--%%%%%-%%---%||-----------|-%%%%-%%-%%%%%|%%%-|----------
%%%%%%%%---||||%-||||||||-||-|||||-||%%-%%%%-|||-|%------||%--|%-|----||||||--|||||-%||----|--|||||%||---|||-----------|-||||-||-|||||||||-|----------
||||||||---|||||X||||||||-||-|||||X||||X||||X|||-||XXXXXX|||XX||-|-XXX||||||--|||||X|XXXXXXXXX||||||||-XX|||XXXXX-XXXXX|X||||-||X|||||||||X|XXXXXXXXXX