------------------------------------------------------------------------------------------------------------------------------------------------------
------------------------------------------------------------------------------------------------------------------------------------------------------
------------------------------------------------------------------------------------------------------------------------------------------------------
------------------------------------------------------------------------------------------------------------------------------------------------------
------------------------------------------------------------------------------------------------------------------------------------------------------
------------------------------------------------------------------------------------------------------------------------------------------------------
------------------------------------------------------------------------------------------------------------------------------------------------------
------------------------------------------------------------------------------------------------------------------------------------------------------
------------------------------------------------------------------------------------------------------------------------------------------------------
---------------------------------------------------------------------------------------------------------------------------------------------------t--
------------%--------------------------------------------------------------------------------------------------------------------------------------t--
------------|-------------------------------------------------------------------------------------------------------------%------------------------t--
------------|%%-----------------------%-%----------------------%%------------%%%%%----------------------------------------|-------%%%%--%%%--------%%-
------------|||-------%---------------|-|----------------%-----||------------|||||----------------------------------------|-------||||--|||--------||-
%%%%%%%%----|||%------|---------------|-|---%------------|-----||%----%%%%%%%|||||---%%------%---%%-----------------------|-------||||--|||--------||%
||||||||XXXX|XX|XXXXX-|XXXXXXXXXXXXXXX|X|XXX|XXXXXXXXXXXXXXXXX-|||XXXX||||||||||||-XX||XXXXXX|XXX||XXXXXXXXXX-XXXXXXXXXXXX|X------||||XX|||XXXXXXXX|||