------------------------------------------------------------------------------------------------------------------------------------------------------
------------------------------------------------------------------------------------------------------------------------------------------------------
------------------------------------------------------------------------------------------------------------------------------------------------------
------------------------------------------------------------------------------------------------------------------------------------------------------
------------------------------------------------------------------------------------------------------------------------------------------------------
------------------------------------------------------------------------------------------------------------------------------------------------------
------------------------------------------------------------------------------------------------------------------------------------------------------
------------------------------------------------------------------------------------------------------------------------------------------------------
------------------------------------------------------------------------------------------------------------------------------------------------------
------------------------------------------------------------------------------------------------------------------------------------------------------
----------------------------------%-----------%%%%%--%----------------------------------%%%-----------------------------------------------------------
----------------------------------|-----------|||||--|----------------------------------|||-------KK------------------------------------------%-------
----------------------------------|-----%%%%--|||||%-|-------------------%-----------%%%|||-%---%-%%----------------%----%----------%---%-----|--%%%%%
--------------%%%%----------------|-----||||%-||||||-|-----------%%---%%%|-----------||||||-|--%|-||---%----------%%|----|----------|---|----%|--|||||
%%%%%%%%%%%%%%||||--%%%%%---------|-----|||||%||||||-|%---------%||---||||-------%%%%||||||-|--||-||---|---%------|||%%-%|----------|---|----||--|||||
||||||||||||||||||-X|||||--XXXXXXX|XXXXX||||||||||||X||XXXXXXXX-|||XXX||||XXXXXXX||||||||||X|--||X||XX-|XXX|XXXXXX|||||-||---XXXXXXX|XXX|XXXX||--|||||