------------------------------------------------------------------------------------------------------------------------------------------------------
------------------------------------------------------------------------------------------------------------------------------------------------------
------------------------------------------------------------------------------------------------------------------------------------------------------
------------------------------------------------------------------------------------------------------------------------------------------------------
------------------------------------------------------------------------------------------------------------------------------------------------------
------------------------------------------------------------------------------------------------------------------------------------------------------
-----------------------------D---------------------------------------------------------------------------------------------------%--------------------
---------------------------------------------------------------------------------------------------------------------------------|--------------------
---------------------------------------------------------------------------------------------------------------------------------|--------------------
-----------------%---------------------------------------------------------------------------------------------------------------|--------------------
-----------------|-----%-------------------------------------------------------%-------------------------------------------------|--------------------
-----------------|-----|-----D-------------------------------------------------|----------------------%--------------------------|--------------------
-----------------|----%|----%-----------------------------------------------%%-%----------------------|----%--%%%%-------%-------|--------------------
-----------------|----||-%%%|%-%%%%%%%-%%%g%---------------%%%%-------------||-|----------------------|----|--||||--%----|-------|--------------------
%%%%%%%%%%%--%%--|%%%%||%|||||-|||||||-|||-|---------------||||-------------||%|-%%-----------------%%|----|--||||--|----|-%%%%--|%--------------%%---
|||||||||||-X||XX|||||||||||||-|||||||X|||X|XXXXXXXXXXXXXX-||||-XXXX-XXXXXX-||||X||XXXXXXXXXXXXXXXXX||XXXXX|XX||||--|XX-X|X||||X-||-X--XXXXXXXXXX||XXX