------------------------------------------------------------------------------------------------------------------------------------------------------
------------------------------------------------------------------------------------------------------------------------------------------------------
------------------------------------------------------------------------------------------------------------------------------------------------------
------------------------------------------------------------------------------------------------------------------------------------------------------
----------------------------------------S-------------------------------------------------------------------------------------------------------------
------------------------------------------------------------------------------------------------------------------------------------------------------
------------------------------------------------------------------------------------------------------------------------------------------------------
----------------------------------------%-------------------------------------------------------------------------------------------------------------
----------------------------------------|------------------%------------------------------------------------------------------------------------------
----------------------------------------|------------------|----t-------------------------------------------------------------------------------------
----------------------------------------|------------------|----t-------------------------------------------------------------------------------------
----------------------%%-----%%%----%%%-|------------------|---%%-------------------------------------------------------------------------------------
----------%%-%--%-----||-----|||-%--|||-|---------------%%%|---||------------------------------%%-%-----------------------------------------------%---
----------||-|%-|---%-||-----|||%|%-|||-|---------------||||---||------------------------------||%|-------------%---------------------------------|---
%%%%%%%%-%||-||-|---|-||---%%||||||-|||-|---------------||||---||----------------------%%%--%%-||||%%%%--------%|--------%-----%%%-%%-%-%%%-------|---
||||||||-|||X||-|XXX|-XXXXX||XXX|X|XXXX-|-XX--X-XXXXXXXX||||XXX||XX--XX---XXXXXXXXXXXXX|||--||X||||||||XXXXXXXX||XXXXXXXX|XXXXX|||X||X|X|||X----X-|XXX