------------------------------------------------------------------------------------------------------------------------------------------------------
------------------------------------------------------------------------------------------------------------------------------------------------------
------------------------------------------------------------------------------------------------------------------------------------------------------
------------------------------------------------------------------------------------------------------------------------------------------------------
------------------------------------------------------------------------------------------------------------------------------------------------------
------------------------------------------------------------------------------------------------------------------------------------------------------
------------------------------------------------------------------------------------------------------------------------------------------------------
------------------------------------------------------------------------------------------------------------------------------------------------------
-----------------------------------------------------------------------------------------%------------------------------------------------------------
---------------------------------%%------------------------------------------------------|--%%--------------------------------------------------------
---------------------------------||------------------------------------------------%-----|--||--------------------------------------------------------
---------------------------------||----------%-------------------------------%-----|-----|--||--------------------------------------------------------
-----------------%%-%-----%------||----------%----------------%%%%-%%----%-%%|---%-|-%%%%|%%||%%%%------------------------------%---%-----------------
-----------------||-|----%|-%%---||%---------|----------------||||-||-%--|-|||-%-|-|-|||||||||||||---%--%--%-----G-------%%%%-%-|%%%|%%%%%%%%%--%%%%%%
%%%%%%%%-----%---||-|----||-||---|||---------|----%%%---------||||-||-|--|-|||-|-|-|-|||||||||||||---|%%|--|--%-%%-------||||%|-||||||||||||||-%||||||
||||||||XX---|--X||X|XXXX||-||XXX|||---XX----|XXXX|||XXXXXXXXX||||-||X|--|X||XX|X|X|X|||||||||||||XXX||||--|XX|-||XXXXXXX||||||-||||||||||||||X|||||||