------------------------------------------------------------------------------------------------------------------------------------------------------
------------------------------------------------------------------------------------------------------------------------------------------------------
------------------------------------------------------------------------------------------------------------------------------------------------------
------------------------------------------------------------------------------------------------------------------------------------------------------
------------------------------------------------------------------------------------------------------------------------------------------------------
------------------------------------------------------------------------------------------------------------------------------------------------------
------------------------------------------------------------------------------------------------------------------------------------------------------
------------------------------------------------------------------------------------------------------------------------------------------------------
------------------------------------------------------------------------------------------------------------------------------------------------------
-----------------------------------------------T------------------------------------------------------------------------------------g-----------------
-----------------------------------------------t------------------------------------------------------------------------------------------------------
-----------------------------------------------t---------------------------------------------------------------------------------%--------------------
-------------%---------------------------------%---------------------%--------------------%%-------------------------------------|---%----%%%%%%------
-----------%-|---%--%---------------%%%%-%%-%%%|%--------------------|----------------%%%%||%--%-----%%%%%%%%----------%----%%-%%|--%|-%%-||||||------
%%%%%%%%%--|-|---|--|---------------||||-||-|||||------------%%------|-----------%%%%%|||||||--|-----||||||||----------|----||-|||--||-||-||||||------
|||||||||--|X|XXX|XX|XXXXXXXXXXXXXXX||||-||-|||X|XXXXXXXXXXXX||XXXXXX|XXXXXXXXX--||||||||||||X-|X----XXXXXXXXXXXXXXXXXX|XXXX||-|||-X||-||X||||||XXXXXX