------------------------------------------------------------------------------------------------------------------------------------------------------
------------------------------------------------------------------------------------------------------------------------------------------------------
------------------------------------------------------------------------------------------------------------------------------------------------------
------------------------------------------------------------------------------------------------------------------------------------------------------
------------------------------------------------------------------------------------------------------------------------------------------------------
------------------------------------------------------------------------------------------------------------------------------------------------------
------------------------------------------------------------------------------------------------------------------------------------------------------
------------------------------------------------------------------------------------------------------------------------------------------------------
------------------------------------------------------------------------------------------------------------------------------------------------------
------------------------------------------------------------------------------------------------------------------------------------------------------
--------------------------------------------------------------------------------------------------------------------------%%--------------------------
--------------------------------------------------%%---%-------------------K-----------------%----%-----------------------||--------------------------
--------------%%-----%%--%--%----------------%-%%-||---|-------------------%-----------------|----|%--------%------------%||--------------------%-----
--------------||%----||--|%-|----------%%%---|-||-||---|-------------------|-------%%%-------|----||--------|----------%%|||%-------%-----------|-----
%%%%%%%%------|||----||--||-|----------|||%--|-||-||---|-------------------|-------|||-------|----||--------|----------||||||---%%%-|-----------|-----
||||||||XXXXXX||XXXXX||XX||X|X-XXXXXXXX||||--|X||-||XXXXXXXXXXXXXXXXXXXXXXX|XXXXXX-|||-XXXXXX|XXXX||-XXXXXXXX--XXXXXXXXXX||||XXX|||X|XXXXXXXXXXX|XXXXX