------------------------------------------------------------------------------------------------------------------------------------------------------
------------------------------------------------------------------------------------------------------------------------------------------------------
------------------------------------------------------------------------------------------------------------------------------------------------------
------------------------------------------------------------------------------------------------------------------------------------------------------
------------------------------------------------------------------------------------------------------------------------------------------------------
------------------------------------------------------------------------------------------------------------------------------------------------------
--------------------------------------------------------------------------------------------%---------------------------------------------------------
--------------------------------------------------------------------------------------------|---%-----------------------------------------------------
--------------------------------------------------------------------------------------------|---|-----------------------------------------------------
--------------------------------------------------------------------------------------------|---|-----------------------------------------------------
------------------------------------------------------D-------------------------------------|---|-----------------------------------------------------
-------------------------------------------%------------------------------------------------|---|-----------------------------------------------------
------------------------%-----S------------|-%%%%%%------------%----------------------%%----|---|---------------2-------------------------------------
------------------------|%-----------------|-||||||%--%------%-|------------%---------||---%|---|%%------------r----------------%%%%------------------
%%%%%%%%%%%--%%-%%%%%%%%||----------------%|%|||||||%%|%%%%%-|%|%%%%%%%-%-%%|---------||%--||%%-|||-----------------------------||||------------------
|||||||||||-X||X||||||||||-XXXXXXXXXXXXXXX|X||||||||||||||||X||||||||||X|X|||XXXXX-XXX|||--||||-|||XXXXXXXXXXXXXXX--XXXXXXXXXXXX||||XXXXXXXXXXXXXXXXXX