------------------------------------------------------------------------------------------------------------------------------------------------------
------------------------------------------------------------------------------------------------------------------------------------------------------
------------------------------------------------------------------------------------------------------------------------------------------------------
------------------------------------------------------------------------------------------------------------------------------------------------------
------------------------------------------------------------------------------------------------------------------------------------------------------
------------------------------------------------------------------------------------------------------------------------------------------------------
------------------------------------------------------------------------------------------------------------------------------------------------------
--------------------------------------%%--------------------------------------------------------------%-----------------------------------------------
--------------------------------------||--------------------------------------------------------------|----%------------------------------------------
--------------------------------------||--------------------------------------------------------------|----|------------------------------------------
-------------------------------------%||--------------------------------------------------------------%----|------------------------------------------
-------------------------------------|||--------------------------------------------------------------|----|------------------------------------------
-------------%------%-----------%----|||--%%---%-%------%%%-%%--------------%-------------%%%---------|-%--|------------------------------------------
----------%--|------|-------%---|----|||%-||%%%|%|--%%%-|||-||-------------%|%------------|||---%%%%%%|-|%-|---------%%%%%%%%%-%%---%-----------------
%%%%%%%%%-|%-|%%---%|-------|---|---%||||-||||||||--|||-|||%||---%---------|||------------|||---|||||||-||-|---------|||||||||-||---|----%%%%-%-------
|||||||||X||X|||XX-||XXXXXXXXXXX|X-X|||||-||||||||--|||X||||||XXX|XXXXXXXXXX||XXXXX-XXXXXX|||-XX|||||||XX|X|XXXXXX---|||||||||X||X--|XXXX||||X|XXXXXXX