------------------------------------------------------------------------------------------------------------------------------------------------------
------------------------------------------------------------------------------------------------------------------------------------------------------
------------------------------------------------------------------------------------------------------------------------------------------------------
------------------------------------------------------------------------------------------------------------------------------------------------------
------------------------------------------------------------------------------------------------------------------------------------------------------
------------------------------------------------------------------------------------------------------------------------------------------------------
------------------------------------------------------------------------------------------------------------------------------------------------------
------------------------------------------------------D-----------------------------------------------------------------------------------------------
------------------------------------------------------------------------------------------------------------------------------------------------------
-----------------------------------------------------%------------------------------------------------------------------------------------------------
-----------------------------------------------------|------------------------------------------------------------------------------------------------
------------------------%----------------------------|----------------------------------------%%%%-----%----------------------------------------------
------------------------|-------------------%%%%%%%%%|-%%%%-%--------------%-%%%%-%-----------||||-----|------------------------------------------%---
---------------%-%--%---%-%%%-----%%------%-||||||||||-||||%|%%%-----------|%||||-|-----------||||---%-|%-%%------------------------------%-------|---
%%%%%%%%%%-%--%|%|--|---|-|||%%%%%||%-----|-||||||||||-|||||||||-----------||||||-|-%%--------||||---|-||-||----------%--%----------------|-------|---
||||||||||X|--||||XX|XXXXX|||||||||||--X-X|X||||||||||-|||||||||XXXXXXXXXX-||||||X|X||X---XXXXXXXXXXX|XX|XXXXXXXXXXXXX|XX|XXXXXXXXXXXXXXXX|XXXXXXX|XXX