------------------------------------------------------------------------------------------------------------------------------------------------------
------------------------------------------------------------------------------------------------------------------------------------------------------
------------------------------------------------------------------------------------------------------------------------------------------------------
------------------------------------------------------------------------------------------------------------------------------------------------------
------------------------------------------------------------------------------------------------------------------------------------------------------
------------------------------------------------------------------------------------------------------------------------------------------------------
------------------------------------------------------------------------------------------------------------------------------------------------------
-----------------------------------------------------------%------------------------------------------------------------------------------------------
----------------------------------------------%------------|------------------------------------------------------------------------------------------
----------------------------------------------|------------|-----------------------------------------------------------------%%%----------------------
----------------------------------------------|------------|---------------------------%-----%-------------------------------|||----------------------
----------------------------------------------|------------|---------------------------|-----|------------------------------%|||----------------------
------------------------%---------------------|------------|---------------------------|-----|-----------%%---%%%-%%---%%%%%||||-------------------%--
-----------------%------|---------------------|----------%%|----%%%%-%%-%--------------|--%--|-----------||---|||-||---|||||||||-----%%------------|--
%%%%%%%%%%%------|------|-------------%%%---%%|----%%%%%%|||----||||-||-|--------------|--|--|-----------||---|||-||%%%|||||||||-----||------------|-%
|||||||||||XXX-XXXXXXXXX|XXXXXXXXXXXXX|||XXX|||XXXX|||||||||XXXX||||X||X|XXXX-XXXXXXXXX|XX|XX|X-XXXXX--XX||XXX|||X||||||||||||||XXXXX||XXXXXXXXXXXX|X|