------------------------------------------------------------------------------------------------------------------------------------------------------
------------------------------------------------------------------------------------------------------------------------------------------------------
------------------------------------------------------------------------------------------------------------------------------------------------------
------------------------------------------------------------------------------------------------------------------------------------------------------
------------------------------------------------------------------------------------------------------------------------------------------------------
------------------------------------------------------------------------------------------------------------------------------------------------------
--------------------------------------------------------------------------------D---------------------------------------------------------------------
------------------------------------------------------------------------------------------------------------------------------------------------------
------------------------------------------------------------------------------------------------------------------------------------------------------
------------------------------------------------------------------------------------------------------%---------------------------------------------S-
------------------------------------------------------------------------------------------------------|-----------------------------------------------
------------------------------------------------------------------------------------------------------|-----------2-----------------------------------
--------------%-%%%%%%------------------------------%-------------%-%%%----%----%%-----%-----%%%------|--------------------%----------------------%%--
-----------%%%|-||||||------------------------------|----%%%%%%--%|%|||--%-|%%%-||-----|-----|||--%-%%|%%%%%-%%------------|-------------%%%%%--%-||%-
%%%%%%%%%--||||-||||||------------------------------|----||||||--||||||--|-||||-||-----|-----|||--|%||||||||%||--%-%-%%----|-----------%%|||||--|-|||-
|||||||||XX||||-||||||XXXXXXXXXXXXXXXXXXXXXXXXXXXXXX|XXXX||||||-X||||||XX|-||||-||-XXXX|-XX--|||XX|||||||||||||--|X|X||X-XXXXXX-XXXXXXX|||||||X-|X|||-