------------------------------------------------------------------------------------------------------------------------------------------------------
------------------------------------------------------------------------------------------------------------------------------------------------------
------------------------------------------------------------------------------------------------------------------------------------------------------
------------------------------------------------------------------------------------------------------------------------------------------------------
------------------------------------------------------------------------------------------------------------------------------------------------------
---------------------------------------------------------------------------------------------S--------------------------------------------------------
------------------------------------------------------------------------------------------------------------------------------------------------------
---------------------------------------------------%--------------------------------------------------------------------------------------------------
---------------------------------------------------|--------------------------------------------------------------------------------------------------
---------------------------------------------------|-----------------------------------------D----------------------------------S---------------------
-----------------------------------------------%%%-|--------------------------------------------------------------------------------------------------
-------------------------------------%---------|||-|----------------------------------------------------%---------------------------------------------
------------------------%----------%-|--------%|||-|-----------------------%%---------------------------|-----------------------%---------------------
-----------------%------|----%-----|-|--------||||%|----------%%---%%------||%%%---%---------%-r-%%%-%%-|-%%%%%-%%%%%%%%%%%%----|---------------------
%%%%%%%%--%%%%%--|------|---%|-----|%|%%%%%%%-||||||%%%%%%----||---||------|||||---|-----%-%-|---|||-||%|%|||||-||||||||||||----|------------------%--
||||||||XX|||||XX|XXXXXX|XXX|XXX-XX||||||||||X||||||||||||X-XX|XXXX||XXXXXX|||||---|XXXXX|-|X|XXX|||X|||X||||||X||||||||||||XXXX|XXXXXXXXXXXXXXXXXX|XX