------------------------------------------------------------------------------------------------------------------------------------------------------
------------------------------------------------------------------------------------------------------------------------------------------------------
------------------------------------------------------------------------------------------------------------------------------------------------------
------------------------------------------------------------------------------------------------------------------------------------------------------
------------------------------------------------------------------------------------------------------------------------------------------------------
------------------------------------------------------------------------------------------------------------------------------------------------------
------------------------------------------------------------------------------------------------------------------------------------------------------
------------------------------------------------------------------------------------------------------------------------------------------------------
------------------------------------------------------------------------------------------------------------------------------------------------------
-----------------------------------------------------------------------------------------------%------------------------------------------------------
-----------------------------------------------------------------------------------------%-----|------------------------------------------------------
----------------------%------------------------------------------------------------------|-----|---------------------------------------------------#--
-------------%--------|----------------%--%%------------------------%--%%%%%%%%%%%%------|--%%%|------------%%%--%%----------------------------%--%%--
-----------%-|--------|%-%-------------|--||------------------------|--||||||||||||------|%%||||%%%%%%%%%%--|||%-||----------------------------|--||--
%%%%%%%%---|-|-------%||%|------%------|--||--------------------%%%%|--||||||||||||------|||||||||||||||||--||||-||-%--%%%%%%--%---------------|%%||%%
||||||||XXX|X|XXXXX--|X|||-XXXXX|XXXXXXXXX||X-XXXXXXXXXXXXXXXXXX|||||--||||||||||||XXXXXX|X|||||||||||||||XX||||-||X|XX||||||XX|XXXXXXXXXXXXXXX|||||||