------------------------------------------------------------------------------------------------------------------------------------------------------
------------------------------------------------------------------------------------------------------------------------------------------------------
------------------------------------------------------------------------------------------------------------------------------------------------------
------------------------------------------------------------------------------------------------------------------------------------------------------
------------------------------------------------------------------------------------------------------------------------------------------------------
------------------------------------------------------------------------------------------------------------------------------------------------------
------------------------------------------------------------------------------------------------------------------------------------------------------
------------------------------------------------------------------------------------------------------------------------------------------------------
------------------------------------------------------------------------------------------------------------------------------------------------------
------------------------------------------------------------------------------------------------------------------------------------------------------
------------------------------------------------------------------------------------------------------------------------------------------------------
------------------------------------------------------------------------------------------------------------------------------------------------------
------------------------------------------------------------------------------------%%%---------------------------------------%-------%G--%-----------
---------------%%-------%%-----------------------------------%------%---------k----%|||----%%%%%%%%%%%%%----%-----------------|-------|%--|-----------
%%%%%%%%%%%%%%%||%%-----||-----------------------------%--%%-|%%%%--|--------------||||----|||||||||||||----|-----------------|-------||%%|----------%
|||||||||||||||||||-XXXX||XXXXXXXXXXXXXXXXXXXXXXXXXXXX-|XX||X|||||--|XXXXXXXXXXXXXX|XXXXXXX|||||||||||||XXXX|XXXXXXXXXXXXXX-XX|-XXXXXX|||||XXXX-XXXXX|