------------------------------------------------------------------------------------------------------------------------------------------------------
------------------------------------------------------------------------------------------------------------------------------------------------------
------------------------------------------------------------------------------------------------------------------------------------------------------
------------------------------------------------------------------------------------------------------------------------------------------------------
------------------------------------------------------------------------------------------------------------------------------------------------------
------------------------------------------------------------------------------------------------------------------------------------------------------
------------------------------------------------------------------------------------------------------------------------------------------------------
------------------------------------------------------------------------------------------------------------------------------------------------------
------------------------------------------------------------------------------------------------------------------------------------------------------
------------------------------------------------------------------------------------------------------------------------------------------------------
----------------------------------------------------------------%-------------------------------------S---t-------------------------------------------
--------%------------------------%--------------%%%-------------|-----------------------------------------t-------------------------------------------
--------|---%%---%%%-%%%--%------|--------------|||-----------%%|-----%%-----------------------------%--%%t------------------------------------------%
--------|---||---|||-|||--|------|---%----------|||-----------|||-----||------------%--%--%%%%%-%%%--|-%||%%-------G--------------%%%%%%-%%%%%%%--%%%|
%%%%%%%%%%%%||---|||-|||--|%%%%%%|-%%|----------|||------%%%%%|||-----||------------|--|%%|||||-|||--|%|||||----%%%%%-------%%%%--||||||-|||||||--||||
||||||||||||||XXX|||X|||-X||||||||-|||-XXXXX---XXXXXXXXXX||||||||XXXX-||XXXXXXXXXXXX|XX||||||||X|||--|||||||-X-X|||||--XXX--||||XX||||||X|||||||XX||||