------------------------------------------------------------------------------------------------------------------------------------------------------
------------------------------------------------------------------------------------------------------------------------------------------------------
------------------------------------------------------------------------------------------------------------------------------------------------------
------------------------------------------------------------------------------------------------------------------------------------------------------
------------------------------------------------------------------------------------------------------------------------------------------------------
------------------------------------------------------------------------------------------------------------------------------------------------------
------------------------------------------------------------------------------------------------------------------------------------------------------
------------------------------------------------------------------------------------------------------------------------------------------------------
------------------------------------------------------------------------------------------------------------------------------------------------------
------------------------------------------------------------------------------%---------------------%-------------------------------------------------
---------------------------------------------------%%-------------------------|---------------------|---%---------------------------------------------
---------------------------------------------------||-------------------------|---------------------|---|----------------------------------%--%%%-----
---------------------------------------------------||--%--------------%-----%%|%%%%%--%%%%-%%%%%----%---|%%%------------------------%%%%-%-|--|||-----
------------%---%%%%%%--%%%%%-%%-------------------||--|--------------|-----||||||||--||||-|||||----|%%-||||----------------%-------||||-|-|-%|||-----
%%%%%%%%%%%%|-%-||||||%%|||||%||%-----------%%%-%%%||-%|%%--%%--------|%%---||||||||--||||-|||||----|||-||||---%%----%%%%%-%|------%||||%|-|-||||--%--
|||||||||||||X|X|||||||||||||||||---XXX----X|||-|||||-||||XX||XXXXXX-X|||---||||||||--||||X|||||XXXX|X|X||||XX-||XXXX|||||-||XXXX--|||||||-XX|XXXX-|XX