------------------------------------------------------------------------------------------------------------------------------------------------------
------------------------------------------------------------------------------------------------------------------------------------------------------
------------------------------------------------------------------------------------------------------------------------------------------------------
------------------------------------------------------------------------------------------------------------------------------------------------------
------------------------------------------------------------------------------------------------------------------------------------------------------
------------------------------------------------------------------------------------------------------------------------------------------------------
------------------------------------------------------------------------------------------------------------------------------------------------------
------------------------------------------------------------------------------------------------------------------------------------------------------
------------------------------------------------------------------------------------------------------------------------------------------------------
---------------%-----------------------------------------------------------------------------------------------------------------%%------2------------
---------------|-----------------------------------------------------------------------------------------------------------------||-------------------
--------------%|---------------------------%-------------------------------------------------------------------------------------||-22----------------
--------------||%%-----------------%-------|-------------------------------%------------------%----%%%-------------------%%------||-----%-------------
--------------||||--%%%---%%%%%-%-%|%%%----|-------------------------------|------------------|----|||-%%%%-------------%||%%%%%-||%---%|-%%----------
%%%%%%%%------||||--|||%--|||||-|%|||||---%%------------------------------%|-------------%%%%%|----|||%||||------%------||||||||%|||---||-||%%---%-%%-
||||||||XXXXXXX|XXXX||||XX|||||X|||||||---||XXXXXXXXXXXXXXXXXXXXXXXXXXXXXX||XX-----XXXXXX||||||XXXXXXX|||||XX----|XXXXX-||||||||||||XXX||X||||-XX|X||-