------------------------------------------------------------------------------------------------------------------------------------------------------
------------------------------------------------------------------------------------------------------------------------------------------------------
------------------------------------------------------------------------------------------------------------------------------------------------------
------------------------------------------------------------------------------------------------------------------------------------------------------
------------------------------------------------------------------------------------------------------------------------------------------------------
------------------------------------------------------------------------------------------------------------------------------------------------------
--------------------------------------------------------------------------------------------S-------------------------------------%-------------------
----------------------------------------------------------------------------------------------------------------------------------|-------%-----------
----------------------------------------------------------------------------------------------------------------------------------|-------|-----------
----------------------------------------------------------------------------------------------------------------------------------|-------|-----------
----------------------------------------------------------%---%--%%%%%%%-D--------------------------------------------------------|-------|-----------
---------------------------------------------------%%%%%%%|-%-|--|||||||--------------------%-------------------------------------|-------|-----------
--------------%%---%--------------%%---------------||||||||-|-|--|||||||-----------------%--|---------%%%%%%-----#--------%------%|-------|-----------
--------------||---|--------------||--------%------||||||||-|%|--|||||||%%%%%-----%%--%--|%-|----S-%%-||||||-----%--------|------||-------%-----------
%%%%%%%%----%-||--%|%-------------||-%------|%%%-%-||||||||%|||--||||||||||||-----||--|--||-|------||-||||||-----|--------|%--%--||-------|-----------
||||||||XXXX|-||XX|X|XXXXXXXXXXXXX||-|X----X||||X|X||||||||||||X-||||||||||||----X||--|--||X|XXXXXX||X|X||||XXXX-|XXXXXXXX||--|XX||XXXXXXX|XXXXXXXXXXX