------------------------------------------------------------------------------------------------------------------------------------------------------
------------------------------------------------------------------------------------------------------------------------------------------------------
------------------------------------------------------------------------------------------------------------------------------------------------------
------------------------------------------------------------------------------------------------------------------------------------------------------
------------------------------------------------------------------------------------------------------------------------------------------------------
------------------------------------------------------------------------------------------------------------------------------------------------------
------------------------------------------------------------------------------------------------------------------------------------------------------
------------------------------------------------------------------------------------------------------------------------------------------------------
------------------------------------------------------------------------------------------------------------------------------------------------------
------------------------------------------------------------------------------------------------------------------------------------------------------
------------------------------------------------------------------------------------------------------------------------------------------------------
------------------------------------------------------------------------------------------------------------------------------------------------------
----------------------------------------------------------------------------------------%---------------------------------S-----------%---------------
----------%-%---%%%%-%%-#-%-%%---%----%--------%%%%------------------------------%%-----|------------%%-%------------------%%%%%------|%F-%-----%%%---
%%%%%%%%%%|-|%%%||||%||%%-|-||%%%|--%%|--------||||%%%%%%------%%%%%%%%----------||-----|-----%-%%%%-||-|--%-------%-%-----|||||------||%-|----%|||%%%
|||||||||||X|||||||||||||X|X||||||-X|||XXXXXXXX||||||||||XXXXXX||||||||XXXXXXXXXXXXXXXX-|XXXXX|X||||X||-|--|-----XX|X|XXXXX|||||XXXXXXXX|X|XXXX|||||||