------------------------------------------------------------------------------------------------------------------------------------------------------
------------------------------------------------------------------------------------------------------------------------------------------------------
------------------------------------------------------------------------------------------------------------------------------------------------------
------------------------------------------------------------------------------------------------------------------------------------------------------
------------------------------------------------------------------------------------------------------------------------------------------------------
------------------------------------------------------------------------------------------------------------------------------------------------------
---------------------------------------------------------------------------------------------------------------------------%--------------------------
---------------------------------------------------------------------------------------------------------------------------|--------------------------
---------------------------------------------------------------------------------------------------------------------------|--------------------------
--------------------------------------------------------------%------------------------------------------------------------|--------------------------
----------------------g------%%---------%---------------------|------------------------------------------------------------|--------------------------
---------%------%------------||----2----|---------------------|------------------------------------------------------------|--------------------------
---------|------|--%%----%%%-||%%%%-----|---------%-----------|--------------------------------------------------U-------%-|-------------------%------
---------|%-%%%%|%%||----|||-||||||-----|---------|-----------|---------------------------------------------------------%|-|-%%%%--------------|------
%%%%%%%%%||%|||||||||%%-%|||%||||||-%%--|----%%%%%|%%--%%%%%%%|-%-------------------------%----%--%%%%%%-%%%-%%%%-------||-|%||||--------------|------
|||||||||X|||||||||||||-|||||||||||X||XX|XXXX||||||||XX||||||||X|XXX--XXXXXXXXXXXXXXXX-XXX|XXXX|XX||||||-|||X||||XXXXXXX||X||||||XXXXXXXXXXXXXX|XXXXXX