------------------------------------------------------------------------------------------------------------------------------------------------------
------------------------------------------------------------------------------------------------------------------------------------------------------
------------------------------------------------------------------------------------------------------------------------------------------------------
------------------------------------------------------------------------------------------------------------------------------------------------------
------------------------------------------------------------------------------------------------------------------------------------------------------
------------------------------------------------------------------------------------------------------------------------------------------------------
------------------------------------------------------------------------------------------------------------------------------------------------------
---------------------------------%-S------------------------------------------------------------------------------------------------------------------
---------------------------------|--------------------------------------------------------------------------------------------------------------------
---------------------------------|--------------------------------------------------------------------------------------------------------------------
---------------------------------|--------------------------------------------------------------------------------------------------------------------
---------------------------%%%%-%|-%--%------------------------------S%---------------------------------%---------------------------------------------
---------------------------||||-||-|--|-------------------------------|---------------------------------|------------------%%----------%--------------
------------%%%%%%%%%%%%%%-||||-||-|--|----------------------%--------|%------%-%%%%-%%%%%%%-%%%%%%%-%%-|%%%%%---------%%--||----------|--------------
%%%%%%%%%---||||||||||||||-||||-||-|--|%----%---%%-----------|-------%||%%%%%%|-||||-|||||||-|||||||-||-||||||%%%%----%||--||---------%|----%---------
|||||||||X--||||||||||||||XXXXXX||X|XX||XXXX|XXX||XXXXXXXXXXX|XXXXX-X|X||||||||-||||X|||||||-|||||||X||X||||||||||XXX-|||XX||XX--X-XX-||-XXX|XXXXXXXXX