------------------------------------------------------------------------------------------------------------------------------------------------------
------------------------------------------------------------------------------------------------------------------------------------------------------
------------------------------------------------------------------------------------------------------------------------------------------------------
------------------------------------------------------------------------------------------------------------------------------------------------------
------------------------------------------------------------------------------------------------------------------------------------------------------
------------------------------------------------------------------------------------------------------------------------------------------------------
------------------------------------------------------------------------------------------------------------------------------------------------------
------------------------------------------------------------------------------------------------------------------------------------------------------
------------------------------------------------------------------------------------------------------------------------------------------------------
----------------------------------------------------------------------------------------------------------%-------------------------------------------
-------------------------------------%--------------------------------------------------------------------|-------------%-----------------------------
-------------------------------------|--------------------------------------------------------------%-----|-------------|-----------------------------
----------%--------%%---%%-----------|-----%---%-%-------------------------------------------%%%%%--|-----|%%%%%--%%----|---------%-------------------
----------|%----%%-||--%||-----------|-----|---|-|%---%-%%%%-%%%----------------%%%%%------%-|||||--|-----||||||--||%%--|---------|------%%-----------
%%%%%%%%%%||%---||-||--|||-----------|-%%--|---|-||---|-||||-|||----%%%-----%%%%|||||%%%%--|-|||||--|-----||||||%-||||--|---------|----%%||%%%%%-%----
|||||||||||||XXX||XXXXX|||XXXXX-XXXXX|X||XX|---|X||XXX|X||||-|||XXXX|||XXXX-|||||||||||||XXXX|||||X-|XXXXX|||||||X||||XX|XXXXXXXXX|XXXX|||||||||X|XXXX