------------------------------------------------------------------------------------------------------------------------------------------------------
------------------------------------------------------------------------------------------------------------------------------------------------------
------------------------------------------------------------------------------------------------------------------------------------------------------
------------------------------------------------------------------------------------------------------------------------------------------------------
------------------------------------------------------------------------------------------------------------------------------------------------------
------------------------------------------------------------------------------------------------------------------------------------------------------
------------------------------------------------------------------------------------------------------------------------------------------------------
------------------------------------------------------------------------------------------------------------------------------------------------------
------------------------------------------------------------------------------------------------------------------------------------------------------
------------------------------------------------------------------------------------------------------------------------------------------------------
-------------------------------------------------------------------------------------------D----------------------------------------------------%-----
----------------------C------------------------------------------%---------------S----------------------------------------------------F---------|-----
-----------------------------------%------------------%----------|---------------------%-----------------------------%----%%----------%---------|-----
-----------------------------------|-------%--%%%%%---|-----%----|---------------------|---------%-----%%%-%%----%---|-K--||----------|---------|-----
%%%%%%%%------%%--%%%%---------%%--|----%%-|--|||||---|-----|-%%-|%%-------------------|---------|----%|||-||----|%--|%%%%||%%--------|---------|----%
||||||||------||XX||||XXXXXXXXX||XX|-XXX||X|--|||||XXX|XXXXXXX||-X||XXXXX--XXXXXXXXXXXX|XXXXXXXXXXXXX-||||X||XXXX||XX|||||||||XXXXXXXXXXXXXXXXXX|XXXX|