------------------------------------------------------------------------------------------------------------------------------------------------------
------------------------------------------------------------------------------------------------------------------------------------------------------
------------------------------------------------------------------------------------------------------------------------------------------------------
------------------------------------------------------------------------------------------------------------------------------------------------------
------------------------------------------------------------------------------------------------------------------------------------------------------
------------------------------------------------------------------------------------------------------------------------------------------------------
------------------------------------------------------------------------------------------------------------------------------------------------------
----------D------------------------------------------------------------------%------------------------------------------------------------------------
-----------------------------------------------------------------------------|------------------------------------------------------------------------
-----------------------------------------------------------------------------|------------------------------------------------------------------------
----------------%%%----------------------------------------------------------|------------------------------------------------------------------------
----------------|||------------------------------------------%---------------|------------------------------------------------------------------------
----------------|||--------------------%--K%%----------%%%-%%|-%%-----%------|----------------------------------%-%%----%-----------G------------%---%
----------%-%-%-|||%%------------------|--%||-%%--%%%%%|||-|||-||-%---|----%-%----%%----------------------------|-||----|-----------%%%%%%%%%%---|---|
%%%%%%%%%%|%|-|-|||||------%------%--%%|%%|||-||--||||||||-|||-||-|%-%|---%|-|----||---------------------------%|-||----|-%%%------%||||||||||%-%|---|
|||||||||||||-|X|||||XX----|XXXXXX|XX||X|||||X||XX||||||X|X|||-||X||X||X-X||X|XXXX||XXXX-XXXXXXXXXXXXXXXXXXXXXX||-||XXXX|X|||XXXXXX||||||||||||-||-XX|