------------------------------------------------------------------------------------------------------------------------------------------------------
------------------------------------------------------------------------------------------------------------------------------------------------------
------------------------------------------------------------------------------------------------------------------------------------------------------
------------------------------------------------------------------------------------------------------------------------------------------------------
------------------------------------------------------------------------------------------------------------------------------------------------------
------------------------------------------------------------------------------------------------------------------------------------------------------
------------------------------------------------------------------------------------------------------------------------------------------------------
------------------------------------------------------------------------------------------------------------------------------------------------------
------------------------------------------------------------------------------------------------------------------------------------------------------
------------------------------------------------------------------------------------------------------------------------------------------------------
------------------------------------------------------------------------------------------------------------------------------------------------------
-------------------------------------------------------------------------------------------------------------------%-----------------------%----------
-----------------------%-------------------------------------%----%%%--%%-%%%%-----------%-------------------------|-----------------------|----------
-----------------------|---%-%----%%%%%%%%%------%%----------|----|||--||-||||-----------|-------------------------|---------%%%%%%---%%--%|------%%%%
%%%%%%%%%%%%%%%%--%%%--|---|-|-%--|||||||||%%%%%-||-------%%-|----|||%-||-||||-%%%-%%%%%%|------%%%----------------|---------||||||%%-||%-||------||||
||||||||||||||||XX|||XX|XXX|X|X|XX|X||||||||||||X||XX-XXX-||X|XXXX||||-||X||||X|||X|||||||XXXX--|||XXXXXXXXXXXXXXXX|XXXXXXXXX||||||||-|||X|XXXXXXX||||