------------------------------------------------------------------------------------------------------------------------------------------------------
------------------------------------------------------------------------------------------------------------------------------------------------------
------------------------------------------------------------------------------------------------------------------------------------------------------
------------------------------------------------------------------------------------------------------------------------------------------------------
------------------------------------------------------------------------------------------------------------------------------------------------------
------------------------------------------------------------------------------------------------------------------------------------------------------
------------------------------------------------------------------------------------------------------------------------------------------------------
------------------------------------------------------------------------------------------------------------------------------------------------------
--------------------------------------------------------------------------------------------------------------------------------%---------------------
--------------------------------------------------------------------------------------------------------------------------------|---------------------
----------S---------------------------------------------------------------------------------------------------------------------|---------------------
-------------------------------------%--------------------------------------------------------------------------%---------------|---------------------
--------%%--------%------------------|-----------------------------%%%---%%%%%-%%---------------------%%--------|-----#---------|---------------------
--------||--------|------------------|-----%%-%g%------------------|||---|||||%||---%-----------------||%%%-%%--|-----%%%%%%-%--|%%-------------------
%%%%%%%%||%%-%%-%%|%-----------------|-----||-|-|-%----------------|||---||||||||---|--%%%------------|||||-||--|-----||||||-|--|||----------%--------
||||||||||||-||-||||XXXXXXX-X-XXXXXXXXXXXXX||X|-|X|-X--XXXXXXXXXXXX|||-XX||||||||XXX|XX|||XXXXXXXXXXXX|||||X||--|X----||||||-|--X||XXXXXXXXX-|XXX----X