------------------------------------------------------------------------------------------------------------------------------------------------------
------------------------------------------------------------------------------------------------------------------------------------------------------
------------------------------------------------------------------------------------------------------------------------------------------------------
------------------------------------------------------------------------------------------------------------------------------------------------------
------------------------------------------------------------------------------------------------------------------------------------------------------
------------------------------------------------------------------------------------------------------------------------------------------------------
-------------------------------------------------------------------------------------------------------------------------------------------------%----
-------------------------------------------------------------------------------------------------------------------------------------------------|----
-------------------------------------------------------------------------------------------------------------------------------------------------|----
-------------------------------------------------------------------------------%-----------------------------------------------------------------|----
-----------------%----%--------------------------------------------------------|-----------------------------------------------------------------|----
-----------------|----|---------------%-------------%--------------------------|-----------------------------------------------------------------|----
-----------------|----|---------%%----|-------%-----|-%%------%%%--------------|---%---------------------------------%%--------------------------|----
-----------------|----|---------||----|-------|---%%|-||------|||-----%%%%-----|---|%-%%---%%-----------------%------||--------%%----------------%----
%%%%%%%%---------|-%%%|%%%--%-%-||----|-------|---|||%||------|||-----||||-----|---||-||---||%----------------|------||-------%||-----%----%%%%%-|--%%
||||||||--XXXXXXX|X|||||||XX|X|X||XXXXXXXXXXXX|---||X|||XXXX-X|||XXXXX||||XXX-X|XXX||X||---|||XXXXXX--XXXXXXX-|XXXXXX||XXXXXX-|||XXXXX|--XX|||||X|XX||