------------------------------------------------------------------------------------------------------------------------------------------------------
------------------------------------------------------------------------------------------------------------------------------------------------------
------------------------------------------------------------------------------------------------------------------------------------------------------
-------------------------------------------------------------------------------------------------------------------------------------U----------------
------------------------------------------------------------------------------------------------------------------------------------------------------
------------------------------------------------------------------------------------------------------------------------------------------------------
------------------------------------------------------%-----------------------------------------------------------------------------------------------
-----------------------------------%------------------|------------------------------------------------------------------------------%----------------
-----------------------------------|------------------|------------------------------------------------------------------------------|----------------
-----------------------------------|------------------|------------------------------------------------------------------------------|----------------
----------------------%------------|-------------%----|------------------------------------------------------------------------------|----------------
----------------------|--%---------|-------------|----|------------------------------------------------------------------------------|----------------
----------------------|--|----%%%--|-------------|----|-----------------------%%------------------------%----------------------------|%%--------------
----------------------|--|--%-|||--|-------------|----|-------------%%%-------||-------%%--%-----------%|----------------------------|||---%-%-%%%-%%%
%%%%%%%%%%%%%%-%-%-%%%|-%|--|-|||-%|----%%%%--%%%|----|-------------|||-------||%------||--|-----------||-------------------%---%----|||-%%|%|-|||-|||
||||||||||||||-|X|X||||X|XXX|X|||-||XXX-||||--||||XXXX|---XXXXXXXXXX|||X--XXXX|||-XXX-X||-X|X-X----XXXX||XX-XXXXXXXXXXXXXXXX|XXX|XXXX|||-|||||X|||X|||