------------------------------------------------------------------------------------------------------------------------------------------------------
------------------------------------------------------------------------------------------------------------------------------------------------------
------------------------------------------------------------------------------------------------------------------------------------------------------
------------------------------------------------------------------------------------------------------------------------------------------------------
------------------------------------------------------------------------------------------------------------------------------------------------------
------------------------------------------------------------------------------------------------------------------------------------------------------
------------------------------------------------------------------------------------------------------------------------------------------------------
------------------------------------------------------------------------------------------------------------------------------------------------------
--------------------%---------------------------------------------------------------------------------------------------------------------------------
--------------------|--------------------%------------------------------------------------------------------------------------------------------------
--------------------|--------------------|------------------------------------------------------------------------------------------------------------
--------------------|--------------------|%------------------------------------------------%------------------------------------------------%%%-------
----------------%%%-|---%----------------||--%-------------------------%%%%-%%%---%--------|--%-%-----------%----------%%-------------------|||-------
--------%%------|||-|---|----------------||%%|-------------------------||||-|||---|--------|--|-|-----------|%---------||----%--------------|||---%%%%
%%%%%%%%||%%-%%-|||-|%--|-----%----------|||||-%-%%-----------%--------||||-|||---|%%%%%%%%|%%|%|%%%%%%%%%%%||%%%%%%%--||--%%|--%-----------|||---||||
||||||||||||-||X|||X||XX|XXX--|XXXXXXXX-X|XXX|-|-||XXXXXXXXXXX|XXXXXXXXXXXXX|||---||||||||||||||X||||||||||||||||||||XX||XX|||--|XXXXXX-XXXX|||XXX||||