------------------------------------------------------------------------------------------------------------------------------------------------------
------------------------------------------------------------------------------------------------------------------------------------------------------
------------------------------------------------------------------------------------------------------------------------------------------------------
------------------------------------------------------------------------------------------------------------------------------------------------------
------------------------------------------------------------------------------------------------------------------------------------------------------
------------------------------------------------------------------------------------------------------------------------------------------------------
------------------------------------------------------------------------------------------------------------------------------------------------------
------------------------------------------------------------------------------------------------------------------------------------------------------
------------------------------------------------------------------------------------------------------------------------------------------------------
------------------------------------------------------------------------------------------------------------------------------------------------------
----------------------------------------------------------------------------------------------------------------------------------------------%-------
-------------------------------------------------------------------------%------%---------------S----S-----------------------------------#----g-------
-----------%-------------------------%-----------------------------------|------|--%----%--------------%-------------%------%----------%%#----|-------
-----------|------------------%%%----|------------------------%%---------|------|--|----|--------------|------%------|-----%|----------||%----|-%--%-%
%%%%%%%%%%-|%%%%%%-%---%%-----|||----|%---------------%-------||---------|------|--|----|---------%%---|%%%%%%|------|-----||----------|||---%|-|--|-|
||||||||||-|||||||-|---||XXXXX|||XXXX||XXXXXXXXXXXX-XX|XXXXXXX||XXXXXXXXX|X-XXXX|XX|XXXX|XXXXXXXXX||XXX||||||||XXXXX-|XXXXX||XXXXXXX-XX|||--X|X-|XX|X|