------------------------------------------------------------------------------------------------------------------------------------------------------
------------------------------------------------------------------------------------------------------------------------------------------------------
------------------------------------------------------------------------------------------------------------------------------------------------------
------------------------------------------------------------------------------------------------------------------------------------------------------
------------------------------------------------------------------------------------------------------------------------------------------------------
------------------------------------------------------------------------------------------------------------------------------------------------------
--------------------%---------------------------------------------------------------------------------------------------------------------------------
--------------------|-----------------------------------------------------------------------------------------------------------------%---------------
--------------------|-----------------------------------------------------------------------------------------------------------------|----------r----
--------------------|-----------------------------------------------------------------------------------------------------------------|---------------
-------------%------|-----------------------------------------------------------------------------------------------------------------|%---------%----
-----------%-|------|-----------------------------------------------------------------------------------------------------------------||---------|----
-----------|-|--%---|-------------------------%-%%%%%%--------------------------------------------------%%----------------------------||--------%|%%--
-----------|-|--|---|------%------------------|-||||||%%%%%--%-%%%%%%%%%%%-----------------%%-%%%%------||----------------%%%%%%------|%--------||||%-
%%%%%%%%%%%|-|--|---|%-----|------------------|-|||||||||||-%|-|||||||||||-----%-----------||-||||%%-%%-||----------%%----||||||-%----||%-------|||||-
||||||||||||X|X-|-XX||XXXXXXXXXXXXXXXXXXXXXX--|X|||||||||||-||X|||||||||||XXXXX|-XXXXXXXXX-||-||||||X||-||XXXXXXXXXX||XXXX||||||X|--XX|||XXXX--X|||||-