------------------------------------------------------------------------------------------------------------------------------------------------------
------------------------------------------------------------------------------------------------------------------------------------------------------
------------------------------------------------------------------------------------------------------------------------------------------------------
------------------------------------------------------------------------------------------------------------------------------------------------------
------------------------------------------------------------------------------------------------------------------------------------------------------
------------------------------------------------------------------------------------------------------------------------------------------------------
------------------------------------------------------------------------------------------------------------------------------------------------------
------------------------------------------------------------------------------------------------------------------------------------------------------
------------------------------------------------------------------------------------------------------------------------------------------------------
------------------------------------------------------------------------------------------------------------------------------------------------------
---------------------------------------------------------------------------------------%--------------------------%-----------S-----------------------
------------------------------------------------------------------------%--------------|--------------------------|-----------------------------------
-----------------%%%%-%------------------------%%%---%%%%%%%%-----------|-------%------|%----------------------%%%|%-%----%----%--%------------------%
-----------------||||-|---------------%--------|||---||||||||-%%%%%%%%#-|%%%%%-%|%-----||---%%------------%----|||||%|-%%-|%%%%|--|-%%-------------%-|
%%%%%%%%%%%%-----||||-|%--------%%%%--|%%--%---|||---||||||||-||||||||%%||||||-|||-----||---||---------%%%|%---|||||||-||-||||||--|-||-------------|-|
||||||||||||---X-||||X||XXXXXXXX||||XX|||X-|XXX|||XXX||||||||X||||||||||||||||X|||XXX-X||-XX||XXXXXXXXX|||||XXX|||||||X||-||||||-X|X||X---XXXXXXXXX|X|