------------------------------------------------------------------------------------------------------------------------------------------------------
------------------------------------------------------------------------------------------------------------------------------------------------------
------------------------------------------------------------------------------------------------------------------------------------------------------
------------------------------------------------------------------------------------------------------------------------------------------------------
------------------------------------------------------------------------------------------------------------------------------------------------------
------------------------------------------------------------------------------------------------------------------------------------------------------
-----------------------------------------------------------------------------------------------------%------------------------------------------------
-----------------------------------------------------------------------------------------------------|------------------------------------------------
-----------------------------------------------------------------------------------------------------|------------------------------------------------
-----------------------------------------------------------------------------------------------------|------------------------------------------------
-----------------------------------------------------------------------------------------------------|------------------------------------------------
-----------------------------------------------------------------------------------------------------|------------------------------------------------
---------%%%%-%%-------------------------------------------------------------------------%----%%%%%--|------------------------------------%%----------
---------||||-||------%%%%%%-%%%%------------------------------%--%%%-%------------------|----|||||--%------------%%%-----------%---------||----------
%%%%%%%%%||||-||------||||||-||||--------------------------%---|--|||-|-------%%%%%-%%%%%|----|||||-%|------------|||-----------|--%%%%%%-||----------
|||||||||||||X||XXXXXX||||||X||||-XXXXXXXXXXXXXXXXXXXXXXXXX|XXX|XX|||X|XXXX-XX|||||-||||||---X|||||X||XXXXXXXXXXXX|||XXXXXXXXXXX|XX||||||X||XXXXXXXXXX