------------------------------------------------------------------------------------------------------------------------------------------------------
------------------------------------------------------------------------------------------------------------------------------------------------------
------------------------------------------------------------------------------------------------------------------------------------------------------
------------------------------------------------------------------------------------------------------------------------------------------------------
------------------------------------------------------------------------------------------------------------------------------------------------------
------------------------------------------------------------------------------------------------------%-----------------------------------------------
------------------------------------------------------------------------------------------------------|-----------------------------------------------
-----------------------------------------------------------------------------%------------------------|-----------------------------------------------
-----------------------------------------------------------------------------|------------------------|-----------------------------------------------
-----------------------------------------------------------------------------|------------------------|-----------------------------------------------
-----------------------------------------------------------------------------|------------------------|-----------------------------------------------
-----------------------------------------------------------------------------|------------------------|-----------------------------------------------
---------------------------------%--------%----------------------------------|---------%--------------|-----------------------------------------------
--------------%%-%%%-%----%%%----|%%%----%|-----------------------%%--%------|---------|--------------|------------------%%---------------------------
%%%%%%%%%%%-%%||%|||%|%-%-|||----%|||----||---------------------%%||--|------|---------|-%-----------%|------------------||---------------------------
|||||||||||X|||||||||||-|X|||XXXX||||XXXX||XXXXXXXXXXXXXXXXXXXXX||||XX|XXXXXX|XXXXXXXXX|X|XXXXX-XXXXX||XXXXXXXXXXXXXXXXXX||XXXXXXXXXXXXXXXXXXXXXXXXXXX