------------------------------------------------------------------------------------------------------------------------------------------------------
------------------------------------------------------------------------------------------------------------------------------------------------------
------------------------------------------------------------------------------------------------------------------------------------------------------
------------------------------------------------------------------------------------------------------------------------------------------------------
------------------------------------------------------------------------------------------------------------------------------------------------------
------------------------------------------------------------------------------------------------------------------------------------------------------
------------------------------------------------------------------------------------------------------------------------------------------------------
------------------------------------------------------------------------------------------------------------------------------------------------------
------------------------------------------------------------------------------------------------------------------------------------------------------
------------------------------------------------------------------------------------------------------------------------------------------------------
-------------------------------------------------------------------------------------%%-%%-%%%--------------------------------------------------------
-----------------------------------------------------------%-------------------------||-||-|||------------------------------------------%-------------
----------------------------%-----------------------%------|-------------------------||%||-|||---------------%--------------------------|%%--------%%-
-------------------%--------|-----------------------|------%------------------%%%-%%%|||||-|||-------%-------|--------------------------|||--------||-
%%%%%%%%%--%%%---%-|------%%|--------------%--%-----|------|------------------|||-||||||||-|||-------|-------|---%----------------------|||--------||-
|||||||||XX|||-XX|X|XXXXXX|||--XXXXXXXXXXXX|XX|XXXXX|XXXXXX|XXXXXXXXXXXX--XXXX|||X||||||||X|||XXXXXXX|-XXXXXX|XXX|XXXXXXXXXXXXXXXXXXXXXXX||XXXXXXXX||-