------------------------------------------------------------------------------------------------------------------------------------------------------
------------------------------------------------------------------------------------------------------------------------------------------------------
------------------------------------------------------------------------------------------------------------------------------------------------------
------------------------------------------------------------------------------------------------------------------------------------------------------
------------------------------------------------------------------------------------------------------------------------------------------------------
------------------------------------------------------------------------------------------------------------------------------------------------------
------------------------%-----------------------------------------------------------------------------------------------------------------------------
------------------------|-----------------------------------------------------------------------------------------------------------------------------
------------------------|-----------------------------------------------------------------------------------------------------------------------------
------------------------|-----------------------------------------------------------------------------------------------------------------------------
------------------------|-------CC--------------%-----------------------------------------------------------------------------------------------------
------------------------|---------#-------%-----|-----------------------------------------------------------------------------------------------------
---------%%%%%%%%-------%----%----%%%%-%%-|-%--%|-----------------------------%%-----------------------%%------%%%%-----------%-----------------------
---------||||||||-------|----|----||||-||-|-|-%||---------------%--%------%---||-----------------------||------||||-----------|-----------------------
%%%%%%%%-||||||||----%%-|%%%%|%-%%||||-||-|-|-|||-%%------%%%%%%|%%|%%--%%|%%%||%%%%%%%%%%----%%%%%-%%%||----%%||||-----------|---------------------%%
||||||||X||||||||XXX-||X|||||||-||||||-||XX-|X|||-||XXXXXX||||||||||||XX||||||||||||||||||----|||||-|||||XXX-||||||XXXXXXXXXXX|-XXXXXXXXXXXXXXXXXXXX||