------------------------------------------------------------------------------------------------------------------------------------------------------
------------------------------------------------------------------------------------------------------------------------------------------------------
------------------------------------------------------------------------------------------------------------------------------------------------------
------------------------------------------------------------------------------------------------------------------------------------------------------
------------------------------------------------------------------------------------------------------------------------------------------------------
------------------------------------------------------------------------------------------------------------------------------------------------------
------------------------------------------------------------------------------------------------------------------------------------------------------
------------------------------------------------------------------------------------------------------------------------------------------------------
------------------------------------------------------------------------------------------------------------------------------------------------------
-------------------------------------------------------------------------------------------S-------------%%-------------------------------------------
-------------------------------------------------------------------C-------%-----------------------------||-------------------------------------------
----------------%---------------------------------%------------------------|--------------g-----------%--||----%%--------------%----------------------
----------%-----|---------------------------------|---%---------------%%-%-%%--------------%-%%-------|--||%---||----%%%-------|-%%%%%%%--------------
----------|-%---|-----------------------------%---|---|---------------||-|-||--------------|-||-------|--|||---||----||%---%---|-|||||||----%%-----%--
%%%%%%%%%%|-|---|-%---------------%%%%F%%%----|---|---|-----------%%%%||%|-||--------------|-||-------|--|||---||----|||---|%%%|%|||||||----||%%%%%|%%
|||||||||||XXXXX|X|XXXXXXXXXX-XX-X||||X|||--XXX-XX|XXXXX----XXXXXX||||||||X||XXXXXXXXXXXXXX|X||XXXXXXX|XX|||XXX||--XX||XXXX|||||||||||||XXXX||||||||||