------------------------------------------------------------------------------------------------------------------------------------------------------
------------------------------------------------------------------------------------------------------------------------------------------------------
------------------------------------------------------------------------------------------------------------------------------------------------------
------------------------------------------------------------------------------------------------------------------------------------------------------
------------------------------------------------------------------------------------------------------------------------------------------------------
------------------------------------------------------------------------------------------------------------------------------------------------------
---------------------------------------------------------------------------------------%--------------------------------------------------------------
---------------------------------------------------------------------------------------|--------------------------------------------------------------
---------------------------------------------------------------------------------------|--------------------------------------------------------------
---------------------------------------------------------------------------------------|--------------------------------------------------------------
---------------------------------------------------------------------------------------|-------------------------------------%------------------------
--------------------------------%------%-----------------------------------------------|-------------------------------------|------------------------
--------------------------------|--%%--|-%---------------------------------------------|------------------------------%%%%%--|%-%%%%%-----------------
---------%----------------------|--||--|-|--------------------------------------------%|%%%%%-------------------------|||||--||-|||||----%%---%-------
%%%%%%%%%|-------%%--%%---------|--||--|-|%---------------------------------------%%%-|||||||----------------------%--|||||--||-|||||----||---|%------
||||||||||XXXXXXX||XX||XXXXXXXXX|XX||XX|X||XXXXXXXXXXXXXXXXXXXXXXXXXXXXXXXXXXXXXXX|||-|||||||XX-XXXXXXXXX-XXXXXXXXX|--|||||--||X|||||XXXX||X--||XXXXXX