------------------------------------------------------------------------------------------------------------------------------------------------------
------------------------------------------------------------------------------------------------------------------------------------------------------
------------------------------------------------------------------------------------------------------------------------------------------------------
------------------------------------------------------------------------------------------------------------------------------------------------------
------------------------------------------------------------------------------------------------------------------------------------------------------
------------------------------------------------------------------------------------------------------------------------------------------------------
------------------------------------------------------------------------------------------------------------------------------------------------------
------------------------------------------------------------------------------------------------------------------------------------------------------
------------------------------------------------------------------------------------------------------------------------------------------------------
------------------------------------------------------------------------------------------------------------------------------------------------------
------------------------------------------------------------------------------------------------------------------------------------------------------
--------------------------------------------------------------------------------------------%---------------------------------------------------------
-------------------------%%%%------------------%--%%%---------------------------------------|----%-----%-%-----%----%%--------------------%%%%-%---%%%
--------------------%----||||%%%-%%-%-%%-------|--|||------------------------%--------------|----|%--%-|-|-----|----||------------%-------||||-|-%-|||
%%%%%%%%-%%%%%------|----|||||||%||-|-||-------|--|||%%---%%%--%%%%%%-%%%%%%-|%%%%-%---%%%%-|-%%%||%%|%|-|%%---|----||------------|-----%-||||-|%|%|||
||||||||X|||||XXXXXX|XXXX||||||||||-|-||XXXXXXX|XX|||||---|||XX||||||X||||||XX||||X|XXX||||X|X||||||||||-|||XXX|X---||XXXXXXXXX---|XXXXX|X||||X||X||||