------------------------------------------------------------------------------------------------------------------------------------------------------
------------------------------------------------------------------------------------------------------------------------------------------------------
------------------------------------------------------------------------------------------------------------------------------------------------------
------------------------------------------------------------------------------------------------------------------------------------------------------
------------------------------------------------------------------------------------------------------------------------------------------------------
------------------------------------------------------------------------------------------------------------------------------------------------------
------------------------------------------------------------------------------------------------------------------------------------------------------
------------------------------------------------------------------------------------------------------------------------------------------------------
------------------------------------------------------------------------------------------------------------------------------------------------------
------------------------------------------------------------------------------------------------------------------------------------------------------
---------------------------------------------------------------------------------------------------------------------------------D----------------%---
--------------------------------------------------C------------------------------2----------------------------------------------------------------|---
----------------------------%%----%%%%--------------------------------------------------------%---%--------------%%------------------%-----------%|%%%
-------------%---%---%-%----||----||||----------------------------------------------%%--------|---|--------------||---%---------%%%%-|--%%%------|||||
%%%%%%%%%%%%%|%--|%%%|%|%%%%||----||||---------------------%---%--------%-----------||--------|---|--------------||%%%|---%--%%%||||-|--|||------|||||
|||||||||||||||XX|||||||||||||----||||X-XX-XXXXXXXXXXXXX---|XXX|XXXXXXXX|XXXX-XXXX-X||XXXXXXXX|XXX|XXXXXXXXXX----||||||---|--|||||||X|X-|||XXXXXX||||X