------------------------------------------------------------------------------------------------------------------------------------------------------
------------------------------------------------------------------------------------------------------------------------------------------------------
------------------------------------------------------------------------------------------------------------------------------------------------------
------------------------------------------------------------------------------------------------------------------------------------------------------
------------------------------------------------------------------------------------------------------------------------------------------------------
---------------------------------------------------%--------------------------r-----------------------------------------------------------------------
---------------------------------------------------|--------------------------%-----------------------------------------------------------------------
---------------------------------------------------|--------------------------|-----------------------------------------------------------------------
---------------------------------------------------|--------------------------|-----------------------------------------------------------------------
---------------------------------------------------|--------------------------|-----%-----------------------------------------------------------------
--------------------%------------------------------|--------------------------|-----|-----------------------------------------------------------------
--------------------|----------------------%%------|--------------------------|-----|------------------------g---------------------%------------------
--------------------|---------%-%---%%%----||------|--------------------------|-----|-----------------------%--%%%-%%---------%%---|--------%---%%%%--
--------%%--%%%%%%%%|%-%-%%%--|-|---|||%%--||----%-|%--%---%-----------%-%%%%%|%-%--|%------------%-------%-|--|||-||-----%---||---|--------|---||||%%
%%%%%%%%||--||||||||||%|%|||--|-|---|||||-%||---%|%||%-|%%%|%%-%----%%-|%|||||||-|--||--%%%%-%----|%%-----|-|--|||%||-----|--%||-%-|--------|%%%||||||
||||||||||--||||||||||||||||X-|-|-XX|||||X|||XXX||||||X|||||||X|XXXX||X|||||||||-|--||XX||||-|XXXX|||XXXXX|X|XX||||XXXXXXX|XX||XX|XXXXX-XXXX||||||||||