------------------------------------------------------------------------------------------------------------------------------------------------------
------------------------------------------------------------------------------------------------------------------------------------------------------
------------------------------------------------------------------------------------------------------------------------------------------------------
------------------------------------------------------------------------------------------------------------------------------------------------------
------------------------------------------------------------------------------------------------------------------------------------------------------
------------------------------------------------------------------------------------------------------------------------------------------------------
------------------------------------------------------------------------------------------------------------------------------------------------------
------------------------------------------------------------------------------------------------------------------------------------------------------
------------------------------------------------------------------------------------------------------------------------------------------------------
--------------------------------------------------------------------------------------------------------------t---------------------------------------
--------------------------------------------------------------------------------------------------------------t------------------------------------%--
----------------------------------------g---------------------------------------------------------------------%%-------------------------%---------|--
-------------------%--%-%--------%%--%--%----------%---%%%--------------%-%-----------%--------%%-------------||-------------%%%%%%%%%%%-|%--------|--
-------------------|--|-|--------||--|--|-------%%-|---|||--------------|-|-----%-----|--------||-%%%%%-%%%%%%||%%-----------|||||||||||-||--%%--%%|%-
%%%%%%%%----%%-----|--|%|--------||--|--|--%%%%%||-|---|||--------------|-|%---%|-----|----%---||-|||||-||||||||||-----------|||||||||||%||--||%%||||-
||||||||XXXX||-XXX-|XXX||XXXXX---||XX|XXXXX|||||||X|XXX|||XXXXXXX-XXXXXX|X||XXX||XXXXX|XXXX|XXX||-|||||X||||||||||XXXXXXXXX--||||||||||||||XX||||||||-