------------------------------------------------------------------------------------------------------------------------------------------------------
------------------------------------------------------------------------------------------------------------------------------------------------------
------------------------------------------------------------------------------------------------------------------------------------------------------
------------------------------------------------------------------------------------------------------------------------------------------------------
------------------------------------------------------------------------------------------------------------------------------------------------------
------------------------------------------------------------------------------------------------------------------------------------------------------
------------------------------------------------------------------------------------------------------------------------------------------------------
------------------------------------------------------------------------------------------------------------------------------------------------------
------------------------------------------------------------------------------------------------------------------------------------------------------
-----------------------------%------------------------------------------------------------------------------------------------------------------------
-----------------------%-----|---------------------------------%--------------------------------------------S-----------------------------------------
-----------------------|-----|---------------------------------|-------------------------------------------------------------k------------------------
-----------------------|--%--|-------------------%%------------|-----------------------------%-------------------------------------%------------------
--------%%%%%%%%-------|--|-%|k%%----%%%%%-------||%-----------|-----%%%%%%-%%-----%---------|---%------%%%-%---------------%----%%|-----%------------
%%%%%%%%||||||||-------|--|-||-||----|||||-------|||-----------|-----||||||-||%%---|---------|---|%%--%%|||-|%%%%%%---------|----|||--%%-|---%--------
||||||||||||||||XXXXXXX|XX|-||X||XXX-|||||----XXX|||XXXXXXXXXXX|XXX-X||||||X||||XXX|XXXXXXXXX|XXX|||XX|||||-|||||||XXXXXXXXX|X---|||-X||X|XXX|XXXXXXXX