------------------------------------------------------------------------------------------------------------------------------------------------------
------------------------------------------------------------------------------------------------------------------------------------------------------
------------------------------------------------------------------------------------------------------------------------------------------------------
------------------------------------------------------------------------------------------------------------------------------------------------------
------------------------------------------------------------------------------------------------------------------------------------------------------
------------------------------------------------------------------------------------------------------------------------------------------------------
---------------------------------S--------------------------------------------------------------------------------------------------------------------
------------------------------------------------------------------------------------------------------------------------------------------------------
------------------------------------------------------------------------------------------------------------------------------------------------------
---------------------------------%--------------------------------------------------------------------------------------------------------------------
---------------------------------|--------------------------------------------------------------------------------------------------------------------
---------------------------g-----|-----------------------%--------------------------------------------------------------------------------------------
-----------------%%%%%%-%%-------|-----%-----%-----------|---------------%---%%%%---%%------%----%-----------------%----------------------------------
-----------------||||||-||-------|-----|%%---|--%--------|---------------|---||||--%||--%%%%|%%%%|-%%-%-%%%%%------|--------------%%----------------%%
%%%%%%%%%%%%%%%%%||||||-||-------|-----|||---|--|--------|---------------|---||||%%|||--||||||||||-||-|-|||||%-----|%-----------%%||--------------%-||
|||||||||||||||||||||||-||XXXXXXX|X-XXX|||X--|XX|XXXXXXXX|XXXXXXX--XXXXXX|XXX|||||||||XX||||||||||-||X|-||||||X--XX||XXXXXX-XXXX||||XXXXXX-XXX-XXX|X||