------------------------------------------------------------------------------------------------------------------------------------------------------
------------------------------------------------------------------------------------------------------------------------------------------------------
------------------------------------------------------------------------------------------------------------------------------------------------------
------------------------------------------------------------------------------------------------------------------------------------------------------
------------------------------------------------------------------------------------------------------------------------------------------------------
------------------------------------------------------------------------------------------------------------------------------------------------------
------------------------------------------------------------------------------------------------------------------------------------------------------
------------------------------------------------------------------------------------------------------------------------------------------------------
------------------------------------------------------------------------------------------------------------------------------------------------------
------------------------------------------------------------------------------------------------------------------------------------------------------
------------------------------------------------------------------------------------------------------------------------------------------------------
------------------------------------------------------------------------------------------------------------------------------------------------------
---------%-%%F--%---------%--%%-%%%%---------%%---------------------%-----%%-%-------------------------------------%%-------%-%------------%%---%-----
---------|-||%-%|---------|--||-||||----%---%||---%%-%------%%%%%%%-|%--%-||S|---------------------------%---------||-------|-|-------%%%%%||%--|-----
%%%%%%%%%|%|||-||---------|--||-||||----|---|||---||-|----%%|||||||-||--|%||-|----------------%%---------|------%%%||-----%%|-|%%--%%%||||||||--|-----
||||||||||||||-||--XXX-XXX|-X||X||||-XXX|XXX|||XXX||X|XXX-|||||||||X||--||||X|XXXXXXX-XXXXXXXX||XXXXXXXXX|XXXXXX|||||XXXX-|||X|||--|||||||||||--|-XXXX