------------------------------------------------------------------------------------------------------------------------------------------------------
------------------------------------------------------------------------------------------------------------------------------------------------------
------------------------------------------------------------------------------------------------------------------------------------------------------
------------------------------------------------------------------------------------------------------------------------------------------------------
----------------------------------------------%-------------------------------------------------------------------------------------------------------
----------------------------------------------|-------------------------------------------------------------------------------------------------------
----------------------------------------------|-------------------------------------------------------------------------------------------------------
----------------------------------------------|-------------------------------------------------------------------------------------------------------
----------------------------------------------|---------------------------------------------------------------------C---------------------------------
---------------------%------------------------|--------------------------------------------------------------------------%----------------------------
---------------------|------------------------|--------------------------------------------------------------------------|----------------------------
---------------%-----|------------------------|-----------------------%--------------------------------------------------|----------------------------
---------------|-----|------------------------|---%-------------------|%%%---%%%%%---------------------------------%%----|----------------------------
--------%%%%%%%|-----|-%%----%-%%%%%%--------%|---|------------------%||||---|||||---------------------------%-%---||----|----------%-----------------
%%%%%%%%||||||||-%---|-||----|-||||||%%%%%%%%||---|---%%-----%-------|||||---|||||----%-%------%%%----%%%-%%-|%|-%-||----|%--%--%%--|------%%%%%%-----
|||||||||||||||XX|XXX|-||--XX|X||||||||||||||||--X|XXX||XX-XX|XXXXX--|X|||XXX|||||XXXX|-|XXXXXX|||XXXX|||X||X|||X|X||X---||--|--||XX|XXXXXX||||||XXXXX