------------------------------------------------------------------------------------------------------------------------------------------------------
------------------------------------------------------------------------------------------------------------------------------------------------------
------------------------------------------------------------------------------------------------------------------------------------------------------
------------------------------------------------------------------------------------------------------------------------------------------------------
------------------------------------------------------------------------------------------------------------------------------------------------------
------------------------------------------------------------------------------------------------------------------------------------------------------
------------------------------------------------------------------------------------------------------------------------------------------------------
------------------------------------------------------------------------------------------------------------------------------------------------------
------------------------------------------------------------------------------------------------------------------------------------------------------
------------------------------------------------------------------------------------------------------------------------------------------------------
-------------C--------------------------------------------t------------------%---------------------------------------------------------------------%--
----------------------------------------------------------t-%%---------------|---------------------------------------------------------------------|--
--------------------%--%------------------%%%%--%%%%%-%%%-%%||---%%-----%----|%--------------------------------------------------------%----------%|--
--------------------|-%|------------------||||--|||||-|||%||||---||-%%%-|-%--||-------%-----------------------------------------------%|%-%%----%-||--
%%%%%%%%%%%%%%%%%%%%|%||-%-%%-------------||||%-|||||-||||||||-%-||%|||-|%|%%||-------|--------%%%%%%----%---%%%-------------%%-------|||-||----|-||--
||||||||||||||||||||||||-|X||---XXX-XX----|||||X|||||X||||||XX-|-||||||-||||||XXXXXXXXXXXXXXXXX||||||-XXX|XXX|||XXXXXXXXXXXXX||XXXXXXX|||X||X-XX|X||XX