------------------------------------------------------------------------------------------------------------------------------------------------------
------------------------------------------------------------------------------------------------------------------------------------------------------
------------------------------------------------------------------------------------------------------------------------------------------------------
------------------------------------------------------------------------------------------------------------------------------------------------------
------------------------------------------------------------------------------------------------------------------------------------------------------
------------------------------------------------------------------------------------------------------------------------------------------------------
------------------------------------------------------------------------------------------------------------------------------------------------------
------------------------------------------------------------------------------------------------------------------------------------------------------
------------------------------------------------------------------------------------------------------------------------------------------------------
------------------------------------------------------------------------------------------------------------------------------------------------------
------------------------------------------------------------------------------------------------------------------------------------------------------
--------------%%---------------------------------------------------------------------------------------------------------------------------------2----
--------%----%||%%%%%%%---------%--------------%------------------%-----------%-------------------------------------%---------------------------------
--------|----||||||||||--%%%%F%%|%%%%----%%%-%%|-----------------%|-----------|-----------------------%%--%%%%%%%%-%|-%-------------------------------
%%%%%%%%|----||||||||||--||||%|||||||%%%%|||-|||--%%%%%%%%-------||-----------|---%---------%---------||--||||||||-||-|-------%--%--------------------
|||||||||-X--||||||||||XX|||||||||||||||||||X|||XX||||||||XXXXXXX||-XXXXXXXXXX|XXX|XXXXXXXXX|XXXXXXX-X||--||||||||-||X|XXXXXX-|XX|X-XX-XXXXXXXXXXXXXXX