------------------------------------------------------------------------------------------------------------------------------------------------------
------------------------------------------------------------------------------------------------------------------------------------------------------
------------------------------------------------------------------------------------------------------------------------------------------------------
------------------------------------------------------------------------------------------------------------------------------------------------------
------------------------------------------------------------------------------------------------------------------------------------------------------
------------------------------------------------------------------------------------------------------------------------------------------------------
----------------------------------------------------------------------------------------------------------------%-------------------------------------
----------------------------------------------------------------------------------------------------------------|------------------%------------------
----------------------------------------------------------------------------------------------------------------|------------------|------------------
----------------------------------------------------------------------------------------------------------------|------------------|------------------
---------------------------------------------------------------------------------------------------------%------|------------------|------------------
--------------------------------------------%------------------------------------------------------------|------|------------------|------------------
---------%------%------G-----------------%--|--%-------%%%------%------------------------------------%%%%|------%-----%%%-%%-------|------------------
---------|------|---%--%%-------------%--|--|--|-------|||-%----|-----%%%%---%%%%%------%----------%-|||||------|-----|||-||-------%-%%%%---%%%----%--
%%%%%%%%%|------|---|--||-%%%%-%%%%%%%|-%|%-|%%|-%-----|||-|----|----%||||---|||||------|%%%-%----%|-|||||------|-----|||-||---%%%%|-||||---|||%---|--
||||||||||XXXXXX|XXX|X-||-||||-||||||||X|||-X|||-|XXX-X|||X|XXXX|XXXX|||||XX-|||||XXX---||||X|XXXX||X|||||XX-XXX|XXXXX|||X||XXX|||||-||||---||||XXXXXX