------------------------------------------------------------------------------------------------------------------------------------------------------
------------------------------------------------------------------------------------------------------------------------------------------------------
------------------------------------------------------------------------------------------------------------------------------------------------------
------------------------------------------------------------------------------------------------------------------------------------------------------
------------------------------------------------------------------------------------------------------------------------------------------------------
------------------------------------------------------------------------------------------------------------------------------------------------------
------------------------------------------------------------------------------------------------------------------------------------------------------
------------------------------------------------------------------------------------------------------------------------------------------------------
------------------------------------------------------------------------------------------------------------------------------------------------------
------------------------------------------------------------------------------------------------------------------------------------------------------
---------------------------------------------------------------------%--------------------------------------------------------------------------------
------------------------------------2--------------------------------|----------------%---------------------------------------------------------------
----------------------------------------------------C-%-----%-------%|-%-%--%----%%%%-|%%-%---------%-%%%%%%%%-%-%-----%%%--------------------%%%--%--
----------%-%%%%-----%--------%%%%---%----------------|-----|-%---%%||-|%|%%|%---||||-|||-|---------|-||||||||-|-|-----|||------%--%---%%%%---|||--|--
%%%%%%%%--|-||||-----|--%%----||||-%-|-----%----------|-----|-|---||||-|||||||---||||-|||-|---------|-||||||||-|-|%%%--|||-%----|--|%%%||||---|||%%|--
||||||||-X|-||||--X--|XX||XXXXX|||X|XXXXXXX|XXXXXXXXXXXXXXXX|X|X--||||-|||||||XXX||||-|||X|XXXXX-X--|-||||||||X|X||||XX|||X|XXXX|XX||||||||XXXXXX||XXX