------------------------------------------------------------------------------------------------------------------------------------------------------
------------------------------------------------------------------------------------------------------------------------------------------------------
------------------------------------------------------------------------------------------------------------------------------------------------------
------------------------------------------------------------------------------------------------------------------------------------------------------
------------------------------------------------------------------------------------------------------------------------------------------------------
---------------------------------------------------------------------------------------------------------------------------------S-----------------D--
------------------------------------------------------------------------------------------------------------------------------------------------------
------------------------------------------------------------------------------------------------------------------------------------------------------
------------------------------------------------------------------------------------------------------------------------------------------------------
------------------------------------------------------------------------------------------------------------------------%%%---------------------------
------------------------------------------------------------------------------------------------------------------------|||---------------------------
-----------------------------------------------------------------------C---%---------------------CS---------------------|||---------------------------
-----------------------------------------------------%--%%%%%--------------|-----------------------%%%%%%%%--------%--%-|||%%--------------%---------%
-----------------------------------------------------|-%|||||---------%----|%----------------------||||||||--------|--|%|||||--------------|-------%-|
%%%%%%%%---%%%---------------------------------------|-||||||---------|----||----%--------------%--||||||||%--%%%%-|--|||||||-%%%-%%%%%%---|-%%%%%-|-|
||||||||XXX|||-XXXXXXXXXXXXXXXXXXXXXXXXXXXXXXXXXXXXXX|X||||||XXXXXXXXX|X--XX|XXXX|XXXXXXXXXXXXXX|XX|||||||||X-||||X|XX|||||||X|||X||||||XXX|X|||||X|-|