------------------------------------------------------------------------------------------------------------------------------------------------------
------------------------------------------------------------------------------------------------------------------------------------------------------
------------------------------------------------------------------------------------------------------------------------------------------------------
------------------------------------------------------------------------------------------------------------------------------------------------------
------------------------------------------------------------------------------------------------------------------------------------------------------
------------------------------------------------------------------------------------------------------------------------------------------------------
--------------------------------------------------------%---------------------------------------------------------------------------------------------
--------------------------------------------------------|---------------------------------------------------------------------------------------------
--------------------------------------------------------|---------------------------------------------------------------------------------------------
--------------------------------------------------------|---------------------------------------------------------------------------------------------
--------------------------------------------------------|------%--------------------------------------------------------------------------------------
--------------------------------------------------------|------|---------------------------------------------%----------------------------------------
--------------------------------------%--%%%%-%%%%------|------|---------------------------------------------|%--%%%------%------------------%--------
-------------%--%%--------------------|--||||-||||%%----|------|---------------------------------------------||--|||------|--------%%--%%%---|-%%%----
%%%%%%%%%%---|--||%-------------------|--||||-||||||%-%%|%%%%-%|%-%%%%%%%%%%%%-%%%%----------------%%---%%%%%||%%|||%%%--%|----%%--||--|||%%-|-|||%%%%
||||||||||XX-|XX|||XXXXXXXXXXXXX-XXXXX|XX||||X|||||||X|||||||-|||-||||||||||||X||||X-XXXXXXXXXX-XXX||X--|||||X|||||||||--||----||-X||--|||||-|X|||||||