------------------------------------------------------------------------------------------------------------------------------------------------------
------------------------------------------------------------------------------------------------------------------------------------------------------
------------------------------------------------------------------------------------------------------------------------------------------------------
------------------------------------------------------------------------------------------------------------------------------------------------------
------------------------------------------------------------------------------------------------------------------------------------------------------
-----------------------------------------------------------------%----------------------------------------------t-------------------------------------
-----------------------------------------------------------------|----------------------------------------------t-------------------------------------
-----------------------------------------------------------------|----------------------------------------------%-------------------------------------
-----------------------------------------------------------------|----------------------------------------------|-------------------------------------
--------------------------------------------g--------------------|----------------------------------------------|-------------------------------------
--------------------------------------------|--------------------|%-------------------------------%-------------|-------------------------------------
--------------------------------------------|----2---------------||-------------------------------|-------------C-------------------------------------
-------------------%%%%%-%%%-%%-------------|--%----%%-%%%%%%%%-%||-------%-----------------------|---------------------------------------------------
-----------%--%%%%%|||||-|||-||----------%%-%--|----||-||||||||-|||-------|-----------------------|------------------------------------%%%%%%%%%%--%%%
%%%%%%%%%--|--||||||||||-|||-||----------||-|--|----||-||||||||-|||%%%%%--|-%---------------------|------------------------%-%%%%------||||||||||--|||
|||||||||XX|XXXXXXX|||||X|||-||XXXXXX--XX||X|XX|-XXX||X||||||||X||||||||-X|X|XXXXXXXXXXXXXXXXXXXXX|XXX-XXXXXXXXXXX-XXXXXXXX|X||||XXXXXX||||||||||-X|||