------------------------------------------------------------------------------------------------------------------------------------------------------
------------------------------------------------------------------------------------------------------------------------------------------------------
------------------------------------------------------------------------------------------------------------------------------------------------------
------------------------------------------------------------------------------------------------------------------------------------------------------
------------------------------------------------------------------------------------------------------------------------------------------------------
------------------------------------------------------------------------------------------------------------------------------------------------------
------------------------------------------------------------------------------------------------------------------------------------------------------
----------------------------------------------------------------------------------------------t-----------------------%---S---------------------------
----------------------------------------------------------------------------------------------t-----------------------|-------------------------------
----------------------------------------------------------------------------------------------t-----------------------|-------------------------------
----------------------------------------------------------------------------------------------t-----------------------|-------------------------------
--------------#-------------------------------------------------------------------------------%-----------------------|-------------------------------
-----------%%-%--------%%--%------------%--%-----------------%--%%------------------------%--%|-----------------------|------%---%---%%%--------------
-----------||-|--------||--|--%%%-------|--|-----------t-----|--||------%%%%--------------|--||-----------------------|-----%|---|-%-|||-%%----------%
%%%%%%%%%%%||-|----%%%-||--|--|||---%--%|--|-----------t-%---|--||%%%%%%||||%----%--------|--||--------------------%%%|%%%--||---|-|-|||-||---%------|
||||||||||||XX|XXXX|||X||--|XXXXXXXX|XX||XX|-XXXXXXXXXXX-|--X|XX|||||||||||||XX-X|XXXXXXXX|XX|XXXXXXXXXXXXXXXXXXXXX|||||||--||XXX|X|-|||-||XXX|---X-X|