------------------------------------------------------------------------------------------------------------------------------------------------------
------------------------------------------------------------------------------------------------------------------------------------------------------
------------------------------------------------------------------------------------------------------------------------------------------------------
------------------------------------------------------------------------------------------------------------------------------------------------------
------------------------------------------------------------------------------------------------------------------------------------------------------
------------------------------------------------------------------------------------------------------------------------------------------------------
------------------------------------------------------------------------------------------------------------------------------------------------------
------------------------------------------------------------------------------------------------------------------------------------------------------
---------------------------------------------------------------------------%-------------------------------------------t------------------------------
---------------------------------------------------------------------------|-------------------------------------------t------------------------------
---------------------------------------------------------------------------|-------------------------------------------t------------------------------
---------------------------------------------------------------------------|-------------G-----------------------------%------------------------------
------------%%%--%%--%------------------------------%-%%-------------------|------%------%---------------------------%%|%%-%%%----%-------------------
------------|||%-||-%|%%%%%%%--------------%---%-%--|%||%-%-%-%%%----------|------|------|------%%%%%-%%%%%%%%%%-----|||||-|||%-%%|-%-%---%%%%%%%%%%--
%%%%%%%%-%--||||-||-|||||||||--------------|---|-|--|||||-|-|-|||----------|%-----|------|-%%%%%|||||-||||||||||-----|||||-||||%|||-|-|---||||||||||%%
||||||||-|XX||||X||X|||||||||XXXX-XXXXXXXXX|XXX|X|XX|||||X|X|X|||XXXXXXXXXX||X-XXX|XXXX-XXX||||||||||X||||||||||XXXXX|||||-||||||||X|-|XX-||||||||||||