------------------------------------------------------------------------------------------------------------------------------------------------------
------------------------------------------------------------------------------------------------------------------------------------------------------
------------------------------------------------------------------------------------------------------------------------------------------------------
------------------------------------------------------------------------------------------------------------------------------------------------------
------------------------------------------------------------------------------------------------------------------------------------------------------
------------------------------------------------------------------------------------------------------------------------------------------------------
------------------------------------------------------------------------------------------------------------------------------------------------------
------------------------------------------------------------------------------------------------------------------------------------------------------
------------------------------------------------------------------------------------------------------------------------------------------------------
-------------------------------------------------------------------------------------%%----------%--%-------------------------------------------------
-------------------------------------------------------------------------------------||----------|--|---------------%%--------------------------------
-------------------------------------------------------------------------------------||----------|--|---------------||--------------------------------
-----------%-------------------------%-------%-----------%---------------------%%%%--||--%%%--%--|%%|---------------||%%------%-----------------------
-----------|-------------------------|-------|-----------|--%%-%%-%------------||||--||--|||-%|-%||||%------%%%%--%-||||------|-------%%-----g--------
%%%%%%%%---|-------------------------|-------|-----------|--||%||-|---#-----%--||||--||--|||-||-||||||------||||--|-||||------|-%%----||%%%%%%%%%%%%%-
||||||||XXX|XXXXXXXXXXXXXXXXXXXXXXXXX|XXXXXXX|XXXXXXXXXX-|XX|||||X|XX-XXXXXX|--||||--||-X|||-||X||||||X--XXX||||--|-||||XXXXXX|X||XXXX|||||||||||||||-