------------------------------------------------------------------------------------------------------------------------------------------------------
------------------------------------------------------------------------------------------------------------------------------------------------------
------------------------------------------------------------------------------------------------------------------------------------------------------
------------------------------------------------------------------------------------------------------------------------------------------------------
------------------------------------------------------------------------------------------------------------------------------------------------------
------------------------------------------------------------------------------------------------------------------------------------------------------
---------t--------------------------------------------------------------------------------------------------------------------------------------------
---------t--------------------------------------------------------------------------------------------------------------------------------------------
---------%--------------------------------------------------------------------------------------------------------------------------------------------
---------|-----------------------------------------------------------------------------------------------------------------------%%-------------------
---------|-----------------------------------------------------------------------------------------------------------------------||-------------------
---------|-----g-----------------------------------------------------------------------------------------------------------------||-----------t-------
---------|------------%-----------------------------%%%-%%S------------------------------%-%--------%-----------------%-%-%%%%--%||-----------t%------
--------%|------------|-----------------------------|||%||-------------------------------|-|--------|-----------------|-|-||||--|||-----------%|------
%%%%%%%%||%%%%%-------|-----------------------------||||||------------------------------%|-|--------|-----------------|-|-||||--|||---%-%-%%%%||------
|||||||||||||||XXXXXXX|XXXXXX--XXX-XXXXXXXXXXXXXXXXX|||X||XXXXXXXXXXX--XXXXXXXXXXXXXXXXX||-|XXX---XX|XXX--XXXXXXXXXXXX|X|X||||--|||--X|X|X||||||XXXXXX