------------------------------------------------------------------------------------------------------------------------------------------------------
------------------------------------------------------------------------------------------------------------------------------------------------------
------------------------------------------------------------------------------------------------------------------------------------------------------
------------------------------------------------------------------------------------------------------------------------------------------------------
------------------------------------------------------------------------------------------------------------------------------------------------------
------------------------------------------------------------------------------------------------------------------------------------------------------
-----------------------------------------------------------------------------------------------%------------------------------------------------------
-----------------------------------------------------------------------------------------------|------------------------------------------------------
-----------------------------------------------------------------------------------------------|-------------------------------------%----------------
----------------------------%---------------------------------------------------------%%-------|-------------------------------------|----------------
----------------------------|---------------------------------------------------------||-------|-------------------------------------|----------------
----------------------------|------------------------%--------------------------------||-------|-------------------------------------|----------------
--------------%%---%---%-%--|------------------------|%S%---------------%%-%%---%%-%--||------%|%%%-----------------%---%----%-------|-----%----------
--------------||---|---|%|--|------------------------||-|-%--%%%--------||-||---||-|--||------|||||-----%%-------%%-|---|----%-------|-----|--------%-
%%%%%%%%%%%%%-||%%-|---|||--%-------%----------------||-|-|--|||-----%%%||%||%%%||-|%%||----%-|||||-----||-------||-|%%%|----|-------|-----|--------|-
|||||||||||||X||||-|XX-||X-X|XXXXX--|XXXXXXXXXXXXXX--XXXX-|XX|||XXXXX|||||||||||||X|||||XX--|-|||||-----||XXXXXXXXXX|||||XX-XXXXXXXXX|XXXXX|XXXXXXXX|X