------------------------------------------------------------------------------------------------------------------------------------------------------
------------------------------------------------------------------------------------------------------------------------------------------------------
------------------------------------------------------------------------------------------------------------------------------------------------------
------------------------------------------------------------------------------------------------------------------------------------------------------
------------------------------------------------------------------------------------------------------------------------------------------------------
------------------------------------------------------------------------------------------------------------------------------------------------------
------------------------------------------------------------------------------------------------------------------------------------------------------
------------------------------------------------------------------------------------------------------------------------------------------------------
------------------------------------------------------------------------------------------------------------------------------------------------------
------------------------------------------------------------------------------------------------------------------------------------------------------
------------------------------------------------------------------------------------------------------------------------------------------------------
--------%-%%%-----------------------------------------------------------------------------------------------------------------------------------------
--------|%|||----------%%-%------%%-%%--%----------------%------%------------------------------%%%%%%%%%%%------------------------%-------------------
--------|||||-----%----||-|------||-||%%|%%%%%-----------|------|-%%%%-%%%-------%--%-------%--|||||||||||------------------------|--------g----------
%%%%%%%%|||||%-%%-|----||-|%-----||-||||||||||-----------|----%-|-||||-|||%%%%%%-|--|F-%%%%%|%%|||||||||||---------%---%%---------|--%------%%--------
||||||||||||||-||X|XXXX||-||-----||X||||||||||XXXXXXXXXXX|---X|X|X|X||X|||||||||-|XX|XX|||||||||||||||||||-XXXXXXX-|XXX||XX--XXXXX|XX|XX--X-||XXXXXXX-