------------------------------------------------------------------------------------------------------------------------------------------------------
------------------------------------------------------------------------------------------------------------------------------------------------------
------------------------------------------------------------------------------------------------------------------------------------------------------
------------------------------------------------------------------------------------------------------------------------------------------------------
------------------------------------------------------------------------------------------------------------------------------------------------------
------------------------------------------------------------------------------------------------------------------------------------------------------
------------------------------------------------------------------------------------------------------------------------------------------------------
------------------------------------------------------------------------------------------------------------------------------------------------------
-------------------------------------------------------------------------------------------------------------------------------------------%----------
----------------------------------------------%--------------------------------------------------------------------------------------------|----------
----------------------------------------------|--------------------------------------------------------------------------------------------%----------
----------------------------------------------|--------------------------------------------------------------------------------------------|----------
------------------------------------%%--------|-------------------------------------------------%-------------------------------------%%---%----------
------------------------------------||--------|--%%-%%%%%---------------------%-%%--------------|------g-----------------%---%%%%-----||%%-|----------
%%%%%%%%%-%%%-----------------------||----%---|%%||-|||||------------%--%-----|-||%-----------%-|------------------------|---||||%%%%-||||-|-------%--
|||||||||-|||X-XXXXXXXXX---XXXX-XXXX||XXXX|XXX|||||X|||||X-XXXXXXXXXX|--|XXXXX|X|||XXXXXXXXXXX|X|XXXXXXXXXXXXXXXXXXXXXXXX|-XX||||||||X||||-|XXXXXXX|XX