------------------------------------------------------------------------------------------------------------------------------------------------------
------------------------------------------------------------------------------------------------------------------------------------------------------
------------------------------------------------------------------------------------------------------------------------------------------------------
------------------------------------------------------------------------------------------------------------------------------------------------------
------------------------------------------------------------------------------------------------------------------------------------------------------
------------------------------------------------------------------------------------------------------------------------------------------------------
-------------------------------------------------------------------%----------------------------------------------------------------------------------
-------------------------------------------------------------------|----------------------------------------------------------------------------------
-------------------------------------------------------------------|----------------------------------------------------------------------------------
-------------------------------------------------------------------|----------------------------------------------------------------------------------
-------------------------------------------------------------------|--------------------------------------------%---%-----------------------------%-%-
----------------------------------------------2--------------------|------------------------------%--------%---S|---|-----------------------------|-|-
----------------------------------%%--%%--------------------------%|-----------------%%-----------|--------|----|---|%%-%%--%%%%%%%%%%----%-%%-%%-|%|%
---------------------------%%%%-%%||%%||--------------------------||----------------%||-%%--------|--------|----|---|||-||--||||||||||----|-||-||-||||
%%%%%%%%%%%%------%--------||||-||||||||-%---------------------%%%||--%%%%%%%%%-----|||-||-------%|------%-|----|---|||-||--||||||||||----|-||-||-||||
||||||||||||--XXXX|XXXXX--X||||X||||||||X|XXXXXXXXXXXXXXXXXXXXX|||||--|||||||||XXXXX|||X||XXXXXXX||XXX-XX|X|-XXX|XXX|||X||XX||||||||||XXXX|X||X||X||||