------------------------------------------------------------------------------------------------------------------------------------------------------
------------------------------------------------------------------------------------------------------------------------------------------------------
------------------------------------------------------------------------------------------------------------------------------------------------------
------------------------------------------------------------------------------------------------------------------------------------------------------
------------------------------------------------------------------------------------------------------------------------------------------------------
------------------------------------------------------------------------------------------------------------------------------------------------------
------------------------------------------------------------------------------------------------------------------------------------------------------
------------------------------------------------------------------------------------------------------------------------------------------------------
------------------------------------------------------------------------------------------------------------------------------------------------------
------------------------------------------------------------------------------------------------------------------------------------------------------
----------------------------------------------------------------------------------------------------------------------------------------------%%------
-------------------%--------------------------------------------------------------------------------------------------------------------------||------
-------------------|-----------------%---------------------------------------%----------------------------------%------------%----------------||------
-------------------|------------%----|--%--%--%%-%%%%------------%-----------|----------------------%-----------|%%%----%----|------%---------||--%--%
%%%%%%%%-%%%%%%---%|%%----------|----|--|--|--||-||||%-%---------|-----------|----------------------|---------%-||||--%%|%-%-|------|%--%-----||--|--|
||||||||-||||||XXX|X||XXXXXXXXXX|XXXX|XX|X-|XX||-|||||X|XXXXXXXXX|XX---XXXXXX|XXXXXXXXXXXXXXXX-XXXXX|XXXXXXXX-|X||||X-||||-|-|XXXXXX||XX|XXXXX||XX|--|