------------------------------------------------------------------------------------------------------------------------------------------------------
------------------------------------------------------------------------------------------------------------------------------------------------------
------------------------------------------------------------------------------------------------------------------------------------------------------
------------------------------------------------------------------------------------------------------------------------------------------------------
------------------------------------------------------------------------------------------------------------------------------------------------------
------------------------------------------------------------------------------------------------------------------------------------------------------
------------------------------------------------------------------------------------------------------------------------------------------------------
--------------------------------%---------------------------------------------------------------------------------------------------------------------
--------------------------------|---------------------------------------------------------------------------------------------------------------------
--------------------------------|---------------------------------------------------------------------------------------------------------------------
--------------------------------|---------------------------------------------------------------------------------------------------------------------
--------------------------------|---------------------------------------------------------------------------F-------%%%%%-----------------------------
-----------%-%%----%%----%------|-------------------%%----------%%-------------------2----------------------%-------|||||--------%%%-%----------------
-----------|-||----||----|----%%|%%%----------------||----------||-----%%-------------%--------------------#|---%%%%|||||--------|||-|------%%%%--%---
%%%%%%%%%--|-||-%--||----|----||||||--------------%-||----------||-----||%%-----------|--------------------#|--%|||||||||%%------|||-%------||||--|%--
|||||||||-X|-||-|XX||-XXX|-XXX||||||XXXXXXXXXXXXXX|X||XXXXXXXX-X||XXXXX||||XXX---XXX-X|---XXXXXXXXXXXXXXXXXX|X-|||||XXXXX||XXXXXX|||X|XXXXXX||||XX||XX