------------------------------------------------------------------------------------------------------------------------------------------------------
------------------------------------------------------------------------------------------------------------------------------------------------------
------------------------------------------------------------------------------------------------------------------------------------------------------
------------------------------------------------------------------------------------------------------------------------------------------------------
--------------------------------------------------------------------------------------------------%---------------------------------------------------
--------------------------------------------------------------------------------------------------|---------------------------------------------------
--------------------------------------------------------------------------------------------------|---------------------------------------------------
--------------------------------------------------------------------------------------------------|---------------------------------------------------
--------------------------------------------------------------------------------------------------|---%-----------------------------------------------
--------------------------------------------------------------------------------------------------|---|-----------------------------------------------
----------------------------------%-%-------------------------------------------------------------|---|-----------------------------------------------
----------------------------------|-|-------------------------------------------------------------|---|-----U-----------------------------------------
----------%%%---------------------|-|-------%---%---------------------------------------%-------%-|---|-----------%---%%---------%-%------------%-----
----------|||%-------------------%|-|-------|---|---------------------------------------|-------|-|---|-----------|---||---------|-|------------|-----
%%%%%%%%%%||||------%-%%---------||-|%------|---|--------%----------------------------%-|-------|%|%--|-----------|%-%||---------|-|------------|-----
||||||||||||||XXXXXX|X||XXXXXXXXXX|X||XXXXXX|XXX|XX-XXXXX|XXXXXXXXXXXXXXXXXXXX-XXXXXXX|X|-XXXXXX||||XXXXX---XXXXXX||X||XXXX-XXXXX|X|XXXXXXXX-XXX|XXXXX