------------------------------------------------------------------------------------------------------------------------------------------------------
------------------------------------------------------------------------------------------------------------------------------------------------------
------------------------------------------------------------------------------------------------------------------------------------------------------
------------------------------------------------------------------------------------------------------------------------------------------------------
------------------------------------------------------------------------------------------------------------------------------------------------------
------------------------------------------------------------------------------------------------------------------------------------------------------
------------------------------------------------------------------------------------------------------------------------------------------------------
------------------------------------------------------------------------------------------------------------------------------------------------------
------------------------------------------------------------------------------------------------------------------------------------------------------
------------------------------------------------------------------------------------------------------------------------------------------------------
--------------------------------------------%-------------------------------%-------------------------------------------------------------------------
---------g----------------------------------|%----------%%%-----------%-----|%------------------------------------------------------------------------
----------------------------%--%------------||-------%--|||-----------|-----||--%----------------------------------%-----%%---------------------------
----------------------------|--|-%-%%%%%%-%-||%%%%%--|%%|||--%%%------|%%--%||--|----------------------------------|-----||---------------------------
%%%%%%%%--------------------|--|-|-||||||-|-|||||||%%||||||--|||----%%|||--|||--|---------------%--%%%------%%---%-|-----||--------------------%%%----
||||||||XXXXXXXXXXXXXXXXXX--|XX|-|-||||||-|X|X|||||||||||||-X|||XXXX|||||X-||XXX|X-XXXXX--XX-XXX|XX|||XXXXXX||XXX|X|-----||XXXXXXXXXXXXXXXXXXXX|||XXXX