------------------------------------------------------------------------------------------------------------------------------------------------------
------------------------------------------------------------------------------------------------------------------------------------------------------
------------------------------------------------------------------------------------------------------------------------------------------------------
------------------------------------------------------------------S-----------------------------------------------------------------------------------
--------------------------%---------------------------------------------------------------------------------------------------------------------------
--------------------------|---------------------------------------------------------------------------------------------------------------------------
--------------------------|---------------------------------------------------------------------------------------------------------------------------
--------------------------|---------------------------------------%-----------------------------------------------------------------------------------
--------------------------|---------------------------------------|-----------------------------------------------------------------------------------
----------------%---------D---------------------------------------|-----------------------------------------------------------------------------------
-------------%--|-------------------------------------------------|--------------------------------------------------------%--------------------------
-------------|--|%%------------%----------------------------------|--------------------------------------------%-----------|---------------%%%-%------
-------------|%-|||%%%%------%-|----------------%%----------------|----------------------------------------%---|-----%---%-|-%%------------|||-|------
-------------||-|||||||-----%|-|%%---------%%%--||-%%---%%%%-%%---%----------------------------------------|%--|-----|---|-%%||-%%-%-%%%%%-|||-|------
%%%%%%%%%%%--||-|%%||||%----||-|||%%%%%--%-|||-%||%||---||||-||---|---------------%-------%----------------||--|-----|---|-||||%||-|-|||||%|||-|------
|||||||||||XX||X||||||||XX-X||-X|||||||XX|-|||X||||||X--||||X||XXX|XXXXXXXXXXXXXXX|XXXXXXX|XXXXXXXXXXXXXXXX||XX|---XX|XXX|X|||||||-|X||||||XXXXXXXXXXX