------------------------------------------------------------------------------------------------------------------------------------------------------
------------------------------------------------------------------------------------------------------------------------------------------------------
------------------------------------------------------------------------------------------------------------------------------------------------------
------------------------------------------------------------------------------------------------------------------------------------------------------
------------------------------------------------------------------------------------------------------------------------------------------------------
------------------------------------------------------------------------------------------------------------------------------------------------------
------------------------------------------------------------------------------------------------------------------------------------------------------
------------------------------------------------------------------------------------------------------------------------------------------------------
-----------------------------------------------------------------------------------------------------------------------------------g------------------
------------------------------------------------------------------------------------------------------------------------------------------------------
------------------------------------------------------------------%-----------------------------------------t---------------------------t%------------
----------------------------K------------------------S------------|-----------------------------------------t--------------------------%T|--------gg--
----------------------------%------------%------------------------|%%----%-%--------------------------------t-------%-------------%%---%t|%-----------
-----------------------%%%--|------------|-----%------------------|||----|-|-%--%-------------------%-----%%%%%%%---|------%%-%%--||%--|%%|%%%%%----%%
%%%%%%%%%%%%-%%%%--%%%%|||--|------------|-%---|------------------|||---%|-|-|--|-----------%%%%%%%-|---%%|||||||%%-|------||-||--|||--|||||||||-%--||
||||||||||||X||||XX|||||||XX|XXXXXXXXXXXX|X|XXX|XXXXXXXXXXXXXXXXXX|XXXXX||X|-|X-|XXXXXXXXXXX|||||||X|X--|||||||||||-|XXXXXX||X||XX|||--X||||||||X|XX||