------------------------------------------------------------------------------------------------------------------------------------------------------
------------------------------------------------------------------------------------------------------------------------------------------------------
------------------------------------------------------------------------------------------------------------------------------------------------------
------------------------------------------------------------------------------------------------------------------------------------------------------
------------------------------------------------------------------------------------------------------------------------------------------------------
------------------------------------------------------------------------------------------------------------------------------------------------------
------------------------------------------------------------------------------------------------------------------------------------------------------
------------------------------------------------------------------------------------------------------------------------------------------------------
------------------------------------------------------------------------------------------------------------------------------------------------------
------------------------------------------------------------------------------------------------------------------------------------------------------
------------------------------------------------------------------------------------------------------------------------------------------------------
------------------------------------------------------------------------------------------------------------------------------------------------------
----------------%---------------------------------------------------------------------%----%-------------------------------%%%--------%%--------------
----------------|-------------------------%%----------------------------------------%%|----|----------%%%%%%%%----------%%-|||%%------||---%%%%%%%%%--
%%%%%%%%%%%-----|-----%----%%%-%%%%%%%%---||----------%-%%--------------------------|||%%%-|-------%%%||||||||%-%-------||-|||||-%%---||---|||||||||--
|||||||||||X--XX|XXX-X|-XXX|||-||||||||XXX||XXXXXX-XXX|X||XXXXXX-XXXXXXXXXXXXXXXXXXX||||||X|XXXXXXX||||||||||||-|X------||-|||||-||---||-XX|||||||||XX