------------------------------------------------------------------------------------------------------------------------------------------------------
------------------------------------------------------------------------------------------------------------------------------------------------------
------------------------------------------------------------------------------------------------------------------------------------------------------
------------------------------------------------------------------------------------------------------------------------------------------------------
------------------------------------------------------------------------------------------------------------------------------------------------------
------------------------------------------------------------------------------------------------------------------------------------------------------
-----------------------------------S------------------------------------------------------------------------------------------------------------------
-----------------------------------------------------------------------------%------------------------------------------------------------------------
-----------------------------------------------------------------------------|--S---------------------------------------------------------------------
-----------------------------------%-T---------------------------------------|-----%------------------------------------------------------------------
-----------------------------------|-t---------------------------------------|-----%-------------------------%-----------------------%----------------
-----------------------------------|-t---------------------------------------|-----|------------------------%|-----------------------|----------------
-------------------------%%-%%%%%%-|%%%--%-----%%%----%-------%%%%%-%%%%%%%--|--%--|#--------------%--------||-----------------------|-----------%-%--
-------------------------||-||||||-||||--|-----|||----|----%-%|||||-|||||||--|%%|%%%%--%%%%%-------|--------||--%----%%%%%-%--%%-%%--|-%---------|-|--
%%%%%%%%%%%%%%%%%--------||-||||||-||||%%|%%%%-|||----|--%%|%||||||-|||||||--||||||||--|||||--%----|%%------||--|----|||||-|%%||-||--|-|-%%%%%%%%|%|--
|||||||||||||||||XXXX-XXX||-||||||-|||||||||||-|||XXXX|-X||||||||||X|||||||--||||||||--|||||XX|XXXX|||XXX---X|XX|XXXX|||||-|||||-||XX|X|X|||||||||||--