------------------------------------------------------------------------------------------------------------------------------------------------------
------------------------------------------------------------------------------------------------------------------------------------------------------
------------------------------------------------------------------------------------------------------------------------------------------------------
------------------------------------------------------------------------------------------------------------------------------------------------------
------------------------------------------------------------------------------------------------------------------------------------------------------
-------------------------------------------------------------------------------------------------------------------------D----------------------------
------------S-----------------------------------------------------------------------------------------------------------------------------------------
----------------------------------------------------------------------------------------------------------------------------------%-------------------
-----------------------------------------------------------------------%-------------------------------------------------t--------|-------------------
--------------%--------------------------------------------------------|-------------------------------------------------t--------|------%------------
---------%-%%%|--------------------------------------------------------|-------%-----------------------------------------t--%-----|------|S-----------
---------|-||||--------------------------------------------------------|-------|-----------------------------------------%--|-----%------|---S--------
---------|-||||----------%---------------------------%%%-%---------%--%|-------|-----------------------------------------|--|-----|------|--%-%%%%----
---------|-||||----------|-------------%----%--------|||%|%--------|%-||%%-----|--------%--------------------------------|--|-----|-%----|%-|-||||----
%%%%%%%%%|-||||-------%%%|--#---%%%%---|----|%%%%----||||||--------||-||||-----|---%%%%%|-----------------------------%--|--|--%--|-|----||-|-||||----
||||||||||X||||XXXXXXX||||XXXXXX||||XXX|XX-X|||||XX--||||||XXXXXXXX||X||||XXXXX|XXX||||||XXXXXXXXXX-XXXXXXXXXX------XX|XX|XX|XX|XX|-X--XX||X|X||||XXX-