------------------------------------------------------------------------------------------------------------------------------------------------------
------------------------------------------------------------------------------------------------------------------------------------------------------
------------------------------------------------------------------------------------------------------------------------------------------------------
------------------------------------------------------------------------------------------------------------------------------------------------------
------------------------------------------------------------------------------------------------------------------------------------------------------
------------------------------------------------------------------------------------------------------------------------------------------------------
-------------------------%-------------------------------------%--------------------------------------------------------------------------------------
-------------------------|-------------------------------------|--------------------------------------------------------------------------------------
-------------------------|-------------------------------------|--------------------------------------------------------------------------------------
-------------------------|-------------------------------------|--------------------------------------------------------------------------------------
-------------------------|--------%----------------------------%--------------------------------------------------------------------------------------
-------------------------|--------|------------------%%%%%%%---|--------------------------------------------------------------%-----------------------
--------%-----------%%%-%%-----%%%|--------------%-%-|||||||---|---%---------------------------------------%-%%%------%-------|----%%-----------------
--------|---g-------|||-||--%--||||-------%------|-|-|||||||--%|---|---------------------------------------|-|||------|-----%%|----||-----------------
%%%%%%%%|-----------|||-||%%|%%||||%-%---%|------|-|-|||||||--||---|--------%%%%%%-------------------------|-|||--%%-%|-%---|||--%-||-----------------
|||||||||XXXXXXXXXXX|||X||||||||||||X|XXX||XXXXXX|X|-|||||||XXX|XXX|XXXXXXXX||||||XXXXXXXXXXXXXXXXXXXX--X--|X|||--||-||X|-XX||XXX|X|XXXX--XXXXXXXXXXX-