------------------------------------------------------------------------------------------------------------------------------------------------------
------------------------------------------------------------------------------------------------------------------------------------------------------
------------------------------------------------------------------------------------------------------------------------------------------------------
------------------------------------------------------------------------------------------------------------------------------------------------------
------------------------------------------------------------------------------------------------------------------------------------------------------
------------------------------------------------------------------------------------------------------------------------------------------------------
--------------------------------------------------------------------------------------------------%---------------------------------------------------
--------------------------------------------------------------------------------------------------|---------------------------------------------------
--------------------------------------------------------------------------------------------------|---------------------------------------------------
--------------------------------------------------------------------------------------------------|--%------------------------------------------------
--------------------------------------------------------------------------------------------------|--|------------------------------------------------
---------------------------%%%%%-%-------------------------------------------------------%--------|--|-------------S-----------------------------%----
--------------------%%-----|||||-|--%----U---%%%%%%%%%%%%%%--%-------%---------%-%-------|--------|--|---------------%---------------%----%------|--%-
---------%%%----%%%-||-----|||||-|--|--------||||||||||||||--|-------|---------|-|-%%%%%%|%%-%%%-%|--|--------------%|---------------|-%-G|------|--|-
%%%%%%%%%|||----|||-||-----|||||-%%%|--------||||||||||||||--%%%%%%--|%--%%%%%-|-|-|||||||||%|||-||--|--------------||----%----------|-|-%|%%--%-|--|-
||||||||||||----|||X||XXXXXXXXXX-||||XXXXXXXXX|||||||||||||XX||||||--||XX|||||-|XXX|||||||||||||-||XX|XXXXXXXXXXXXXX|XXXXX|XXXXXXXXXX|X|-||||XX|-XXX|X