------------------------------------------------------------------------------------------------------------------------------------------------------
------------------------------------------------------------------------------------------------------------------------------------------------------
------------------------------------------------------------------------------------------------------------------------------------------------------
------------------------------------------------------------------------------------------------------------------------------------------------------
-------------------------------------------------------------------%----------------------------------------------------------------------------------
-------------------------------------------------------------------|----------------------------------------------------------------------------------
-------------------------------------------------------------------|----------------------------------------------------------------------------------
------------%------------------------------------------------------|--%-------------------------------------------------------------------------------
------------|------------------------------------------------------|--|-------------------------------------------------------------------------------
------------|------------------T-----------------------------------D--|-------------------------------------------------------------------------------
------------|---%--------------t--------------------------------------|-----------------------------------------------------------------%-------------
------------|---|--------U-----t--------------------------------------|-----------------------%----------------------------------------%|-------------
------------|--%|--------------t%%%%%%-%%%%%------%%---%%%%-------%---|-----------------------|---------%------------------------------||------%------
------------|%%||----g--------%%||||||-|||||------||---||||-------|%--%-------------------%%%-|-%%%%%%%-|------------------------------||%-----|------
%%%%%%%%%%%%|||||-%---%%%-----||||||||-|||||------||---||||-------||--|-------------------|||-|%|||||||-|------------------------------|||-----|------
|||||||||||||||||X|XXX|||XXXXX||||||||-|||||XXXXXX||XXX||||-XXXXXX||XX|XXXXXXXXXXXXXX---XX|||X|||||||||X|XXXXXXXXXXXXXXXX-X--XXXXXXXXXX|||XXXXX|XXXXXX