------------------------------------------------------------------------------------------------------------------------------------------------------
------------------------------------------------------------------------------------------------------------------------------------------------------
------------------------------------------------------------------------------------------------------------------------------------------------------
------------------------------------------------------------------------------------------------------------------------------------------------------
------------------------------------------------------------------------------------------------------------------------------------------------------
------------------------------------------------------------------------------------------------------------------------------------------------------
------------------------------------------------------------------------------------------------------------------------------------------------------
------------------------------------------------------------------------------------------------------------------------------------------------------
------------------------------------------------------------------------------------------------------------------------------------------------------
------------------------------------------------------------------------------------------------------------------------------------------------------
------------------------------------------------------------------------------------------------------------------------------------------------------
-------------------------------------------------------------%----------------------------------------------------------------------------------------
---------%--------------%-----------%--%%--------------------|----------------------------------%--%----%%%%-%--%%---------------------------%--------
---------|--------------|----%------|--||%-%------%%---------|----------------------------------|%%|----||||%|--||%%-------%-----------------|--------
%%%%%%%%%|%%%-----------|---%|------|--|||-|------||%%------%%--%%%-----------%----%------------||||---%||||||--||||-%-----|--%-----%%%%%--%%|%-------
|||||||||||||XXXXXXXXXX-|XXX||XXXXXX|-X|||X|------||||--XXX-||XX|||XXXXXX-XXXX|XXXX|XXXXXXXXXX--|XX|---|||||||XX||||X|XXXXX|XX|X---X|||||XX||||--XXXXX