------------------------------------------------------------------------------------------------------------------------------------------------------
------------------------------------------------------------------------------------------------------------------------------------------------------
------------------------------------------------------------------------------------------------------------------------------------------------------
------------------------------------------------------------------------------------------------------------------------------------------------------
------------------------------------------------------------------------------------------------------------------------------------------------------
------------------------------------------------------------------------------------------------------------------------------------------------------
------------------------------------------------------------------------------------------------------------------------------------------------------
------------------------------------------------------------------------------------------------------------------------------------------------------
------------------------------------------------------------------------------------------------------------------------------------------------------
------------------------------------------------------------------------------------------------------------------------------------------------------
------------------------------------------------------------------------------------------------------------------------------------------------------
--------------------------------------------------------------------------------------------------G---------%-----------------------------------------
------------%%----%----K-------------------------------------------------%%%-%%%%----%%------%----%%--------|---------------------------------%%%----%
------------||%%--|---%%-%%-----%------------------%-%-%%--%%---%%-------|||-||||----||------|----||%%%%%--%|----------%%%--------------------|||--%%|
%%%%%%%%%%--||||--|---||-||-----|---------%%%%%----|-|-||--||---||%%%----|||-||||----||-----%|----|||||||--||----------|||%%%%%%%---------%---|||--|||
||||||||||-X||||XX|-XXXXX||XXXXX|XXXXXX-XX|||||XXXX|X|X||XX||---|||||-X-X|||X||||----||XXXXX||----||X||||XX||-XXXXXXXXX||||||||||XXXXXXXXX|XXX|||XX|||