------------------------------------------------------------------------------------------------------------------------------------------------------
------------------------------------------------------------------------------------------------------------------------------------------------------
------------------------------------------------------------------------------------------------------------------------------------------------------
------------------------------------------------------------------------------------------------------------------------------------------------------
------------------------------------------------------------------------------------------------------------------------------------------------------
------------------------------------------------------------------------------------------------------------------------------------------------------
------------------------------------------------------------------------------------------------------------------------------------------------------
------------------------------------------------------------------------------------------------------------------------------------------------------
------------------------------------------------------------------------------------------------------------------------------------------------------
---------%----------------%-------------------------------------------------t-------------------------------------------------------------------------
---------|----------------|---------%--------------------------------------%t---------------%---------------------------------------------------------
---------|----------------|---------|--------------------------------------|t---------------|--------------------%------------------------------------
--------%|------------%%--|---------|-----------%--%---------------%--%%%%%|t%-%%%%%%%%-----|---------------%%---|-%----------------%----------------%
--------||------%%%%%-||--|---------|-----------|--|---------------|%-||||||%|-||||||||-----|---------------||---|-|----------------|-------------%%%|
%%%%%%%%||%%%%%%|||||%||--|---%%--%-|-------%%%-|%-|---%%%%%%-%%%--||%||||||||-||||||||-----|---------%-----||---|%|----------------|-------------||||
||||||||||||||||||||||||XX|XXX||XX|X|XXXXXXX|||X||-|XXX||||||X|||XX|||||||||||X|||||X||XXXXX|XXXXXXX--|XXXXX||XXXX|XXXXXXXX---XXXXXX|XX-XXXXXXXXXX||||