------------------------------------------------------------------------------------------------------------------------------------------------------
------------------------------------------------------------------------------------------------------------------------------------------------------
------------------------------------------------------------------------------------------------------------------------------------------------------
------------------------------------------------------------------------------------------------------------------------------------------------------
------------------------------------------------------------------------------------------------------------------------------------------------------
------------------------------------------------------------------------------------------------------------------------------------------------------
------------------------------------------------------------------------------------------------------------------------------------------------------
------------------------------------------------------------------------------------------------------------------------------------------------------
------------------------------------------------------------------------------------------------------------------------------------------------------
------------------------------------------------------------------------------------------------------------------------------------------------------
--------------------------------------------------------------------------------------%---------------------------------------------------------------
------------------------------------------%-------------------------------------------|-----------------S-----------------------C---------------------
-------------------%%%%%%-----------------|------------%----%------------%--%---------|-------------%----------------------------------%%-------------
---------%---------||||||---%#----%%%%----|------------|----|%%%%%%%%%%%%|--|---------|----------%%%|----------------------------%%%%-%||--%%--%%%%%%%
%%%%%%%%%|%--------||||||---|%%%--||||----|-------%----|%%%-||||||||||||||--|-------%%|-------%%-||||----------------------------||||-|||--||--|||||||
|||||||||||XXXXX---||||||--X||||XX||||XXXX|XXXXXX-|-XXX||||XX|||||||||||||XX|XX----X|||XXXX-XX||-||||-XXX--XXXXXXXXXXXXXXXXXXXXXX|||X-|||XXXXXX|||||||