------------------------------------------------------------------------------------------------------------------------------------------------------
------------------------------------------------------------------------------------------------------------------------------------------------------
------------------------------------------------------------------------------------------------------------------------------------------------------
------------------------------------------------------------------------------------------------------------------------------------------------------
------------------------------------------------------------------------------------------------------------------------------------------------------
------------------------------------------------------------------------------------------------------------------------------------------------------
------------------------------------------------------------------------------------------------------------------------------------------------------
------------------------------------------------------------------------------------------------------------------------------------------------------
------------------------------------------------------------------------------------------------------------------------------------------------------
------------------------------------------------------------------------------------------------------------------------------------------------------
------------------------------------------------------------------%-----------------------------------------------------------------------------------
---------------------------------------------------%%%%%----------|-%%%-------------------------------------------------------------------%-----------
-------------------------------------------%-------|||||----------|-|||------------%%------%-----------------------------%----------------|-----------
------------------------------%%--%%%%%%%%%|%------|||||-----%%-%%|-|||------------||%%%%--|-%--%--%%----%-%%%%-%%%%%%%%%|----------------|-----------
%%%%%%%%----------------------||--|||||||||||%%%%%%|||||%-%%%||-|||-|||%----------%||||||-%|-|--|%-||--%-|-||||-||||||||||----------------|-----------
||||||||X-XXXXXXXXXXXXXXXXXXXX||XX|||||||||||||||||XXXXX|X|||||X|||XXXX|XXXXXXXXXX|||||||X||X|XX||-||XX|-|-||||X||||||||||------XXXXXXX-XX|-XXXXXXXXXX