------------------------------------------------------------------------------------------------------------------------------------------------------
------------------------------------------------------------------------------------------------------------------------------------------------------
------------------------------------------------------------------------------------------------------------------------------------------------------
------------------------------------------------------------------------------------------------------------------------------------------------------
------------------------------------------------------------------------------------------------------------------------------------------------------
------------------------------------------------------------------------------------------------------------------------------------------------------
------------------------------------------------------------------------------------------------------------------------------------------------------
------------------------------------------------------------------------------------------------------------------------------------------------------
------------------------------------------------------------------------------------------------------------------------------------------------------
------------------------------------------------------------------------------------------------------------------------------------------------------
----------------------------------------------------%---------------------------------------------------------------------------------%---------------
----------------------------------------------------|---------------------------------------------------------------------------------|------%--------
---------------------------------------------------%|------------------------------------------------%%%%-----%%%%%--%%---%%--%%%----%|------|----%---
-------------%-------------------------------------||-%%-%%--%%%%%%%%----%%%%%-----%--%%%--%%%%%-%%--||||%%%%-|||||--||---||--|||--%-||------|-g--|---
%%%%%%%%%%%%-|%%%%-%%--%----%%%%-------------------||-||-||--||||||||----|||||-----|--|||--|||||-||--||||||||-|||||--||---||--|||--|-||------|--%%|-%-
||||||||||||X|||||X||XX|XXXX||||XXXXXXXXXXXXXXXXXXX||X||-||XX||||||||XX-XXXXXXXXXXX|XX|||XX|||||X||-X||||||||-|||||-X||XXX||-X|||XX|X||XX----|X-|||X|X