------------------------------------------------------------------------------------------------------------------------------------------------------
------------------------------------------------------------------------------------------------------------------------------------------------------
------------------------------------------------------------------------------------------------------------------------------------------------------
------------------------------------------------------------------------------------------------------------------------------------------------------
------------------------------------------------------------------------------------------------------------------------------------------------------
--------------------------------------------------------------------------------------------------------------------------------------------------S---
------------------------------------------------------------%-----------------------------------------------------------------------------------------
------------------------------------------------------------|-----------------------------------------------------------------------------------------
------------------------------------------------------------|-----------------------------------------------------------------------------------------
------------------------%-----------------------------------|-------------------------------%-----------------------------------------------------%---
------------------------|-----------------------------------|-------------------------------|-----------------------------------------------------|---
------------------------|------------------------------%----|-----------%---%--------------g|-----------------------------%-----------------------|---
------------------------|----%--------%----------------|----|-----------|---|-%%%%%%%-%%----|----------------2------------|-----------------------|---
--------%%%%--%---------|----%%U----%%|-%--------------%----|-----------|-%-|-|||||||-||-%%-|---%--%%%%---%-------%%---%%-|-----------%-----%%%%%%%-%-
%%%%%%%%||||--|---------|----||--%%-|||-|%-%-----------|--%-|-----------|-|-|-|||||||-||-||-|%%%|-%||||---|-%-----||%--||-|--%--------|----%|||||||-|-
||||||||||||XX|-XXXXXXXX|X-XXXXXX||-XX|X||X|XXXXXXXXXXX|XX|X|-XXXXX-XXXXXX|X|X|||||||X||X||X|||||X|||||---|X|XXX--|||XX||XXXX|XXXXXXXX|XXXX|||||XX|XXX