------------------------------------------------------------------------------------------------------------------------------------------------------
------------------------------------------------------------------------------------------------------------------------------------------------------
------------------------------------------------------------------------------------------------------------------------------------------------------
------------------------------------------------------------------------------------------------------------------------------------------------------
---------------------------------------------------------------------------------------------------------------------------------%--------------------
-----------------------------------------------------------------------------------------------%---------------------------------|--------------------
-----------------------------------------------------------------------------------------------|---------------------------------|--------------------
-----------------------------------------------------------------------------------------------|---------------------------------|--------------------
-----------------------------------------------------------------------------------------------|---------------------------------|--------------------
-----------------------------------------------------------------------------------------------|---------------------------------|--------------------
-----------------------------------------------------------------------------------------------|----S----------------------------|--------------------
-----------------------------------------------------------------------------------------------|---------------------------------|--------------------
--------------------------------------------------------------%----C-----------%---------------|---%-%%%%%-----------------------|----------------%%--
--------------------%------%%----%-%%-%%%-%%%---%-%%----%-----|--%--------%----|---------------%---|%|||||--%%%--%%%%%%%%%%%-----|-----%%%--%%%%--||--
%%%%%%%%%%----------|-%-%%-||----|-||-|||-|||---|-||---%|%%%--|--|--------|----|--%---%--------|---|||||||--|||--|||||||||||%%%%%|-%%%%|||%%||||--||--
||||||||||XXX-XXXXXX|X|X||X||XX-X|X||X|||X|||XXX|-||XXX|||||XX|--|XXXXXXXXXXXXXXX-|XXX|XXXXXXXX|XXX|||||||XX|||XX|||||||||||||||||-|||||||||||||XX||--