------------------------------------------------------------------------------------------------------------------------------------------------------
------------------------------------------------------------------------------------------------------------------------------------------------------
------------------------------------------------------------------------------------------------------------------------------------------------------
------------------------------------------------------------------------------------------------------------------------------------------------------
------------------------------------------------------------------------------------------------------------------------------------------------------
------------------------------------------------------------------------------------------------------------------------------------------------------
------------------------------------------------------------------------------------------------------------------------------------------------------
------------------------------------------------------------------------------------------------------------------------------------------------------
------------------------------------------------------------------------------------------------------------------------------------------------------
------------------------------------------------------------------------------------------------------------------------------------------------------
------------------------------------------------------------------------------------------------------------------------------------------------------
---------------------------------------------------------------------------------------------%--------------------%-----------------------------------
-------------------------------------------------------------------%----------%--------------|-------U------------|----------------------------------%
----------------------%%------%%%%--%-----------------------------%|----------|--------------|%%%---%-----%-------|---------------------------%%%%%%-|
%%%%%%%%--------------||------||||--|--------------------%--------||----------|--------------||||-%%|-----|-------|------%%%-%%%--%%---%----%-||||||%|
||||||||XXXXXXXXXXXXXX||XXXXXX||||XX|XXXXXXXXXXXXXXXXX-XX|X-----X-||XXXXXXXXXX|XXXXXXXXXXXXXXX|||-|||X-XX-|XXXXXXX|X----X|||X|||XX||-XX|XXXX|X||||||||