------------------------------------------------------------------------------------------------------------------------------------------------------
------------------------------------------------------------------------------------------------------------------------------------------------------
------------------------------------------------------------------------------------------------------------------------------------------------------
------------------------------------------------------------------------------------------------------------------------------------------------------
------------------------------------------------------------------------------------------------------------------------------------------------------
------------------------------------------------------------------------------------------------------------------------------------------------------
------------------------------------------------------------------------------------------------------------------------------------------------------
------------------------------------------------------------------------------------------------------------------------------------------------------
------------------------------------------------------------------------------------------------------------------------------------------------------
-------------------------------------------------------------------------------------%-------------------------------T--------------------------------
-------------------------------------------------------------------------------------|-------------------------------t--------------------------------
-------------------------------------------------------------------------------------|-------------------------------t------------------Y---%%%%%-----
------------------------------------------%%%%%--------%-----%%-----G----------------|%----------------------------%-t-----------------%%%--|||||-----
------------------------------------------|||||-----%--|%%---||-----%-------%%%-%%%%%||%%%-%%%%%%%--%---%%-%%---%%%|%%-%----%----------|||--|||||-----
%%%%%%%%%%---%%%--------------------------|||||-----|--|||---||-----|-------|||%||||||||||%|||||||%%|%%%||%||---||||||-|----|---------%|||--|||||-----
||||||||||XXX|||XXXXXXXXXXXXXXXXXXXXXXX---|||||XX-XXX-X|||XXX||X-XXXXXXXXX--|||||||||||||||||||||||||||||||||---|||||XX|XXXX|-XXXXXXXX||||-XXXXXXXXXXX