------------------------------------------------------------------------------------------------------------------------------------------------------
------------------------------------------------------------------------------------------------------------------------------------------------------
------------------------------------------------------------------------------------------------------------------------------------------------------
------------------------------------------------------------------------------------------------------------------------------------------------------
------------------------------------------------------------------------------------------------------------------------------------------------------
------------------------------------------------------------------------------------------------------------------------------------------------------
------------------------------------------------------------------------------------------------------------------------------------------------------
------------------------------------------------------------------------------------------------------------------------------------------------------
------------------------------------------------------------------------------------------------------------------------------------------------------
------------------------------------------------------------------------------------------------------------------------------------------------------
------------------------------------------------------------------------------------------------------------------%%----------------------------------
--------------%----------------------------%-------------------------------%%---------------------------------%---||----------------------------------
--------------|----------------------------|%--%%%%------------------------||---%------------------------%%%--|---||----------------------------------
--------------|--%-------------------------||--||||%--%%%%%%-%%-%%-%------2||---|-----------%-------%----|||%-|%%%||-%%%%-%%%%------------------------
%%%%%%%%----%-|--|-------------------------%|--|||||--||||||%||%||-|-------||---|%%%--------|----%--|%---||||-||||||-||||-||||-----------------%%%%%%-
||||||||XXXX|-|--|-----XX-XXXXXXXXXXXXXXXXX||-X|||||--||||||||||||X|XXXXXXX||-XX||||XXXXXXXX|XXXX|XX||XXX||||X||||||X||||X||||XXXXXXXXXXXXXXXXX||||||X