------------------------------------------------------------------------------------------------------------------------------------------------------
------------------------------------------------------------------------------------------------------------------------------------------------------
------------------------------------------------------------------------------------------------------------------------------------------------------
------------------------------------------------------------------------------------------------------------------------------------------------------
------------------------------------------------------------------------------------------------------------------------------------------------------
------------------------------------------------------------------------------------------------------------------------------------------------------
------------------------------------------------------------------------------------------------------------------------------------------------------
------------------------------------------------------------------------------------------------------------------------------------------------------
------------------------------------------------------------------------------------------------------------------------------------------------------
------------------------------------------------------------------------------------------------------------------------------------------------------
------------------------------------------------------------%-----------------------------------------------------------------------------------------
------------------------------------------------------------|----------------------%------------------------------------------------------------------
--------%%-------%%--%%%%----------%%%------------%----%%%--%-%%%%%%---------------|--------------------------------------%---------------------%---%-
--------||-------||--||||---%%%%%%%|||---%------%%|----|||F%|-||||||--%%%-%%%------|-------------%------------------------|-----%------------%--|%--|%
%%%%%%%%||-%%%---||--||||---||||||||||%--|----%%|||----|||%||-||||||--|||-|||--%---|-------------|----------%-------------|%%%--|------------|--||--||
||||||||||-|||--X||XX||||XXX|||||||||||--|X--X|||||XXXX||||||-||||||-X|||-|||-X|XXXXXXXXXXXXXXXXX|XXXXXXXXXX|--XXXXXXXXXXX||||--|XXXXXXXXXX-X|XX||XXX|