------------------------------------------------------------------------------------------------------------------------------------------------------
------------------------------------------------------------------------------------------------------------------------------------------------------
------------------------------------------------------------------------------------------------------------------------------------------------------
------------------------------------------------------------------------------------------------------------------------------------------------------
------------------------------------------------------------------------------------------------------------------------------------------------------
------------------------------------------------------------------------------------------------------------------------------------------------------
----------------------------------------------------------------------------------------------------------------------%-------------------------------
----------------------------------------------------------------------------------------------------------------------|-------------------------------
----------------------------------------------------------------------------------------------------------------------|-------------------------------
----------------------------------------------------------------------------------------------------------------------|-------------------------------
----------------------------------------------------------------------------------------------------------------------|-------------------------------
----------------------------------------------------------------------------------------------------------------------|-------------------------------
----------------------------------------------------------------------%----------------%---%%%%%--------%%------------|--------%%-----%---------------
--------------%------------------%%-------------%---%-----------%%----|-------------C--|---|||||--------||------------%--------||-----|---------------
%%%%%%%%%%----|-------%%--%-%%-%%||-------------|--%|%%%--------||----|%-%%%%%---------|---|||||--------||------------|--------||%%%%-|---------------
||||||||||X--X|XXXXXXX||--|-||X||||-XXXXXXXXXXXX|XX|||||-XXXXXXXXXXXXX||X|||||XXXXXXXXX|X--|||||XXXX--XX||XXXXXXXXXXXX|XXXXXXXX||||||X|XXXXXXXXXXXXXXX