------------------------------------------------------------------------------------------------------------------------------------------------------
------------------------------------------------------------------------------------------------------------------------------------------------------
------------------------------------------------------------------------------------------------------------------------------------------------------
------------------------------------------------------------------------------------------------------------------------------------------------------
------------------------------------------------------------------------------------------------------------------------------------------------------
-------------------------------------------------------------------------------------------------------------------------%----------------------------
-------------------------------------------------------------------------------------------------------------------------|----------------------------
---------------------------------------------------------------------D---------------------------------------------------|----------------------------
--------------------------------------------------------------------------------t----------------------------------------|----------------------------
--------------------------------------------------------------------------------t----------------------------------------|----------------------------
--------------------------------------------------------------------------------t----------------------------------------|----------------------------
----------%------------------------#--------------------------------------------t----------------------------------------%----------------------------
----------|----%%%%%------------%--%------------------------------------------%%%%%%-%-----------------------------------|----------------------------
----------|---%|||||------------|--|---------------------------------%------%-||||||%|--------%%%--%-%%%-%%-%%-%%%-%%-%%%|%%%%-%-%%%%%---%------------
%%%%%%%%%-|%%-||||||------------|--|-------------------------%-------|%-----|-||||||||--------|||%-|-|||-||-||-|||-||-||||||||%|%|||||-%%|------------
|||||||||X|||XX|||||XXXXXXXXXXXX|XX|XXX-XXXXXXXXXXXXXXXXXXXXX|XXXXXXX||XXXXX|X||||||||XXXXXX--||||X|X|||X||X||X|XX-||X||||||||||||||||X|||XXXXXXXXXXXX