------------------------------------------------------------------------------------------------------------------------------------------------------
------------------------------------------------------------------------------------------------------------------------------------------------------
------------------------------------------------------------------------------------------------------------------------------------------------------
------------------------------------------------------------------------------------------------------------------------------------------------------
------------------------------------------------------------------------------------------------------------------------------------------------------
------------------------------------------------------------------------------------------------------------------------------------------------------
------------------------------------------------------------------------------------------------------------------------------------------------------
------------------------------------------------------------------------------------------------------------------------------------------------------
-------------------------------------------------------------------------------S----------------------------------------------------------------------
------------------%-----------------------------------------------------------------------------------------------------------------------------------
------------------|-----------------------------------------------------------------------------------------------------------------------------------
--------------%---|----------------%---%--------------------------------------------------------------------------------------------------------------
--------------|%%-|%---------%%----|---|-------------------%%%%%%%-------------%----------------%------%%%%%%-%-----------%-----------------%-%%------
-----------%%%|||-||---------||%-%%|%%%%F%-----------------|||||||------------%|%%%%------------|%%----||||||%|-%---------|-----------------|-||------
%%%%%%%%%%%|||%||-||---------|||-|||||||%|%%%%%%%%%-%%%-%%-|||||||----%%%%----||||||------------|||----||||||||-|----%-%%%|%%%%%%%----------|-||------
|||||||||||||||||X||XXX---XXX|||-||X|||||||||||||||X|||X||-|||||||XXXX||||XXXX||||||XXXXXXXXXXXX|XX-XXX||||||||X|---X|X|||||||||||XXXXXXX--X|X||XXXXXX