------------------------------------------------------------------------------------------------------------------------------------------------------
------------------------------------------------------------------------------------------------------------------------------------------------------
------------------------------------------------------------------------------------------------------------------------------------------------------
------------------------------------------------------------------------------------------------------------------------------------------------------
------------------------------------------------------------------------------------------------------------------------------------------------------
------------------------------------------------------------------------------------------------------------------------------------------------------
--------------------------------------------------------------------------S---------------------------------------------------------------------------
------------------------------------------------------------------------------------------------------------------------------------------------------
------------------------------------------------------------------------------------------------------------------------------------------------------
--------%---------------------------------------------------------------------------------------------------------------------------------------------
--------|---------------------------------------------------------------%%%-%-------------------------------------------------------------------------
--------|---------------------------------------%%----------------------|||-|---------------------------------------------%------------------------g--
--------|----------------------%%--%%%%%--------||---------------%%%%---|||-|------%----------------------------------%---|-------%-%%--%%%%%%%%%-----
--------|----K-%--%------gg----||--|||||----%%--||--------%%%----|||%---|||-|%%%%%%|%%%%%%%%%%%-%%--%%%%--------------|---|-------|-||--|||||||||%----
%%%%%%%%|----%-|--|------------||--|||||---%||--||--------|||----||||---|||-|||||||||||||||||||-||--||||--%%----------|---|-------|-||-%||||||||||----
|||||||||----|X|X-|----XXXXXXXX||XX|||||XXX|||XXXXX-XXXXXXXXXXXXXXXXXXXX|||-|||||||||||||||||||X||XX||||XX||XXXXXXXXXXXXXX|-XXXXXX|-||X|||||||||||X-XX