------------------------------------------------------------------------------------------------------------------------------------------------------
------------------------------------------------------------------------------------------------------------------------------------------------------
------------------------------------------------------------------------------------------------------------------------------------------------------
------------------------------------------------------------------------------------------------------------------------------------------------------
---------------------------------------------------------------------------------------------------------------------------%--------------------------
---------------------%-----------------------------------------------------------------------------------------------------|--------------------------
---------------------|----------------------------------------------------------------------------------------------------D|--------------------------
---------------------|-----------------------------------------------------------------------------------------------------|--------------------------
---------------------|-----------------------------------------------------------------------------------------------------|--------------------------
---------------------|-----------------------------------------------------------------------------------------------------|--------------------------
---------------------|---------------------S-%%-----------------------------------------%----------------------------------|--------------------------
---------------------|------------------g----||-----------------------------------------|----------------------------------|--------------------------
----------%----------|-%%-------%---------%--||--%%%--%%%%%%%%--------------------------|-----------------------------%----|--%%-%-%-------%----------
----------|%---------|-||-------|---------|%K%%--|||--||||||||---%------------------%-%%|%%--%--------%---%%-%%%%%----|-%-%|%%||-|-|-------|--%%------
%%%%%%%%%%||-------%%|-||-%%----|%--------||%||--|||%%||||||||-%%|----%%-----%------|-|||||--|--------|---||-|||||-%--|%|-||||||-|-|-%%%%%-|--||-%%---
||||||||||||XXXXXXX|||X||-||----||XXXXXXXX|||||--|||||||||||||X|||XXXX||XXXXX|XXXXXX|-|||||X-|XXXXXXXX|XXX||X|||||X|XX|||X||||||-|-|X|||||X|XX||X||XXX