------------------------------------------------------------------------------------------------------------------------------------------------------
------------------------------------------------------------------------------------------------------------------------------------------------------
------------------------------------------------------------------------------------------------------------------------------------------------------
------------------------------------------------------------------------------------------------------------------------------------------------------
------------------------------------------------------------------------------------------------------------------------------------------------------
------------------------------------------------------------------------------------------------------------------------------------------------------
-------------------------------------------------------------------------g----------------------------------------------------------------------------
------------------------------------------------------------------------%%----------------------------------------------------------------------------
------------------------------------------------------------------------||----------------------------------------------------------------------------
---------------------------------------T--------------------------------||----------------------------------------------------------------------------
---------------------------------------t--------------------------------||---------%----------------%----%--------------------------------------%-----
---------------------------------------t--------------------------------||---------|----------------|----|--------------------------------------|-----
---------------%-----------%----%---%%-%------------------------------%-||--%------|----------------|----|--------------------------------------|-----
---------------|-----------|-%--%%%%||-|%---------%%------------------|%||-%|%%%%%-|%---------------|----|--------------------------------------|-----
%%%%%%%%%%%--%%|---------%%|-|%-||||||-||---------||---%%------------%||||%|||||||%||--%---%%---%%%%|%%%%|-%%%%%%%%%%%%%%-----------%-----------|-----
|||||||||||XX|||X-XXXXXXX|||XX|XXXXX||-XXXXXXXXX--||XXX||XXX-----XXXX||||||||||||||||XX|XXX||XXX||||||||||-||||||||||||||XXXX-XXXXXX|XXXXXXXXXXX|XXXXX