------------------------------------------------------------------------------------------------------------------------------------------------------
------------------------------------------------------------------------------------------------------------------------------------------------------
------------------------------------------------------------------------------------------------------------------------------------------------------
------------------------------------------------------------------------------------------------------------------------------------------------------
------------------------------------------------------------------------------------------------------------------------------------------------------
------------------------------------------------------------------------------------------------------------------------------------------------------
------------------------------------------------------------------------------------------------------------------------------------------------------
------------------------------------------------------------------------------------------------------------------------------------------------------
------------------------------------------------------------------------------------------------------------------------------------------------------
------------------------------------------------------------------------------------------------------------------%-----------------------------------
-----------------------------%------------------------------------------------------------------------------------|----------------------------------U
-----------------------------|-------------------S-----------------------S---------------%------------------------|-----------------------------------
-----------------------------|-------------------------------------------------%---------|------------------------|--------%%-------------------------
-------------%---------------|----------------------------------%%%------------|---------|-----%%-----------------|--------||------------%%%%%%%%%----
%%%%%%%%%%%%-|-----%%--------|--------------------------%%%%%%%-|||------------|---------|-----||------%----------|--------||%-----------|||||||||---%
||||||||||||X|XXXXX||XXXXXXXX|-XXXXXXXXXXXXXXXXXXXXXXXXX|||||||X|||XXXXXXXXXXXX|X----XXX-XXXXXX||XXXXXX|XXXXXXXXX-|------XX|||XXXXXXXXXX-|||||||||X-X|