------------------------------------------------------------------------------------------------------------------------------------------------------
------------------------------------------------------------------------------------------------------------------------------------------------------
------------------------------------------------------------------------------------------------------------------------------------------------------
------------------------------------------------------------------------------------------------------------------------------------------------------
------------------------------------------------------------------------------------------------------------------------------------------------------
------------------------------------------------------------------------------------------------------------------------------------------------------
------------------------------------------------------------------------------------------------------------------------------------------------------
------------------------------------------------------------------------------------------------------------------------------------------------------
------------------------------------------------------------------------------------------------------------------------------------------------------
------------------------------------------------------------------------------------------------------------------------------------------------------
--------------------------------------------------------------------------------%%--------------------------------------------------------------------
--------------------------------------------------------------------------------||--------------------------------------------------------------------
----------%%%-------------------------------------------%---%-------------------||---------%%--------%%%%-----%%%------------------%%%%%%%---%--%-----
----------|||--%---%%%%%%%--%%%%%--%%----------------%%%|%%%|%%---------%----%-%||---------||--------||||-----|||-----------%------|||||||---|--|-----
%%%%%%%%%-|||--|---|||||||--|||||--||----------------||||||||||--%%-----|----|%|||--------%||--------||||-----|||%----------|%%%%%-|||||||---|--|-----
|||||||||X|||XX|---|||||||X-|||||--||--X-XXXXXXXXXXXX|||X||||||XX||XXXXXXXXX-|||||XXXXXXXX|||XXX--X--||||XXX--||||XXXXXXXXXX||||||X|||||||XXX|XX|X--XX