------------------------------------------------------------------------------------------------------------------------------------------------------
------------------------------------------------------------------------------------------------------------------------------------------------------
------------------------------------------------------------------------------------------------------------------------------------------------------
------------------------------------------------------------------------------------------------------------------------------------------------------
---------------------------------------------------------------------D--------------------------------------------------------------------------------
------------------------------------------------------------------------------------------------------------------------------------------------------
------------------------------------------------------------------------------------------------------------------------------------------------------
---------------------------------------------------------------------%--------------------------------------------------------------------------------
---------------------------------------------------------------------|--------------------------------------------------------------------------------
------------%--------------------------------------------%-----------|--------------------------------------------------------------------------------
------------%-------------------S------------------------|-----------|-----------------%--------------------------------------------------------------
----------r-|------------------------------------------%-|--------%%%|-----------------|---------------%----------------------------------------------
------------|-%----------------------------------------|-|--------||||------------%----|---------------|%----------------------------%----%-------%%--
-----------%%-|%%--%-%%%%-%----%-------------%---------|%|--------||||------------|----|%%-%F%%-%------||%%--%%-%-----------%--------|----|---%-%-||--
%%%%%%%%%%-||-|||--|-||||-|----|%------------|---------|||%%------||||------------|----|||-|%||-|---%--||||--||%|%%%-%------|--------|----|---|-|-||--
||||||||||-||-|||-X|X||||X|XXXX||XXXXXXXXXXXX|XXXXXXXXX|||||XXXX-XXXX|XXXXXXXXXXXX|----|||X||||X|XXX|XX||XXXX|||||||X|XXXXXX|XXXXXXXX|XXXX|XX-|X|X||XX