------------------------------------------------------------------------------------------------------------------------------------------------------
------------------------------------------------------------------------------------------------------------------------------------------------------
------------------------------------------------------------------------------------------------------------------------------------------------------
------------------------------------------------------------------------------------------------------------------------------------------------------
------------------------------------------------------------------------------------------------------------------------------------------------------
------------------------------------------------------------------------------------------------------------------------------------------------------
------------------------------------------------------------------------------------------------------------------------------------------------------
------------------------------------------------------------------------------------------------------------------------------------------------------
---------%--------------------------------------------------------------------------------------------------------------------------------------------
---------|--------------------------------------------------------------------------------------------------------------------------------------------
---------|--------------------------------------------------------------------------------------------------------------------------------------------
---------|-------------------------------%------------------------------------------------------------------------------------------------------------
---------|---------------------%%-%%-%---|-----------------------%%-%%-----%%-%%------------------------------------UU--------------------------------
---------|---------------------||-||-|---|-----------------------||-||-----||-||%-------------------%--%--------%-----------------%-------------------
%%%%%%%%%|%%%--------------%%--||-||-|%--|----------------------%||-||-----||-|||----%-------------%|--|--------|-----%-----------|--%-%%-------------
|||||||||||||XXXXXXXXXXXXXX||XX||-||X||--|XXXXXXXXXXXXXXXXXXX-XX|||-||XXXXX||X|||XX--|XXX-XXXXXXXXX||XX|XXXXXXXXXXXXXX|XXXXXXXXXXX|XX|X||-XXXXXXXXXXXX