------------------------------------------------------------------------------------------------------------------------------------------------------
------------------------------------------------------------------------------------------------------------------------------------------------------
------------------------------------------------------------------------------------------------------------------------------------------------------
------------------------------------------------------------------------------------------------------------------------------------------------------
------------------------------------------------------------------------------------------------------------------------------------------------------
--------------------------------------#---------------------------------------------------------------------------------------------------------------
-------------------------------------%%---------------------------------------------------------------------------------------------------------------
-------------------------------------||------------------------------------------------------------------------------------------------%--------------
-------------------------------------||------------------------------------------------------------------------------------------------|--------------
-------------------------------------||------------------------------------------------------------------------------------------------|-%------------
-------------------------------------||------------------------------------------------------------------------------------------------|-|------------
---------------------------#---------||------------------------------------------------------------------------------------------------|-|-------%----
--------%%-----------------%%--------||--------------------%%-----%----------------------------------------%------------------------%%%|-|---%---%----
--------||------------%%%%-||%--%%---||%--%-%%%%-----------||--%-%|%%%%-------%-----------%----------------|------------%-----------||||-|---|%-%|----
%%%%%%%%||-----%------||||%|||--||---|||--|%||||-----------||--|%||||||-------|-----------|----------------|%%%%-%%%%%%-|%--%%%%%---||||%|---||%||----
||||||||||XXXXX|-XXXXX||||||||X-||XXX|||--||||||X---XX-X---||XX||||||||XXXXXXX|XXXXXXXXXXX|XXX-XXXXXXXXXXXX|||||X||||||X||X-|||||XX-|||||XX-X|||||XX--