------------------------------------------------------------------------------------------------------------------------------------------------------
------------------------------------------------------------------------------------------------------------------------------------------------------
------------------------------------------------------------------------------------------------------------------------------------------------------
------------------------------------------------------------------------------------------------------------------------------------------------------
------------------------------------------------------------------------------------------------------------------------------------------------------
------------------%-----------------------------------------------------------------------------------------------------------------------------------
------------------|-----------------------------------------------------------------------------------------------------------------------------------
------------------|-----------------------------------------------------------------------------------------------------------------------------------
------------------|-----------------------------------------------------------------------------------------------------------------------------------
------------------|-----------------------------------------------------------------------------------------------------------------------------------
------------------|------------------------------------------%----------------------------------------------------------------------------------------
------------------|------------------------------------------|%%%%%-------------------------------------g---------------------------------------------
---------%%%---%%-|---%--%-%%----%%--------------------------||||||-----------------%%%%-%-%-----%%%%%%%-%-------------%%%%%%%----------------------%-
---------|||---||-|---|--|-||%---||-%%--%%%%%%%%F------------||||||---%-------------||||-|-|-----|||||||-|----%%%%-%---|||||||%%%%%-%%%%-%%---------|-
%%%%%%%%%|||-%%||-|%%%|--|-|||---||-||--||||||||%%%%%--------||||||-%-|------------%||||%|%|--%--|||||||-|----||||-|--%||||||||||||-||||-||---------|-
||||||||||||-||||-|||||XX|X|||XXX||X||--|||||||||||||X--X---X||||||-|X|XXXXXXXXXXXX|||||||||-X|XX|||||||X|XXXX||||X|X-|||||||||||||X||||X||--XXXXXXX|X