------------------------------------------------------------------------------------------------------------------------------------------------------
------------------------------------------------------------------------------------------------------------------------------------------------------
------------------------------------------------------------------------------------------------------------------------------------------------------
------------------------------------------------------------------------------------------------------------------------------------------------------
------------------------------------------------------------------------------------------------------------------------------------------------------
------------------------------------------------------------------------------------------------------------------------------------------------------
------------------------------------------------------------------------------------------------------------------------------------------------------
------------------------------------------------------------------------------------------------------------------------------------------------------
------------------------------------------------------------------------------------------------------------------------------------------------------
------------------------------------------------------------------------------------------------------------------------------------------------------
--------S--%----------------------------------------------------------------------------------------------------------------------------------%-------
-----------|-----------------------------------------------------------------------------------------------S----------------------------------|-------
-----------|-----------------%---%%-%%----------%--------------------------------------------------------%------------------------------------|-------
-----------|-----------------|---||-||----------|----------------------------%-----------%-%%%%%%%%%%%%%%%-------%-%%%--%%-%%%%%--%-----------|-------
%%%%%%%%%F-|%%%%%------------|---||-||--------%-|----------------------------|-----------|%|||||||||||||||%%---%%|-|||--||-|||||--|-----------|-------
|||||||||XX||||||XXXXXXXXXXXX|XXX||X||XXXXXXXX|X|--XXX-XXXXXXXXXXXXXXX--XXXXX|XXXXXXXXXXX|||||||||||||||||||-XX|||X|||--||-|||||-X|XXXXXXXXXXX|XXXXXXX