------------------------------------------------------------------------------------------------------------------------------------------------------
------------------------------------------------------------------------------------------------------------------------------------------------------
------------------------------------------------------------------------------------------------------------------------------------------------------
------------------------------------------------------------------------------------------------------------------------------------------------------
------------------------------------------------------------------------------------------------------------------------------------------------------
------------------------------------------------------------------------------------------------------------------------------------------------------
------------------------------------------------------------------------------------------------------------------------------------------------------
------------------------------------------------------------------------------------------------------------------------------------------------------
----------------%-------------------------------------------------------------------------------------------------------------------------------------
----------------|-------------------------------------------------------------------------------------------------------------------------------------
----------------|-------------------------------------------------------------------------------------------------------%%----------------------------
----------------|-------------------------------------------------------------------------------------------------------||--%%------%---------%-------
----------------|-%-------------%------------------------------------------------------------%-----------------%%-%%%---||--||------|----%%---|-------
----------%%%%--|-|%%-----------|--------------------------%-----------------S-%-------------|----------------%||-|||---||--||------|----||---|-------
%%%%%%%%%%||||--|-|||-----------|------------------%%%%----|-----------%-------|--------%-%-%|%-%%%%%%%%%%%--%|||-|||---||--||%%----|----||---|-------
||||||||||||||XX|X|||XXXXXXXXXXX|XXXXXXXXXXXXXXXX-X||||XXXX|XXXXXXXXX-X|XXXXXXXXXXXXXXXX|-|X|||-|||||||||||X-||||-|||XXX||XX||||XXXXXXXXXXXXXX|XXXXXX-