------------------------------------------------------------------------------------------------------------------------------------------------------
------------------------------------------------------------------------------------------------------------------------------------------------------
------------------------------------------------------------------------------------------------------------------------------------------------------
------------------------------------------------------------------------------------------------------------------------------------------------------
------------------------------------------------------------------------------------------------------------------------------------------------------
------------------------------------------------------------------------------------------------------------------------------------------------------
------------------------------------------------------------------------------------------------------------------------------------------------------
------------------------------------------------------------------------------------------------------------------------------------------------------
--------------------------------------------------------------------------%---------------------------------------------------------------------------
--------------------------------------------------------------------------|---------------------------------------------------------------------------
-----------------------------%--------------------------------------------|--------------------------------------------------------------------------%
-----------------------------|----------------------%---------------------|------------------------------------------------------------------g---%---|
----------------%%%%%-%------|----------------------|--------------------%|----------------------%%%-%--%%%--------------%%%%%%%%%%%%%-----------|---|
----------------|||||-|------|------------------%---|----------%----%%%--||%--%-%-%--------------|||-|--|||-----G--------|||||||||||||--------%%%|%-%|
%%%%%%%%--------|||||-|-%----|------------%%%---|---|%--%%%%--%|----|||--|||--|-|-|----------%---|||-|--|||-----%--------|||||||||||||--%%%%%-|||||-||
||||||||---XXXXX|||||X|X|XXXX|XXXXXXXXXXXX|||XXX|---||--||||XX||----|||--|||XX|-|X|XXXXXXXXXX|XXX|||X|-X|||XXXXX|--------|||||||||||||--|||||X|||||X||