------------------------------------------------------------------------------------------------------------------------------------------------------
------------------------------------------------------------------------------------------------------------------------------------------------------
------------------------------------------------------------------------------------------------------------------------------------------------------
------------------------------------------------------------------------------------------------------------------------------------------------------
------------------------------------------------------------------------------------------------------------------------------------------------------
------------------------------------------------------------------------------------------------------------------------------------------------------
----------------------------------------------------------------------------%---------------------------%---------------------------------------------
----------------------------------------------------------------------------|---------------------------|---------------------------------------------
---------------------------------------------------------------------%------|---------------------------|----%----------------------------------------
---------------------------------------------------------------------|------|---------------------------|----|----------------------------------------
------------------S------------------------------------%-------------|------|---------------------------|---%%----------------------------------------
-------------------------------------------------------|-------------|------|-----------------%---------|---||----------------------------------------
----------%-%%%-----------------------%-----%-------%--|-------------|------|----%%%%---------|---------|---||---------------%%-%---------------------
----------|-|||---------%-----%------%|-----|-------|--|%%%%%%%%-%%%-|---%--%----||||---------|-G-------%---||--%-%%---------||-|-----------%%--------
%%%%%%%%%%|%|||%%%%%-%%-|-----|------||-----|-------|--|||||||||-|||-|---|--|---%||||---------|-%-------|---||--|-||%--%%%---||-|---%%-%%-%%||--------
||||||||||||||||||||X||X|XXXXX|XXXXXX||XXXXX|--XXXXX|XX|||||||||X|||X|XXX|XX|XXX|||||XXXXXXXXX|X|XXXXXXX|XX-||XX|XXX|XX|||XXX||X|XXX||-||-||||XXXXXXXX