------------------------------------------------------------------------------------------------------------------------------------------------------
------------------------------------------------------------------------------------------------------------------------------------------------------
------------------------------------------------------------------------------------------------------------------------------------------------------
------------------------------------------------------------------------------------------------------------------------------------------------------
------------------------------------------------------------------------------------------------------------------------------------------------------
------------------------------------------------------------------------------------------------------------------------------------------------------
------------------------------------------------------------------------------------------------------------------------------------------------------
-------------------------------------------------------------D----------------------------------------------------------------------------------------
------------------------------------------------------------------------------------------------------------------------------------------------------
-----------------------------------------------------------------------------------------------------------------------------------------C------------
-------------------------------------------------------------D-----------------------------------------------------------%----------------------------
-----------%-------------------------------------------------------------------------------------------------------------|----------------------------
-----------|------------------------------------------------%----------%%-----%%%-%----%%-%%%------%------------%-----%--|--%-------------------------
-----------|-------------%%%%---%-%---%---------------------|%---------||%--%-|||-|----||%|||---%--|%%---%%-----|-----|--|--|-----------%%%%%%%%%%--%%
%%%%%%%%%%%|-%---%%-%%-%%||||-%%|%|%%%|----------%------%%%%||%--------|||--|-|||-|----||||||%--|-%|||---||-----|-----|%-|--|-----------||||||||||--||
||||||||||||X|XXX||X||X||||||-|||||||||-XXXXXXXXX|XXXXXX|||||||XXXXXXXX|||XX|X|||X|XXX-||X||||XX|-|X||XXX||XXXXX|XXXXX||X|XX|XXXXXXXXXXX||X|||||||XX||