------------------------------------------------------------------------------------------------------------------------------------------------------
------------------------------------------------------------------------------------------------------------------------------------------------------
------------------------------------------------------------------------------------------------------------------------------------------------------
------------------------------------------------------------------------------------------------------------------------------------------------------
------------------------------------------------------------------------------------------------------------------------------------------------------
------------------------------------------------------------------------------------------------------------------------------------------------------
------------------------------------------------------------------------------------------------------------------------------------------------------
----------------------------------------------------------------------------------------------------------------------D-------------------------------
------------------------------------------------------------------------------------------------------------------------------------------------------
------------------------------------------------------------------------------------------------------------------------------------------------------
------------------------------%-----------------------------------------------------------------------------------------------------------------------
-------------S----------------|----------------------------------------------------------------------------------------%------------------------------
---------------%%%-%-%--------|---------%%%%%%%%%%%%%%%%%---------%%---------------------------%-----%%%%%%%%%%%%------|------------------------------
--------------%|||-|-|-------G|---------|||||||||||||||||--------%||G-------------------%#%-%--|-----||||||||||||-----%|%-%%---------------------%----
%%%%%%%%%%%%--||||-|-|-------%|----%%%%%|||||||||||||||||--------|||%------%%%----------|%|%|%-|%--%%||||||||||||-----|||-||---------------------|----
||||||||||||XX||||X|XX-------||X---||||||||||||||||||||||-XXXXXXXX|||X----X|||XXXXXXXXX-X|X|X|X||--||||||||||||||XXXXX|||X||XX-XXXXXXXXXXXXXXXXXX|XXXX