------------------------------------------------------------------------------------------------------------------------------------------------------
------------------------------------------------------------------------------------------------------------------------------------------------------
------------------------------------------------------------------------------------------------------------------------------------------------------
------------------------------------------------------------------------------------------------------------------------------------------------------
------------------------------------------------------------------------------------------------------------------------------------------------------
------------------------------------------------------------------------------------------------------------------------------------------------------
------------------------------------------------------------------------------------------------------------------------------------------------------
------------------------------------------------------------------------------------------------------------------------------------------------------
------------------------------------------------------------------------------------------------------------------------------------------------------
---------------------------------------------------------------------------------------------------------------%--------------------------------------
-----------------------------------------------------%---------------------------------------------------------|---%----------------------------------
--------------------------------%--------------------|---------------------------------------------------------|---|-------------------------%--------
---------------------%%%%%%%-%--|%----------------%--|--------------%---%----------------------------------%---|-%S|-------%%-------------%%%%%-------
-----------%%%-------|||||||-|%-||-------------%--|%-|--------------|%%%|%%%%%---%---------%%--------------|---|-|-|%------||---%%%%%%%%%-|||||-------
%%%%%%%%%-%|||-%%%---|||||||-||-||%%%%%%%%%-%%%|%-||-|%%--%--%%%----||||||||||---|--%%-----||--------------|---|-|-||------||-%%|||||||||-|||||%------
|||||||||-||||X|||XXX|||||||X||XX||||||||||X|||||-||-|||XX|X-|||X-XX||||||||||XXXXXX||XXXX-||XXXXXXXXXX----|-XX|-|X||XXXXXXXXX|||||||||||-||||||-XX-XX