------------------------------------------------------------------------------------------------------------------------------------------------------
------------------------------------------------------------------------------------------------------------------------------------------------------
------------------------------------------------------------------------------------------------------------------------------------------------------
------------------------------------------------------------------------------------------------------------------------------------------------------
------------------------------------------------------------------------------------------------------------------------------------------------------
------------------------------------------------------------------------------------------------------------------------------------------------------
------------------------------------------------------------------------------------------------------------------------------------------------------
------------------------------------------------------------------------------------------------------------------------------------------------------
------------------------------------------------------------------------------------------------------------------------------------------------------
------------------------------------------------------------------------------------------------------------------------------------------------------
------------------------------------------------------------------------------------------------------------------------------------------------------
-------------------------------------------------------------------------------------------------%%-------------------------%-------------------------
---------------------------------------------------------------------------------------%%%%------||----%--------------------%-------------------------
---------------------------------------------------------------------------------------||||%-----||----|------------%%%--%%%|%------------------------
%%%%%%%%-------------------------------------------------------------------------%%%%%-|||||-----||----|--%%%%%%%%%%|||--|||||-----%----------%-------
||||||||XXXXXXXXXXXXXXXXXXXXXXXXXXXXXXXXXXX-XXXXXXXXXXXXX-XXXXXXXXXXXX-XXXXXXXXXX|||||-|||||XXXXXXXXXXXXXX|||||||||||||XX|||X|--XXX|XXXXXXXXXX|-XXXXXX