------------------------------------------------------------------------------------------------------------------------------------------------------
------------------------------------------------------------------------------------------------------------------------------------------------------
------------------------------------------------------------------------------------------------------------------------------------------------------
------------------------------------------------------------------------------------------------------------------------------------------------------
------------------------------------------------------------------------------------------------------------------------------------------------------
------------------------------------------------------------------------------------------------------------------------------------------------------
------------------------------------------------------------------------------------------------------------------------------------------------------
----------------------------------------------D-------------------------------------------------------------------------------------------------------
--------------------------------------------------------------------------%---------------------------------------------------------------------------
--------------------------------------------------------------------------|---------------------------------------------------------------------------
-----------------------------------%--------------------------------------|-----------------------------------------------------------%-----------D---
-----------------------------------|--------------------------------------|%----------------------------------------------------------|---------------
-----------------------------------|--------------------------------------||-----------------------------------------%---%%-----------|-------%%%%-%%-
-----------------------------------|----------%-----%---------------------||----------%------------------------------|---||-----------|%------||||%||%
%%%%%%%%%%%---------------------%--|----------|-----|---------------------||----------|--%%%------------%%---%%------|%%%||-%%%%%%%%--||%%%%--||||||||
|||||||||||XXXXXXXXXXXXXXXX-XXXX|XX|XXXXXXXXXX|XXXXX|--XXX--XXXXXXXXXXXXXX|XXXXXXXXXXX|XX|||XXXXXXXXXXXX||XXX||------||||||-||||||||X-||||||XX||||||||