------------------------------------------------------------------------------------------------------------------------------------------------------
------------------------------------------------------------------------------------------------------------------------------------------------------
------------------------------------------------------------------------------------------------------------------------------------------------------
------------------------------------------------------------------------------------------------------------------------------------------------------
------------------------------------------------------------------------------------------------------------------------------------------------------
-------------%----------------------------------------------------------------------------------------------------------------------------------------
-------------|----------------------------------------------------------------------------------------------------------------------------------------
-------------|----------------------------------------------------------------------------------------------------------------------------------------
-------------|-----------------------------------------------------------------------------------------------------------%----------------------------
-------------|-----------------------------------------------------------------------------------------------------------|----------------------------
-------------|----%--%---------------------------------------------------------------------------------------------------|----------------------------
-------------|----|--|-----------------------------------------------------------------------------%%%-------------------|----------------------------
-------------|----|%-|-----%-------------------------%%%----------------------------%--%%%%%-------|||-----%-------------|-%-----%----------------%---
-------------%----||-|-----|C--%---------------------|||----------------------------|--|||||-------|||-----|%---%--------|-|%----|----------------|---
%%%%%%%%%----|----||-|-----|---|-------%--%%---------|||--------------------------%-|--|||||-------|||--%%-||---|--------|-||----|----------------|---
|||||||||XXXX|XXXX||X|XXXXX|XXX|XX---XX|XX||XXXXXXXXX|||XXXXXXXXXXXXXXXXXXXXXXXXXX|X|XX|||||XXXXXXXXXXXX||XX|-XX|--XXXXXX|X||-XXX|XXXXXXXXXXXXXXXX|XXX