------------------------------------------------------------------------------------------------------------------------------------------------------
------------------------------------------------------------------------------------------------------------------------------------------------------
------------------------------------------------------------------------------------------------------------------------------------------------------
------------------------------------------------------------------------------------------------------------------------------------------------------
------------------------------------------------------------------------------------------------------------------------------------------------------
------------------------------------------------------------------------------------------------------------------------------------------------------
------------------------------------------------------------------------------------------------------------------------------------------------------
------------------------------------------------------------------------------------------------------------------------------------------------------
------------------------------------------------------------------------------------------------------------------------------------------------------
------------------------------------------------------------------------------------------------------------------------------------------------------
----------------------------------------------------------------------------------%-------------------------------------%------------------%----------
---------------------------------%------------------------------------------------|-------------------------------------|------------------|----------
---------------------------------|-------------------------------%%---------------|%------------------------------------|----------------%%|----------
--------------------------%------|-------------------------------||------%%%%----%||%----%%%-----%%----------G%--%---%--|%%%-------------|||----------
%%%%%%%%%-----------------|------|-%--------------%-------%------||------||||----||||----|||-----||--%-------%|-%|---|--||||-%%----------|||----------
|||||||||XXXXXXXXXXXXX-XXX|XXXXX-|X|XXXXXXXXXXXXXX|XXXXXX-|XXXXXXXXXXXXXX||||-XXX||||XXXX|||XXXXX||XX|XXX-XXX||X||XXX|XX|XXX-||-XXXX--XXX|||--XXXXX-XX