------------------------------------------------------------------------------------------------------------------------------------------------------
------------------------------------------------------------------------------------------------------------------------------------------------------
------------------------------------------------------------------------------------------------------------------------------------------------------
------------------------------------------------------------------------------------------------------------------------------------------------------
------------------------------------------------------------------------------------------------------------------------------------------------------
------------------------------------------------------------------------------------------------------------------------------------------------------
------------------------------------------------------------------------------------------------------------------------------------------------------
-------------------------------------------------------------------------------------------------------------------------------------------------%----
-------------------------------------------------------------------------------------------------------------------------------------------------|----
---------------------------------------------%---------------------------------------------------------------------------------------------------|----
-------------------------------%-------------|---------------------------------------------------------------------------------------------------|----
-------------------------------|-------------|--------------------------------------------------------------------------------------------k------|----
-----------------------%%%----%|----------%--|---------------------%%-----%%%%%%%----%----------------------------%-%--------%-------------------|----
--------%--------------|||----||----------|--|--------------------%||-%%%-|||||||----|----------------------------|-|-----%%-|-%----%%%%%------%%|----
%%%%%%%%|----------%---|||----||----------|--|-------%------------|%%X|||%|||||||----|------------%-%--%----------|%|%----||-|-|-%--|||||--%%%-|||---%
|||||||||XXXXXXXXXX|XXX|||XXXX||XXXXXXXXXXXXX|XXXXXXX|XXXXXXXXXXXX|||X|||||||||||XXXX|XXXXXXXXX-XX|X|X-|XXXXXXXXXXX|X|XXXX||X|X|X|XX|||||XX|||X|||---|