------------------------------------------------------------------------------------------------------------------------------------------------------
------------------------------------------------------------------------------------------------------------------------------------------------------
------------------------------------------------------------------------------------------------------------------------------------------------------
------------------------------------------------------------------------------------------------------------------------------------------------------
------------------------------------------------------------------------------------------------------------------------------------------------------
------------------------------------------------------------------------------------------------------------------------------------------------------
------------------------------------------------------------------------------------------------------------------------------------------------------
------------------------------------------------------------------------------------------------------------------------------------------------------
------------------------------------------------------------------------------------------------------------------------------------------------------
------------------------------------------------------------------------------------------------------------------------------------------------------
-------------------------------------------------------------------%-----------------------------------------------------%----------------------------
---------------------%--------------------------------------%%%----|-%----------%------------------------------------%---|----------------------------
---------------------|---------------------------%---%------|||--%%|%|%%%%-%----|--%---------------------------------|---|-%%-------------------------
---------------------|-%%-%%%%--%----------------|---|------|||--|||||||||-|----|--|--------------------%%%%%%-------%---|-||----------%%%%%%%%%%%%%%%
%%%%%%%%%%%----------|-||-||||--|----------------|--%|%%----|||%-|||||||||%|----|--%--------%%-%-------%||||||--%%---|---|-||%%%%%%%%%%|||||||||||||||
|||||||||||XXXXXXXXXXXX||-||||-X|XX-XXXXXXXXXXXXX|XX||||XXXX||||X||||X||||||X-XX|XX|XXXXXXXX||-|--XXXXX|||||||--||---|XXX|X|||||||||||||||||||||||||||