------------------------------------------------------------------------------------------------------------------------------------------------------
------------------------------------------------------------------------------------------------------------------------------------------------------
------------------------------------------------------------------------------------------------------------------------------------------------------
------------------------------------------------------------------------------------------------------------------------------------------------------
------------------------------------------------------------------------------------------------------------------------------------------------------
------------------------------------------------------------------------------------------------------------------------------------------------------
------------------------------------------------------------------------------------------------------------------------------------------------------
------------------------------------------------------------------------------------------------------------------------------------------------------
------------------------------------------------------------------------------------------------------------------------------------------------------
------------------------------------------------------------------------------------------------------------------------------------------------------
-------------------------------------------------------------------------------------------------------------------------S----------------------------
------------------------------------g----------------------------------g-------------------------------------------------------g----------------------
------------------------------------|---------------------------%--------------------------------------------%--------------------------%%-----%------
--------------%%--------------------|---------%%%-------------%%|-%%---------%-------------------------------|%%%----%%%%%%%%-----------||-%-%-|%%%%%%
%%%%%%%%%%-%%%||-%------------------|---------|||%-%%-----%---|||%||-----%---|-%%-----------------%%%--------||||----||||||||-----------||-|-|%|||||||
||||||||||X|||||X|XXXXXXXXXXXXXXXXXXXXXXXXXXXX||||X||XXXXX|XXX||||||X-X-X|--X|X||XXXXXXXXXXXXXXXXX|||XXXXXXXX||||XXXX||||||||XXX-XXXXXX-||X|X|||||||||