------------------------------------------------------------------------------------------------------------------------------------------------------
------------------------------------------------------------------------------------------------------------------------------------------------------
------------------------------------------------------------------------------------------------------------------------------------------------------
------------------------------------------------------------------------------------------------------------------------------------------------------
------------------------------------------------------------------------------------------------------------------------------------------------------
------------------------------------------------------------------------------------------------------------------------------------------------------
------------------------------------------------------------------------------------------------------------------------------------------------------
------------------------------------------------------------------------------------------------------------------------------------------------------
------------------------------------------------------------------------------------------------------------------------------------------------------
------------------------------------------------------------------------------------------------------------------------------------------------------
--------------------------------------------------------------%---------------------------------------------------------------------------------------
--------------------------------------------------------------|----------------------------------%--------------%%%---%---------------------------%G--
--------------------------------------------------------%%%---|%%%%----%-------%-----------------|----------%%--|||-%-|--%%%%%-------------------%|%--
--------------------------------------------------------|||---|||||----|------%|%%-----%---------|----------||--|||-|-|--|||||---------%%-%-%%%-%|||%-
%%%%%%%%%%%%%----%%---%---------------%-----------------|||---|||||----|------||||--%%-|%--------|%---------||--|||-|-|--|||||%%%---%%-||-|%|||-|||||-
|||||||||||||XXX-||XXX|XXX--XXXXXXXXXX|XXXXXXXXXXXXXXXX-|||-XX|||||XXXX|XXXXXX||||XX||X||--XXXXXXX|-XXXXXXXX||XXXXXXX-XXXXXXXX|||XXX||X||-|||||-||X||X