------------------------------------------------------------------------------------------------------------------------------------------------------
------------------------------------------------------------------------------------------------------------------------------------------------------
------------------------------------------------------------------------------------------------------------------------------------------------------
------------------------------------------------------------------------------------------------------------------------------------------------------
------------------------------------------------------------------------------------------------------------------------------------------------------
------------------------------------------------------------------------------------------------------------------------------------------------------
----------------------------------------------------------------------------------------------------------%-------------------------------------------
----------------------------------------------------------------------------------------------------------|-------------------------------------------
----------------------------------------------------------------------------------------------------------|-------------------------------------------
------------------------------t--------------------------------------------------------------%------------|-------------------------------------------
------------------------------t---------------------------------T----------------------------|------------|-------------------------------------------
------------------------------t-------------------%-------------t-----%----------------------|--------t---|-------------------------------------------
---------%--%-----------------%-------------------|%%-----------t--%%-|----------%%%%%%%%%%%-|--------t---|-----%------------------------%------------
---------|--|-----%%---%------|-------------------|||--------%%%%--||-|----------|||||||||||%|--%--%%%%---%-----|------------------%-----|------------
%%%%%%%%-%--|-----||%%%|%%%%%-|%%%%------%--%%--%%|||%-------||||-%||%|%%%%-%--%-|||||||||||||--|--||||%%%|-----|------------------|-----|------------
||||||||X|XX|XXXXX|||||||||||-|||||-XXXXX|--||--||X|||XXXXXX-||||-||X||||||X|-X|X|||||||||||||XX|--||||||||-----|XXXXXXXXXXXXXXXXXX|XXXXX|XXXXX-----XX