------------------------------------------------------------------------------------------------------------------------------------------------------
------------------------------------------------------------------------------------------------------------------------------------------------------
------------------------------------------------------------------------------------------------------------------------------------------------------
------------------------------------------------------------------------------------------------------------------------------------------------------
------------------------------------------------------------------------------------------------------------------------------------------------------
------------------------------------------------------------------------------------------------------------------------------------------------------
------------------------------------------------------------------------------------------------------------------------------------------------------
------------------------------------------------------------------------------------------------------------------------------------------------------
------------------------------------------------------------------------------------------------------------------------------------------------------
------------------------------------------------------------------------------------------------------------------------------------------------------
---------------------------------------------------------%--------------------------------------------------------------%-----------------------------
---------------------------------------------------------|------------------------------------------------%-------------|-----------------------------
---------%------------------------------------%-%%---%---%------------------------------%%-%%%%%--%%%-----|%%%%%%%%%%%%%|-%%%--%----------------------
---------|%--%--------------------------------|-||---|---|--%---------------------------||-|||||--|||%%---|||||||||||||||-|||--|----------------------
%%%%%%%%%||--|--------------------%--%%%%%%%%-|-||%--|---|--|%%%%------------------%----||%|||||--|||||---|||||||||||||||-|||%-|%%%%%%----------------
|||||||||||-X|XXXX-XXXXXXXXXXXXXXX|--||||||||-|X|||--|XXX|XX|||||-XXXXXXXXX-XXXXXXX|XXXX||||||||XX|||||X-XX||||||||||||||X||||-|||||||-XXXXXX--XXXXX-X