------------------------------------------------------------------------------------------------------------------------------------------------------
------------------------------------------------------------------------------------------------------------------------------------------------------
------------------------------------------------------------------------------------------------------------------------------------------------------
------------------------------------------------------------------------------------------------------------------------------------------------------
------------------------------------------------------------------------------------------------------------------------------------------------------
------------------------------------------------------------------------------------------------------------------------------------------------------
------------------------------------------------------------------------------------------------------------------------------------------------------
------------------------------------------------------------------------------------------------------------------------------------------------------
------------------------------------------------------------------------------------------------------------------------------------------------------
--------------------------------------t---------------------------------------------------------------------------------------------------------------
--------------------------------------t---------------------------------------------------------------------------------------------------------------
--------%-----------------------------t--------------------------------------------------------------------------------------------------------%------
--------|------------------%%---------%------------------------------------------------%---%-%-%%----------------------------------%%----------|------
--------|------------------||---------|%---------%-------------------------------------|---|-|-||----------------------------------||----------|------
%%%%%%%%|---------------%%%||%%%%%%%%-||-%-------|-------------------------------------|%--|%|-||----------%%%---------------------||-----%----|%-----
||||||||X-XXXXXXXXXXXXXX|||||||||||||XX|X|XXXXXXX|XXXXX--XXXXXXX----XXXXXXXXXXXXXXXXXXX||XX|||X||XXXXXXXXXX|||XXXXXXXXXXXXXXXXXXXXX||XXXXX|XXXXX|XX-XX