------------------------------------------------------------------------------------------------------------------------------------------------------
------------------------------------------------------------------------------------------------------------------------------------------------------
------------------------------------------------------------------------------------------------------------------------------------------------------
------------------------------------------------------------------------------------------------------------------------------------------------------
------------------------------------------------------------------------------------------------------------------------------------------------------
------------------------------------------------------------------------------------------------------------------------------------------------------
------------------------------------------------------------------------------------------------------------------------------------------------------
------------------------------------------------------------------------------------------------------------------------------------------------------
-------------------------------------------------------------------------------------------------------------------%---------------------------------t
-------------------------------------------------------------------------------------------------------------------|---------------------------------t
-------------------------------------------------------------------------------------------------------------------|---------------------------------t
------------------------------------------------------------------------------------------------------------F------|---------------------------------%
----------------------------------------------------------------%------2------------------------------------%%%%%--|%-%%-%%%-------------------------|
------------------------%--%%%%%%----%%%%-----------------------|-------%---%%%%%%%%%-----------------------|||||--||-||-|||%%%%%%-%-%%-%%%%---%%%-%%|
%%%%%%%%%%%%%%%%%%%%----|--||||||%---||||-%--------%%-----------|-------|---|||||||||----------------------%%||||--||-||-|||||||||-|%||-||||---|||-|||
||||||||||||||||||||XXX-|XX|||||||---||||X|XXXXXXXX||XXXXXXXXXXX|XXXXXXXXXX-|||||||||XXXXXXXXXXXXXXX-XXXXXX||||||--||X||X|||||||||X||||-||||XXX|||X||X