------------------------------------------------------------------------------------------------------------------------------------------------------
------------------------------------------------------------------------------------------------------------------------------------------------------
------------------------------------------------------------------------------------------------------------------------------------------------------
------------------------------------------------------------------------------------------------------------------------------------------------------
------------------------------------------------------------------------------------------------------------------------------------------------------
------------------------------------------------------------------------------------------------------------------------------------------------------
------------------------------------------------------------------S-----------------------------------------------------------------------------------
------------------------------------------------------------------------------------------------------------------------------------------------------
------------------------------------------------------------------------------------------------------------------------------------------------------
------------------------------------------------------------------------------------------------------------------------------------------------------
------------------------------------------------------------------%--------------------------------------------------------%--------------------------
-------------------------%----------%%%---------------------------|--------------------------------------------------------|-------%------------------
-------------------------|---------%|||-----%%%%%%%-------%%------|%%%--%%%-------------------------------------%%%%%%%%%--|-------|t-----------------
-------------------------|---------||||-----|||||||%%%%%%%||---%--||||%%|||------------------------------------%|||||||||--|-%%-%%-|t%-------%----%---
%%%%%%%%%%--------------%|---------||||-----||||||||||||||||---|--|||||||||%%%----------------%%---------%-----||||||||||%%|-||-||-|%|--%%%%%|----|---
||||||||||XXXXXXXXXXXXXX||XXXXXXXXX|XXXXXXXX||||||||||||||||XXX|XX|XX|X|||||||XXXXXXXXXXXXXXXX||X---XX---|XXX--|||||||||||||X||X||X|||X-||||||XXXX|---