------------------------------------------------------------------------------------------------------------------------------------------------------
------------------------------------------------------------------------------------------------------------------------------------------------------
------------------------------------------------------------------------------------------------------------------------------------------------------
------------------------------------------------------------------------------------------------------------------------------------------------------
------------------------------------------------------------------------------------------------------------------------------------------------------
------------------------------------------------------------------------------------------------------------------------------------------------------
------------------------------------------------------------------------------------------------------%-----------------------------------------------
--------------------%--D------------------------------------------------------------------------------|-----------------------------------------------
--------------------|---------------------------------------------------------------------------------|-----------------------------------------------
--------------------|---------------------------------------------------------------------------------|------%------------------------------------S---
--------------------|---------------------------------------------------------------------------------|------|----------------------------------------
--------------------|--------------------------------------%------------------------------------------|-----S|----------------------------------------
--------------%-----|-------%%--------%--------------------|------%%--%%%%%---------------------------|--%---|-----------------------%%%%-----%--%----
----------%---|%----|--%-%%%||--%%%%%%%----%%%--%%%%%%-----|------||--|||||----%----------------------%--|---|-----------%%-%%%%-%%%%||||%---%|--|%---
%%%%%%%%%%|---||----|--|-|||||--|||||||-%--|||--||||||-----|------||--|||||----|%------%%%-------%%---|%%|---|------%--%-||-||||-|||||||||---||--||---
|||||||||||XXX||-XXX|XX|-|||||XXXXXXXXXX|-X|||XX||||||XXXXXXXXXXXX||--|||||XXXX||XXXXXX|||XXXXXXX||XXX||||XXXXXXXXXX|XX|X||-||||X|||||XXX|XXX||X-||XXX