------------------------------------------------------------------------------------------------------------------------------------------------------
------------------------------------------------------------------------------------------------------------------------------------------------------
------------------------------------------------------------------------------------------------------------------------------------------------------
------------------------------------------------------------------------------------------------------------------------------------------------------
------------------------------------------------------------------------------------------------------------------------------------------------------
------------------------------------------------------------------------------------------------------------------------------------------------------
-------------------------------------------S----------------------------------------------------------------------------------------------------------
------------------------------------------------------------------------------------------------------------------------------------------------------
------------------------------------------------------------------------------------------------------------------------------------------------------
------------------------------------------------------------------------------------------------------------------------------------------------------
-------------------------------------------D---------------------------%------------------------------------------------------------------------%-----
----------------------------------------%------------------------------|------------------------------%------------%----------------------------|-----
----------------------------%%----------|-------------------%----------|----%%----------------------%-|-%----------|%%--------------------------|%%-%-
----------------------------||%---------|------------------%|------%-%%|----||--------------%%%%%---|-|-|----------|||%%-%%--%%------%%-%%%-----|||-|-
%%%%%%%%%%%%%-------%%------|||-%%%%%---%-----%---%%%----%-||------|-|||%%%%||----%---------|||||---|%%-|--%%%%%%%%|||||-||--||------||-|||-----|||-|-
|||||||||||||XXXXXXX||XXXXXX|||X|||||XXX|XXXXX|XXX|||XXXX|X||XXXXXXXXX||||||||XXXX|XXXXXXXXX|||||-XX|||-|XX|||||||||||||-||XX||XXXXXX||X|||-----|X|X|X