------------------------------------------------------------------------------------------------------------------------------------------------------
------------------------------------------------------------------------------------------------------------------------------------------------------
------------------------------------------------------------------------------------------------------------------------------------------------------
------------------------------------------------------------------------------------------------------------------------------------------------------
------------------------------------------------------------------------------------------------------------------------------------------------------
------------------------------------------------------------------------------------------------------------------------------------------------------
------------------------------------------------------------------------------------------------------------------------------------------------------
----------------------%-------------------------------------------------------------------------------------------------------------------------------
----------------------|------U------------------------------------------------------------------------------------------------------------------------
----------------------|----------------------------------------------------------------------------------------------------------------------------g--
----------------------|------------------------------------------------------------------------------------------------------------S------------------
--------------%-------|--------------------------------------------%------------------------------------%-%---%C---------%-%%%------------------------
--------------|-------|----%%%%%%%%%------------------%%------%----|----------------------%--%-------%-%|-|-%-|----%-%---|-|||---------%--%%----------
--------------|-------%-%--|||||||||-------%%---------||------|%-%%|%%--------------------|--|-------|-||-|-|-|---%|-|---|-|||-----%---|--||-------%--
%%%%%%%%%%%%%%%%%%%%%%|%|%%|||||||||---%%%-||---------||------||-|||||--------------------|--|-------|-||-|-|-|---||-|---|-|||%%-%%|-%%|--||-------|--
||||||||||||||||||||||||||||||||||||---|||XXXXXXXXXXXX||XXXXXX||X|||||X--XXXXXXXXXXXXXXXXX|XX|-XXX-XX|-|X-XX|XXX--||-|XXXXXXXX||-|||X|||--||XXXXXXX|XX