------------------------------------------------------------------------------------------------------------------------------------------------------
------------------------------------------------------------------------------------------------------------------------------------------------------
------------------------------------------------------------------------------------------------------------------------------------------------------
------------------------------------------------------------------------------------------------------------------------------------------------------
------------------------------------------------------------------------------------------------------------------------------------------------------
------------------------------------------------------------------------------------------------------------------------------------------------------
---------------------------------------------------------------------------------------------------------------------%--------------------------------
---------------------------------------------------------------------------------------------------------------------|--------------------------------
---------------------------------------------------------------------------------------------------------------------|--------------------------------
---------------------------------------------------------------------------------------------------------------------|--------------------------------
-------------------------------------------------------------------%-------------------------------------------------|--------------------------------
-------------------------%-g---------------------------------------|-------------------------------------------------|---------------------------S----
----------%--------------|-----------------%%--%%%------------%--%%|--------%%--%%%%%--------------------%-----------|-------------------------%-----C
----------|-----%%%%%-%%%|-----------------||--|||-%%--%%%----|--|||--------||--|||||%%%---%%%%%--%%%%---|%%-%%%%%---|-------------------------|---%--
%%%%%%%%--|-----|||||%||||-----------------||--|||-||--|||----|--|||-----%--||--||||||||---|||||--||||-%%|||-|||||---|-------------------------|---|--
||||||||--|XX-XX|||||||||XXX---XXXXXXXXXXXX||--|||X||XX|||XXXX|XX|||--XXX|--||--||||||||---|||||--||||-|||||X|||||XXX|XXXXXXXXXXXXXXXXXXXXXXXXX|-X-|XX