------------------------------------------------------------------------------------------------------------------------------------------------------
------------------------------------------------------------------------------------------------------------------------------------------------------
------------------------------------------------------------------------------------------------------------------------------------------------------
------------------------------------------------------------------------------------------------------------------------------------------------------
------------------------------------------------------------------------------------------------------------------------------------------------------
------------------------------------------------------------------------------------------------------------------------------------------------------
------------------------------------------------------------------------------------------------------------------------------------------------------
------------------------------------------------------------------------------------------------------------------------------------------------------
------------------------------------------------------------------------------------------------------------------------------------------------------
------------------------------------------------------------------------------------------------------------------------------------------------------
------------------------------------------------------------------%%%---------------------------------------------------------------------------------
-------------------g----------------------------------------------|||---------------------------------------------------------------------------------
------------------%--------------%%%%%-%------------------------%%|||%---------------------%--------------------%-----------------%-------------------
---------%%%------|--------------|||||-|-------------%%%%%%%--%%||||||---%%%%%%%%%--%%%%%%-|%---%---------------|--%---%%%--------|--------%----------
%%%%%%%%-|||%%%---|--%%--%-%-----|||||-|-------------|||||||--||||||||%--|||||||||--||||||-||--%|-%%%%%%%-------|--|---|||%---%%%%|%-------|----------
||||||||-||||||-XX|X-||--|X|XXXXX|||||X|XXXXX-XXXXXXX|||||||--|||||||||XX|||||||||XX||||||X||-X||X|||||||XXXXXXX|XX|-XX||||XXX||||||XXXXXXX|XXXXXXXXXX