------------------------------------------------------------------------------------------------------------------------------------------------------
------------------------------------------------------------------------------------------------------------------------------------------------------
------------------------------------------------------------------------------------------------------------------------------------------------------
------------------------------------------------------------------------------------------------------------------------------------------------------
-------------------------------%----------------------------------------------------------------------------------------------------------------------
---------------------------%---|----------------------------------------------------------------------------------------------------------------------
---------------------------|---|----------------------g-----------------------------------------------------------------------------------------------
---------------------------|---|---------------------%%-----------------------------------------------------------------------------------------------
---------------------------|---|S--------------------||-------------------------------------------------------------------------%---------------------
---------------------------S---|---------------------||-------------------------------------------------------------------------|---------------------
-------------------------------%-%%%----------%%%----||-------------------------------------------------------------------------|---------------------
-------------------------------|-|||----------|||----||------------------------------------------g------------------------------|---------------------
----------%%%%%%%%%-%%%%%%--%%%|%|||--%%%%%%--|||----||------------%%%%%%%--%----%%%-%---------------------------------------%%%|-%-%-----------------
----------|||||||||-||||||-%||||||||-%||||||--|||--%%||%%%%%%%--%--|||||||--|-%%%|||%|----%%%-%-%-%----------%--%%%-%---%-%%%||||%|%|----%%%----%-----
%%%%%%%%%%|||||||||-||||||-|||||||||%|||||||--|||%-|||||||||||--|--|||||||--|%||||||||----|||-|-|-|----------|--|||-|---|-|||||||||||----|||----|-----
|||||||||||||||||||X||||||-|||||||||||||||||XX||||X|||||||||||XXXX-|||||||--||||||||||XXXX|||-|X|X|XXXXXXXXXX|--|||-|XXX|X|||||||||||XXXX|||XXXXXXXXXX