------------------------------------------------------------------------------------------------------------------------------------------------------
------------------------------------------------------------------------------------------------------------------------------------------------------
------------------------------------------------------------------------------------------------------------------------------------------------------
------------------------------------------------------------------------------------------------------------------------------------------------------
------------------------------------------------------------------------------------------------------------------------------------------------------
------------------------------------------------------------------------------------------------------------------------------------------------------
------------------------------------------------------------------------------------------------------------%-----------------------------------------
-----------------------------------------------------------D------------------------------------------------|-----------------------------------------
------------------------------------------------------------------------------------------------------------|-----------------------------------------
------------------------------------------------------------------------------------------------------------|-----------------------------------------
----------------------------------------------------------------------------------------------%-------------|-----------------------------------------
-------------------------------------------------S--------------------------------------------|-------------|------S----------------------------------
------------%---%------------%%------%%%-------%%------------------------------------%%-------|-------------|---------------------------%-------------
------------|---|------------||------|||-------||----------%----%%%-%%---%--%----%%%%||-%%%---|---%-----%%%-%-------------%%------%%%%%-|------%%-----
%%%%%%%%%%%%|%%%|-%----------||------|||-------||---%--%-%-|----|||-||---|--|----||||||%|||---|---|-----|||-|------%------||------|||||%|------||-----
|||||||||||||||||-|XXXXXXXXX-||XXXXXX|||XXXXXXXXXXX-|X-|X|X|X-XX|||-||XXX|XX|XXXX||||XX||||XXX|XXX|XX--X|||X|XXXXXX|XXXXXX||XXXXXX||||||XXXXX-XXXXXXXX