------------------------------------------------------------------------------------------------------------------------------------------------------
------------------------------------------------------------------------------------------------------------------------------------------------------
------------------------------------------------------------------------------------------------------------------------------------------------------
------------------------------------------------------------------------------------------------------------------------------------------------------
------------------------------------------------------------------------------------------------------------------------------------------------------
------------------------------------------------------------------------------------------------------------------------------------------------------
-----------------------------------------------------------------------------S------------------------------------------------------------------------
------------------------------------------------------------------------------------------------------------------------------------------------------
------------------------------------------------------------------------------------------------------------------------------------------------------
-------------------------------------------------------------------------------------------------------------------------S----------------------------
--------------------------------%---------------------------------------------------------------------------------------------------------------------
--------------------------------|------F----------------------------------------------------------------------------------%----------g----------------
------------------------%%-%%--%|------%----------------%--------------------%-----------%----------------------%---------%---------------%-----------
-----------------%%-%%--||-||--||------|----%-%---------|------%%%%----------|-----------|----------------------|F-%%%%%-%%%%%%-%%-------%|%%%---%%---
%%%%%%%%---------||-||%%||-||--||------%%%%%|%|------%%%|%%%%%%||||-%%-------|------%%---|----------------------|%-|||||-||||||%||-------|||||%-%||---
||||||||XXX--XXXX||X||||||-||XX||XXXXXX||||||||-----X||||||||||||||X||XXXXXXX|XXXXXX||XXX|XXXXXXXXXXXXXXXXXXXXXX||X|||||-|X|||||||XXXXXXX||||||-|||XXX