------------------------------------------------------------------------------------------------------------------------------------------------------
------------------------------------------------------------------------------------------------------------------------------------------------------
------------------------------------------------------------------------------------------------------------------------------------------------------
------------------------------------------------------------------------------------------------------------------------------------------------------
------------------------------------------------------------------------------------------------------------------------------------------------------
------------------------------------------------------------------------------------------------------------------------------------------------------
---------------------------------------------------------------------------------------------S--------------------------------------------------------
-----------------------------------------D-----------------------------------------------%-------------------------D----------------------------------
-----------------------------------------------------------------------------------------|------------------------------------------------------------
-----------------------------------------------------------------------------------------|------------------------------------------------------------
-----------------------------------------------------------------------------------------|---%---------------------------------%----------------------
--------------G----------%--------------%------%-------------------------------%%%%%%%%--|---|---------------------------------|----------------------
--------------2----------|--------------|------|-------%-%%%%%%%-----------%-%%|||%||||--|r--|---------------------------%----%|--------------------%%
------------%-----%------|--------------|%-----|-------|-|||||||%%-%-------|-||||||||||-%|%--|-%-%%%%%-------------%----%|%-%%||------------%%%%-%%%||
%%%%%%%%%%%-|-----|------|-------------%||-----|-------|-|||||||||-|-------|-||||||||||-|||--|-|-|||||-------------|----|||-||||------------||||-|||||
|||||||||||X|-XXXXXXXXXXXXXXXXXXXXXXXXX|||XX-XX|XX-XXXX|X|||||||||X|XXXXXXXXX||XXX|XXXXX|||XX|X|X|||||XXXXXXXXXXXXX|XXXX|||X||||XXXXXXXXXXX-||||X|||||