------------------------------------------------------------------------------------------------------------------------------------------------------
------------------------------------------------------------------------------------------------------------------------------------------------------
------------------------------------------------------------------------------------------------------------------------------------------------------
------------------------------------------------------------------------------------------------------------------------------------------------------
------------------------------------------------------------------------------------------------------------------------------------------------------
------------------------------------------------------------------------------------------------------------------------------------------------------
------------------------------------------------------------------------------------------------------------------------------------------------------
------------------------------------------------------------------------------------------------------------------------------------------------------
------------------------------------------------------------------------------------------------------------------------------------------------------
------------------------------------------------------------------------------------------------------------------------------------------------------
-------------------------------------------------------------------------------------------------------%%---------------------------------------------
--------%%---------------------------------------------------------------------------------------------||---------------------------------------------
--------||%---------------------------------------------%%%U---------------------------%%%%%-----------||-------------------------------------%%%-----
--------||%-----%-----------------------%%%%%%%%%%%-----|||-%%%%%-----%---%%--%%%%---%-|||||-%%-%--%---||%--%%%%%-%%-----------------%%-------|||-----
%%%%%%%%|||%--%-|--------%---%---%%%---%|||||||||||-----|||-|||||-%%%%|%%%||%%||||---|-|||||%||%|%%|%--|||--|||||-||-------%-%%%%%%%%||%%%%---|||-----
||||||||XXX|XX|X|XXXXXXXX|---|XXX|||---||||||||||||XXXXX|||X|||||X||||||||||||||||--X|XX|||||||||||||XX|||--|||||X||XXXXXXX|X||||||||||||||XXX|||XXXXX