------------------------------------------------------------------------------------------------------------------------------------------------------
------------------------------------------------------------------------------------------------------------------------------------------------------
------------------------------------------------------------------------------------------------------------------------------------------------------
------------------------------------------------------------------------------------------------------------------------------------------------------
------------------------------------------------------------------------------------------------------------------------------------------------------
------------------------------------------------------------------------------------------------------------------------------------------------------
------------------------------------------------------------------------------------------------------------------------------------------------------
------------------------------------------------------------%-----------------------------------------------------------------------------------------
------------------------------------------------------------|-----------------------------------------------------------------------------------------
------------------------------------------------------------|---------------%-------------------------------------------------------------------------
--------------------------------------%---------------------|---------------|-------------------------------------------------------------------------
--------------------------------------|---------------------|---------------|--------------------------------------------%%---------------------------
----------------%%%-------------------|---------------------|--------%------|-----%------------------------------------%-||-------%-------------------
----------------|||%-----%%%-%%%%----%%-%-----%-------------|--%%----|%%---%|-----|---%------------%-------------------|-||--%%---|%%%%%%%%%%%%----%%-
%%%%%%%%%%%%--%-||||%----|||-||||%%-%||-|-----|-----%------%%--||---%|||---||-----|---|------------|----------%--------|-||%-||---|||||||||||||--%%||-
||||||||||||XX|-|||||----|||-||||||X|||X|XXXXX|XXXXX|-XXXX-||XX||-XX|X||XXX||X-XXXXXXXXXXXXXXXXXXXX|XXXXXXXXXX|X---XXXX|X|||X||XXX|||||||||||||XX||||X