------------------------------------------------------------------------------------------------------------------------------------------------------
------------------------------------------------------------------------------------------------------------------------------------------------------
------------------------------------------------------------------------------------------------------------------------------------------------------
------------------------------------------------------------------------------------------------------------------------------------------------------
------------------------------------------------------------------------------------------------------------------------------------------------------
------------------------------------------------------------------------------------------------------------------------------------------------------
------------------------------------------------------------------------------------------------------------------------------------------------------
------------------------------------------------------------------------------------------------------------------------------------------------------
------------------------------------------------------------------------------------------------------------------------------------------------------
------------------------%-----------------------------------------------------------------------------------------------------------------------------
--------------%---------|-----------------------------------------------------------------------------------------------------------%-----------------
--------------|---------|------------------------------------------------------------F----------------------------------------------|-----------------
--------------|---------|------------%-------------------------%%%%------%%-%-%%%%--%%--%%------------------------------------------|-----------------
--------------|-------%-|--------%%%%|%%%----%%--%-------------||||------||-|-||||%%||%-||-%%--------%%%--%-%%-------------%%---%%%%|--------------%%%
%%%%%%%%%%%%%-|-------|-|--------||||||||%%%%||--|------------%||||%%%%%-||-|-|||||||||-||-||--------|||--|-||-------------||---|||||--%%----------|||
|||||||||||||X|XXXXXX-|X|X-XXX---||||||||||||||XXXXXXXXXXXX---||||||||||X||-|X|||||||X|X||X||XXXXXXXX|||-X|X||--XXXXXXX-XXX||XXX|||||-X||XXXXXXXXXX|||