------------------------------------------------------------------------------------------------------------------------------------------------------
------------------------------------------------------------------------------------------------------------------------------------------------------
------------------------------------------------------------------------------------------------------------------------------------------------------
------------------------------------------------------------------------------------------------------------------------------------------------------
------------------------------------------------------------------------------------------------------------------------------------------------------
----------------------------------------%-------------------------------------------------------------------------------------------------------------
----------------------------------------|---------------------------------------------------------------------------------%---------------------------
----------------------------------------|---------------------------------------------------------------------------------|---------------------------
----------------------------------------|---------------------------------------------------------------------------------|---------------------------
----------------------------------------%---------------------------------------------------------S-----------------------|---------------------------
----------------------------------------|---------------------------------------------------------------------------------|---------------------------
----------------------------------------|--------------------------------------------%--------------------------%---------|---------------------------
------------------------------------%---|------------------%-------------------------|--------------------------|---------|---------------------------
--------%------------%--%%---%----g-|---|-%-----------%%---|------%%-%%%-%%%%--%%----|-%--------%%%%%%%---------|---------|%--------------------%-----
%%%%%%%%|--%-----%---|--||---|------|---|%|-----------||---|------||-|||-||||--||---%|-|%%%%%%-%|||||||------%--|--%%%%%%%||--%------%----------|-----
|||||||||XX|XXXX-|XXX|XX||XXX|--X--X|XXX||XXXXXXXX-XXX||XXX|XXXXXX||X|||X||||XX||XXX||X|||||||X||||||||XX-XXX|XX|XX|||||||||XX|XXXXXX|XXXXXXXXXX|XXXXX