------------------------------------------------------------------------------------------------------------------------------------------------------
------------------------------------------------------------------------------------------------------------------------------------------------------
------------------------------------------------------------------------------------------------------------------------------------------------------
------------------------------------------------------------------------------------------------------------------------------------------------------
---------------t--------------------------------------------------------------------------------------------------------------------------------------
---------------t--------------------------------------------------------------------------------------------------------------------------------------
---------------t--------------------------------------------------------------------------------------------------------------------------------------
---------------D--------------------------------------------------------------------------------------------------------------------------------------
------------------------------------------------------------------------------------------------------------------------------------------------------
---------------------------------------------------------%--------------------------------------------------------------------------------------------
---------------------------------------------------------|----------%---------------------------------------------------------------------------------
---------------%-----------------------------------------|----------|-----------------------------------------------%---------------------------------
---------%-%---|-------------------------------------%--%|------%%--|---------G-------------------%%%--%------------|---%%%---%--------------%%-------
---------|-|--%|-%%---------------------------------%|%%||------||--|-------%%%---------------%---|||--|------------|---|||---|---%%----%---%||%------
%%%%%%%%%|-|%-||%||-------------------------%%%%%%--||||||-----%||--|%%%%---|||------------%--|---|||%-|------------|---|||---|---||----|---||||------
||||||||||X||XX||||XXXXXX--XXXXXXXXXXXXXXXXX||||||XX||||||-----|||XX|||||XXX|XXXXXXXXXXXXXX|XXXXXX||||X|XXXXXXXXXXXX|XXXXXXXXX|XXX||XXX-XXXXX||XX---XX