------------------------------------------------------------------------------------------------------------------------------------------------------
------------------------------------------------------------------------------------------------------------------------------------------------------
------------------------------------------------------------------------------------------------------------------------------------------------------
------------------------------------------------------------------------------------------------------------------------------------------------------
------------------------------------------------------------------------------------------------------------------------------------------------------
------------------------------------------------------------------------------------------------------------------------------------------------------
------------------------------------------------------------------------------------------------------------------------------------------------------
------------------------------------------------------------------------------------------------------------------------------------------------------
------------------------------------------------------------------------------------------------------------------------------------------------------
------------------------------------------------------------------------------------S-----------------------------------------------------------------
-------------------------------------------------------------------------------------------------------------%----------------------------------------
-------------------------------------------------------------------------------------------------------------|----------------------------------------
------------%%%--%%%%----%%--------------------------------%%---%-------------------------------------%------|---------%--%---------------------------
------------|||--||||%-%-||--------------------------------||-%%|%----%-------------%-----------------|%-%%%%|%%%%-----|%-|------------%-%%%-%%%%-----
%%%%%%%%%%-%|||%%|||||-|-||-------%------------------------||-||||----|-------------|---------%----%%%||%|||||||||-----||%|-----------%|-|||-||||-%%%-
||||||||||X|||||||||||-|X||XXXXXX-|XXXXXXXXXXXXXXXXXXXXXXXX||-||||XXX-|XXXXXXXXXXXXX|-XXXXXXXX|XXX-|||||||||||||||XXXXX|||XXXXXXXXXXXX||X|||X||||-|||X