------------------------------------------------------------------------------------------------------------------------------------------------------
------------------------------------------------------------------------------------------------------------------------------------------------------
------------------------------------------------------------------------------------------------------------------------------------------------------
------------------------------------------------------------------------------------------------------------------------------------------------------
------------------------------------------------------------------------------------------------------------------------------------------------------
------------------------------------------------------------------------------------------------------------------------------------------------------
------------------------------------------------------------------------------------------------------------------------------------------------------
-------------------------------------------------------------------------------------------------------------------D----------------------------------
------------------------------------------------------------------------------------------------------------------------------------------------------
------------------------------------------------------------------------------------------------------------------%-----------------------------------
------------------------------------------------------------------------------------------------------------------|-----------------------------------
------------------%--------------%------------------------------------------%%%-----------------------------------|----%------------------------------
------------------|--------------|------%---%-----------------------%-------|||-%-------------%%%--%%--%%-%%%%----|---%|----%-----%%----%--%%--%%%%--%
---------%%-------|---------%----%------|---|-------%----------%%---|-------|||-|------------K|||-%||--||-||||-%--|%--||----|-----||----|--||-%||||--|
%%%%%%%%-||-%-----|%-%------|----|------|---|---%---|----------||%%-|----%--|||-|%-%%--%%%%%%%|||%|||%-||-||||-|--||--||----|%----||----|--||-|||||%%|
||||||||X||X|XXXXX||X|XXXXXX|--X-X---XXX|XXX|XXX|XXX|XXXXXXXXXX||||X|XXXX|XXXXXX||-||XX|||||||||||||||X||X||||-|XX||XXXXXXXX||XX-X||----|XX||X||||||||