------------------------------------------------------------------------------------------------------------------------------------------------------
------------------------------------------------------------------------------------------------------------------------------------------------------
------------------------------------------------------------------------------------------------------------------------------------------------------
------------------------------------------------------------------------------------------------------------------------------------------------------
------------------------------------------------------------------------------------------------------------------------------------------------------
----------------------------------------------------------------------------------------------S-------------------------------------------------------
------------------------------------------------------------------------------------------------------------------------------------------------------
--------------------------------------------------------------------------------------------%---------------------------------------------------------
--------------------------------------------------------------------------------------------|-%-------------------------------------------------------
--------------------------------------------------------------------------------------------|-|-------------------------------------------------------
--------------------------------------------------------------------------------------------|-|%---------------------------------------------------%--
--------------------------------------------------------------------------------------------|-||---------------------------------------------------|--
---------------------------------------------%%-----------------------------------------%%--|%S|-------%%---%%%--%---------------------------------|--
----------%%%%%%%----%%--%%%%%%%%--%%%%-%----||-------%-%--------------%--%-%-----------||--||-|-------||---|||--|-------------------%%%-----------|g-
%%%%%%%%%-|||||||--%%||--||||||||%%||||-|----||-------|-|--------------|--|%|-----------||%%||-|%%-%%%%||---|||--|--------%------%---|||--%%----%--|--
|||||||||X|||||||XX||||XX||||||||||||||X|XXXXXXXXXXXXX|X|XXXXXXXXXXXXXX|XX|||XX--XXXXXXX||||||S|||X||||||XX-|||XX|XXXXXXXX|XXXXXX|XXX|||XX||-XXX|XX|XX