------------------------------------------------------------------------------------------------------------------------------------------------------
------------------------------------------------------------------------------------------------------------------------------------------------------
------------------------------------------------------------------------------------------------------------------------------------------------------
------------------------------------------------------------------------------------------------------------------------------------------------------
------------------------------------------------------------------------------------------------------------------------------------------------------
------------------------------------------------------------------------------------------------------------------------------------------------------
------------------------------------------------------------------------------------------------------------------------------------------------------
------------------------------------------------------------------------------------------t-----------------------------------------------------------
------------------------------------------------------------------------------------------t-----------------------------------------------------------
---------------------------------%--------------------------------------------------------t-----------------------------------------g-----------------
---------------------------------|--------------------------------------------------------t-----------------------------------------------------------
---------------------------------|-------------------------------------------%%------%%%--%-----------g----------------------------%------------%-----
---------------------%----%%%%---|------%-----------------------%%-----------||------|||%%|-----------|----------------%-----------|------------|-----
-----------%%--%%-%--|%%%-||||-%%|-%-%%%|%%-%%----%%%-%---%%%%%%||%-%%-------||------||||||---%-------|--------%%%--%%%|-%%--%-%--%|%%%---------|--%-%
%%%%%%%%%%%||%%||-|--||||-||||-|||-|-||||||%||----|||-|---|||||||||-||-------||------||||||%%%|%%-----|--------|||%-||||%||--|%|%%|||||---------|--|-|
|||||||||||||||||-|XX||||-||||X|||X|X|||||||||----|||-|XXX|||||||||X||---XXXX||XXXXXXXXXXXX||||||XXXXXXXXXXXXXX||||X|||X|||XX||||||||||XXXXXXXXXXXX|X|