------------------------------------------------------------------------------------------------------------------------------------------------------
------------------------------------------------------------------------------------------------------------------------------------------------------
------------------------------------------------------------------------------------------------------------------------------------------------------
------------------------------------------------------------------------------------------------------------------------------------------------------
------------------------------------------------------------------------------------------------------------------------------------------------------
------------------------------------------------------------------------------------------------------------------------------------------------------
------------------------------------------------------------------------------------------------------------------------------------------------------
------------------------------------------------------------------------------------------------------------------------------------------------------
------------------------------------------------------------------------------------------------------------------------------------------------------
------------------------------------------------------------------------------------------------------------------------------------------------------
-------------------------------------------t---------------------------------------------------------------------------------------------%------------
-------------------------------------------t---------------------------------------------------------------------------------------------|------------
-------------------------------------------t---------------------------------------------%-------%%%%-%-%%%%%%------------%%%------------|-%%%--------
--------%%------%%-----%%%%-%------%--%%---%--------------%---------------%--------------|%------||||-|%||||||------------|||-%----------|-|||--------
%%%%%%%%||%%%%%%||%-%--||||%|------|--||%--|--------------|---------------|--------------||-%%---||||-||||||||%-----------|||%|--%--%%%%-|-|||--------
|||||||||||||||||||X|XX||||||-XXX--|--|||XX|XXXXXX-XXXXXXX|XXXXXXXXXXXXXXX|XXXXXXXXXXXXXX||X||XXX||||X|||||||||XXXXXXXXXXXXXX||XX|XX||||X|X|||XXXXXXXX