------------------------------------------------------------------------------------------------------------------------------------------------------
------------------------------------------------------------------------------------------------------------------------------------------------------
------------------------------------------------------------------------------------------------------------------------------------------------------
------------------------------------------------------------------------------------------------------------------------------------------------------
------------------------------------------------------------------------------------------------------------------------------------------------------
------------------------------------------------------------------------------------------------------------------------------------------------------
------------------------------------------------------------------------------------------------------------------------------------------------------
---------------%--------------------------------------------------------------------------------------------------------------------------------------
---------------|--------------------------------------------------------------------------------------------------------------------------------------
---------------|--------------------------------------------------------------------------------------------------------------------------------------
---------------|-----------------------------------------------------------------------------------t--------------------------------------------------
---------------|----------------------------------------------------------------------------------Ct--------------------------------------%%----------
---------------|-------%-----------------%%%%%%-------------------------------------------------%--t--------------------------------------||----------
--------------%%------%|-----------------||||||-------------------------------------------------|%-%----------%----------%--%--%-%%%--%---||---g------
%%%%%%%%%%%%%%||------||%-%%-------------||||||%--%%-%-------------------------------%--%%------||-|----------|--------%%|-%|--|-|||--|---||---------%
||||||||||||||||XXXXXX|||-||XXXXXXXXXXXXX|||||||XX||X|XXXXXXXXXXXXXX-XXXXXXXXXXXXXXXX|XX||XXXXXX||X|XXXX---XX-XXXX-XXXX||X-||XX|-|||XX|XXXXXXXXXXXXXX|