------------------------------------------------------------------------------------------------------------------------------------------------------
------------------------------------------------------------------------------------------------------------------------------------------------------
------------------------------------------------------------------------------------------------------------------------------------------------------
------------------------------------------------------------------------------------------------------------------------------------------------------
------------------------------------------------------------------------------------------------------------------------------------------------------
------------------------------------------------------------------------------------------------------------------------------------------------------
------------------------------------------------------------------------------------------------------------------------------------------------------
-----------------------------------------------------------------------------------------------------------------------------%------------------------
-----------------------------------------------------------------------------------------------------------------------------|------------------------
-----------------------------------------%-----------------------------------------------------------------------------------|------------------------
-----------------------------------------|-----------------------------------------------------------------------------------|------------------------
----------g-----------------------------S|C-------------S----------%---------------------------------------------------------%---%--------------------
-----------------------------%-----------|--%%%%---%%%%%-----------|-------%%%-----------------------------------------------|-t-|%-------------------
--------------%--------------|-----------|--||||---|||||--------%%-|%------|||-------------------------------------%----%%---|%t-||----------------%%%
%%%%%%%%%%----|--------------|-----------|--||||--%|||||--------||-||--%--%|||-%%----------------------------------|%---||---||%%||--%%%%-----%%---|||
||||||||||XXXX|XXXXXXXXXXX-XX|XX-XXXXXXXX|XX||||XX||||||XX----XX||X||XX|--|XXX-||-XXXXXXXXXXXXXXXXX-XXXXXXXXXXXXXXX||XXX||X-X||||X|XX||||XXXXX||XXX|||