------------------------------------------------------------------------------------------------------------------------------------------------------
------------------------------------------------------------------------------------------------------------------------------------------------------
------------------------------------------------------------------------------------------------------------------------------------------------------
------------------------------------------------------------------------------------------------------------------------------------------------------
------------------------------------------------------------------------------------------------------------------------------------------------------
------------------------------------------------------------------------------------------------------------------------------------------------------
---------------------------------------------------------------D--------------------------------------------------------------------------------------
------------------------------------------------------------------------%%--------------------------------------D-------------------------------------
------------------------------------------------------------------------||----------------------------------------------------------------------------
------------------------------------------------------------------------||---------------------------------C------------------------------------------
------------------------------------------------------------------------||----------------------------------------------------------------------------
--------------------------------------------%---------------------------%|----------------------------------%-----------------------------------------
--------------%-------%%----%%%-------------|------------------%--------||-------------------------%--------|---------------------------%-----%-------
--------------|-------||----|||-------------|-----------------%|%%%%----|%%-------%----------------|---%---%|---%----%-%%%%%%%%%-%--%%-%|%-%%-|-------
%%%%%%%%%%%---|%%-----||----|||%%---------%-|----%%--%%%%%%---||||||%%%%|||%%%%%--|------%---------|---|---||---|%---|-|||||||||%|%-||-|||-||-|----%%%
|||||||||||-XX|||XXXXX||XXXXXXX||-XXXXXXXX|XXXXXX||XX||||||XXX||||||||||||||||||--|XXXXXX|XXXXXXXXXXXXX|XXX||XXX||XXX|X||||||||||||-||-|X|X||X|-XXX|||