------------------------------------------------------------------------------------------------------------------------------------------------------
------------------------------------------------------------------------------------------------------------------------------------------------------
------------------------------------------------------------------------------------------------------------------------------------------------------
------------------------------------------------------------------------------------------------------------------------------------------------------
------------------------------------------------------------------------------------------------------------------------------------------------------
------------------------------------------------------------------------------------------------------------------------------------------------------
------------------------------------------------------------------------------------------------------------------------t-----------------------------
------------------------------------------------------------------------------------------------------------------------t-----------------------------
------------------------------------------------------------------------------------------------------------------------%-----------------------------
-------------------2----------------------------------------------------------------------------------------------------|-----------------------------
------------------------------------------------------------------------------------------------------------------------|-----------------------------
------------------------------%-----------------------------------------------------------------------------------------|-----------------------------
------------------------------|-----------------------------------------------------------------------------------------|-----------------------------
------------%%%%--%-%%%%%--%%%|--------------%-------------------------------------------%-------%--%%-----%%%%%%%%%%%%-|-----------------------------
%%%%%%%%-%%%||||--|-|||||%-|||%%%%-----------|-------------------------%-------%---------|-------|%-||----%||||||||||||-|--%%%%%%%%%%%--%%%-%---------
||||||||-|||||||X-|X||||||-|||||||XXXX---XXXX|XXXXXXXXXXXXXXXXXXXXXXXXX|XXXXXXX|X--XXXXXX|XX---X-||XXXXX--|||||||||||||X|--|||||||||||XX|||X|XXXXX-XXX