------------------------------------------------------------------------------------------------------------------------------------------------------
------------------------------------------------------------------------------------------------------------------------------------------------------
------------------------------------------------------------------------------------------------------------------------------------------------------
------------------------------------------------------------------------------------------------------------------------------------------------------
------------------------------------------------------------------------------------------------------------------------------------------------------
------------------------------------------------------------------------------------------------------------------------------------------------------
------------------------------------------------------------------------------------------------------------------------------------------------------
------------------------------------------------------------------------------------------------------------------------------------------------------
------------------------------------------------------------------------------------------------------------------------------------------------------
---------------------------------------------t--------------------------------------------------------------------------------------------------------
---------------------------------------------t-------------------------------------------------------------------------------------------------------%
----------------------%----------------------t-------------------------------------------------------------------------------------------------------|
----------------------|-----------%-----%%---%%%%---%%%%%%-%--%%-%%%%%%%%%%------------------------------------------%%------------------------------|
---------%-------%%%-%|-%---%%%%%%|%%%%%||---||||---||||||-|--||-||||||||||----%-------------------------------%%%%-%||--------------------------%---|
%%%%%%%%%|-%%%-%%|||%||-|---||||||||||||||%%-||||---||||||-|--||-||||||||||----|%-----%%%-%%-%%--%-------------||||%|||---------------------%%%%%|%%%|
||||||||||-|||-|||||||XX|XXX||||||||||||||||-||||---||||||X|-X||-||||||||||XXXX||XXXXX|||-||-||XX|XXXXXXXXXXXXX||||||||-XXXX---XXXXXX--XXX-X||||||||||