------------------------------------------------------------------------------------------------------------------------------------------------------
------------------------------------------------------------------------------------------------------------------------------------------------------
------------------------------------------------------------------------------------------------------------------------------------------------------
------------------------------------------------------------------------------------------------------------------------------------------------------
------------------------------------------------------------------------------------------------------------------------------------------------------
------------------------------------------------------------------------------------------------------------------------------------------------------
------------------------------------------------------------------------------------------------------------------------------------------------------
-------------------------------%----------------------------------------------------------------------------------------------------------------------
-------------------------------|----------------------------------------------------------------------------------------------------------------------
-------------------------------|----------------------------------------------------------------------------------------------------------------------
-------------------------------|------------------------------------------------------------------------------------------------%---------------------
-------------------------------|------------------------------------------------------------------------------------------------|---------------------
------------------------------%|-----------------------------------------------------%--------------------------------%---------|--------%------------
------------------------------|%------------%--------------------%-------------------|----------------------%-----%--%|%------%%|-%%%-%%-|%%%--%------
%%%%%%%%----------------------||------------|--------------------|-------------------|-------------%%------%|----%|--|||------|||-|||-||-||||%-|---%--
||||||||X-XXXXXXXXXXXXX-XXXXXX||XXXXXXXXXXXX|XXXXXXXXXXXXXXXXXXXXXXXXXXXXXXXXXXXXXXXX|XXXXXXXXXXXXX||XXXX-X||----||--|||XXXXXX|||X|||-||X|||||X|XXX|XX