------------------------------------------------------------------------------------------------------------------------------------------------------
------------------------------------------------------------------------------------------------------------------------------------------------------
------------------------------------------------------------------------------------------------------------------------------------------------------
------------------------------------------------------------------------------------------------------------------------------------------------------
------------------------------------------------------------------------------------------------------------------------------------------------------
------------------------------------------------------------------------------------------------------------------------------------------------------
------------------------------------------------------------------------------------------------------------------------------------------------------
-----------------------------------------------------------------------------------------------------------------------------%------------------------
---------------------------------------------------------------------------------------------------------------------------%-|------------------------
---------------------------------------------------------------------------------------------------------------------------|-|------------------------
-------------------------------------------------------------------------------------------------------------------------%%|-|------------------------
-------------------------------------------------------------------------------------------------------------------------|||-|--------------------%---
------------%-%%%----%-----%-------------------------------------------K----------------------%-----------%%%---%%%%%----|||%|%--%%%--------------|---
------------|-|||----|-----|-------%%%%%%-%%%---%%-------------------%%%%-%-%%--%%%-----------|-----------|||---|||||----||||||K-|||%%%%-%%%---%%%|--%
%%%%%%%%%%--|-|||----|-----|-------||||||%|||-%%||--%----------%%----||||-|-||--|||%----------|---%%-%----|||---|||||----||||||%%|||||||-|||--%||||%-|
||||||||||XX|X|||XXXX|XXX--|XXXXXXX||||||||||X||||XX|XXXXXXXXXX||XXXX||||X|X||X-||||XXXXXXXXXX|---||X|XXX-|||XXX|||||XXXX|||||||||||||||-|||--||||||-|