------------------------------------------------------------------------------------------------------------------------------------------------------
------------------------------------------------------------------------------------------------------------------------------------------------------
------------------------------------------------------------------------------------------------------------------------------------------------------
------------------------------------------------------------------------------------------------------------------------------------------------------
------------------------------------------------------------------------------------------------------------------------C-----------------------------
------------------------------------------------------------------------------------------------------------------------------------------------------
------------------------------------------------------------------------------------------------------------------------------------------------------
---------%---------------%-----------------------------------------------------------------------------------C-%--------------------------------------
---------|---------------|-------------------------------------------------------------------------------------|--------%-----------------------------
---------|---------------|------------------------------------------------------------%------------------------|-----%--|-----------------------------
---------|%%-------------|------------------------------------------------------------|------------------------|-----|--|-----------------------------
---------|||-------------|------------------------------------------------------------|----------------%-------|-----|-%|-----------------------------
---------|||-------------|------%------%---------%-%------------------------------%%%%|----------------|------%|%%%%%|%|%--%%%-------%%%------%%%%%%%-
---------|||-------%--%%-%%-----|------|%--------|-|%--%%%----%-%-%---------------|||||%-%--------%----|-----%|||||||||||--|||-------|||------|||||||-
%%%%%%%%%|||%%%%%%%|--||-||-----|------||--%-----|-||--|||%%%%|-|-|--%%-----------||||||-|--------|----|%%%%-||||||||||||--|||-------|||------|||||||-
||||||||||||||||||||X-||X||XXX-X|XXXXXX||XX|--XXX|X||--||||||||X|-|XX||XXXXXXXXXXX||||||X|XXXXXXXX|XX-X|||||X||||||||||||XX|||XXXXXX-XXXX-XXXX|||||||X