------------------------------------------------------------------------------------------------------------------------------------------------------
------------------------------------------------------------------------------------------------------------------------------------------------------
------------------------------------------------------------------------------------------------------------------------------------------------------
------------------------------------------------------------------------------------------------------------------------------------------------------
------------------------------------------------------------------------------------------------------------------------------------------------------
------------------------------------------------------------------------------------------------------------------------------------------------------
------------------------------------------------------------------------------------------------------------------------------------------------------
------------------------------------------------------------------------------------------------------------------------------------------%-----------
------------------------------------------------------------------------------------------------------------------------------------------|-----------
------------------------------------------------------------------------------------------------------------------------------------------|-----------
------------------------------------------------------------------------------------------------------------------------------------------|-----------
------------------------------------------------------%------------------------------------------%----------------------------------------|---------%-
------------------------%%%---%%---%%-----------------|---%%-----%-----------------%-------------|--------------------%-%-----------------|---------|-
------------------------|||---||---||%----------%-----|---||-----|---r--%----%%%%%%|%%%%%%%%%%---|--------------------|-|-%----%%%----%%-%|%%%%%--%%|-
%%%%%%%%----------%-----|||---||-%%|||%%--------|-----|---||%----|%--%%%|----|||||||||||||||||---|--------------------|-|-|-%%%|||%%--||-|||||||--|||-
||||||||XXX--XXXXX|XXXXX|||XXX||X|||||||XXXXXXXX|XXXXX|XXX|||XXXX||--||||XXXX|||||||||||||||||-XXXX-XXXXXXXXXXXXXXX-XX|X|X|X||||||||XX||X|||||||--||X-