------------------------------------------------------------------------------------------------------------------------------------------------------
------------------------------------------------------------------------------------------------------------------------------------------------------
------------------------------------------------------------------------------------------------------------------------------------------------------
------------------------------------------------------------------------------------------------------------------------------------------------------
-------------%----------------------------------------------------------------------------------------------------------------------------------------
-------------|----------------------------------------------------------------------------------------------------------------------------------------
------------S|----------------------------------------------------------------------------------------------------------------------------------------
-------------|----------------------------------------------------------------------------------------------------------------------------------------
-------------|----------------------------------------------------------------------------------------------------------------------------------------
------------S|----------------------------------------------------------------------------------------------------------------------------------------
----------%--|------------------------------------------------------------------------------------------------------------------%----S----------------
----------|--|-------------------------%---------------------C------------------------------------------------------------------|---------------------
----------|%-|------%%-----------------|--------------------------%--%--------------%%%-------%-------%%-%----------------------|-%-------------%-%---
--------%%||-|--%---||%-------%%%%%-%--|--%%--%%%-----------------|--|----%F%-------|||-------|-------||-|---%------------------|-|--%----------|-|---
%%%%%%%%||||-|%%|%%%|||-------|||||-|--|--||--|||-----------------|%-|----|%|--%-%-%|||%%%%%%%|%%%%%%-||-|%-%|---%%%%%%---------|-|--|----------|%|---
||||||||||||X||||||||||XXXXX-X|||||-|--|-X||XX||XXXXXXXXXXXXXXXXXX||X|XXX-|||XX|X|-||||||||||||||||||X||X||X||XXX||||||X--XXXXXX|X|XX|XXXXXXXXXXX||-XX