------------------------------------------------------------------------------------------------------------------------------------------------------
------------------------------------------------------------------------------------------------------------------------------------------------------
------------------------------------------------------------------------------------------------------------------------------------------------------
------------------------------------------------------------------------------------------------------------------------------------------------------
------------------------------------------------------------------------------------------------------------------------------------------------------
------------------------------------------------------------------------------------------------------------------------------------------------------
------------------------------------------------------------------------------------------------------------------------------------------------------
------------------------------------------------------------------------------------------------------------------------------------------------------
------------------------------------------------------------------------------------------------------------------------------------------------------
------------------------------------------------------------------------------------------------------------------------------------------------------
----------------------%%%-----------------------------------------------------------------------------------------------------------------------------
----------------------|||-----------------------------------------------------------------------------------------------------------------------------
----------------------|||-----------%----------------------%%---------------------------------------------------------%--%%%%--%--------------------%%
----------------------|||----------%|%-----%%%%------------||---------------------------------------------%-----------|--||||-%|---%----------------||
%%%%%%%%--%%%---%%-%%-|||-%%%%%----|||%%%%%||||------------||---------------------------------------------|%-%%%%%%%--|%%||||%||-%%|----------%-----||
||||||||-X|||XXX||X||-|||-|||||XXXX||||||||||||XXXXXXXXXXXX||XXXXXXXXXXXXXXXXXXXXXXXXXXXXXXXXXXXXXXXXXXXXXX|X|||||||--||||||||||X|||XXXXXXXXXX|-XX-X||