------------------------------------------------------------------------------------------------------------------------------------------------------
------------------------------------------------------------------------------------------------------------------------------------------------------
------------------------------------------------------------------------------------------------------------------------------------------------------
------------------------------------------------------------------------------------------------------------------------------------------------------
------------------------------------------------------------------------------------------------------------------------------------------------------
------------------------------------------------------------------------------------------------------------------#-----------------------------------
------------------------------------------------------------------------------------------------------------------%-----------------------------------
------------------------------------------------------------------------------------------------------------------|-----------------------------------
------------------------------------------------------------------------------------------------------------------|-----------------------------------
-----------------------------%----------------------------%-------------------------------------------------------|-----------------------------------
-----------------------------|-------------%--------------|-------------------------------------------------------|-----------------------------------
-----------------------------|-------%-----|--------------|-------------------------------------------------------t-----------------------------------
----------------------------#|-%-----|-----|--------------|-----------------------%-------------------g%%---------t----%%---%%------------------%-----
----------%%%%%%%%---%----%%%|-|-----|-----|---------%%%--|-%%%%%%----------%-----|--------------------||---------%----||---||------------------|-----
%%%%%%%%%%||||||||%%-|%---||||%|%%%--|%%%%-|----%----|||--|-||||||-%%%-%%---|%----|-----%%-------------||---------|----||---||------------------|-----
||||||||||||||||||||-||---|||||||||X-X||||X|XXXX|XXXX|||--|-||||||X|||-||XXX||XXXX|--XXX||XXXXXXXXXXXX-||XXXXXXXXX|XXXXX|XXX||XXXXXXXXXXXXXXXX-X|XXXXX