------------------------------------------------------------------------------------------------------------------------------------------------------
------------------------------------------------------------------------------------------------------------------------------------------------------
------------------------------------------------------------------------------------------------------------------------------------------------------
------------------------------------------------------------------------------------------------------------------------------------------------------
------------------------------------------------------------------------------------------------------------------------------------------------------
------------------------------------------------------------------------------------------------------------------------------------------------------
------------------------------------------------------------------------------------------------------------------------------------------------------
------------------------------------------------------------------------------------------------------------------------------------------------------
-----------------------------------U------------------------------------------------------------------------------------------------------------------
------------------------------------------------------------------------------------------------------------------------------------------------------
--------%-----------------------------------%---------------------------------------------------------------------------------------------------------
--------|---------------------------------%-|---------------------------------------------------------------------------------------------------------
--------|------------------------%%%------|-|--------------------------------------%%%------------------------------------------------------------%---
--------|-------------%-------%--|||------|-|------%----%%%%-----------------------|||-----%------------------------------------------------------|---
%%%%%%%%|%------------|-%%%--%|--|||------|-|------|--%-||||----------%%-%%%%%%%---|||-----|----%%-------%----------%-----------------------------|---
||||||||||XXXXXXXXXXX-|X|||XX||XX|||---XXX|X|XXXXXX|--|X||||XXXXXXXX--||-|||||||XXX|||-XXXX|XXXX||XXXXXXX|---XX--XXX|XX----XXXXXXXXXXXXXXXXXXXXXXX|XXX