------------------------------------------------------------------------------------------------------------------------------------------------------
------------------------------------------------------------------------------------------------------------------------------------------------------
------------------------------------------------------------------------------------------------------------------------------------------------------
------------------------------------------------------------------------------------------------------------------------------------------------------
-------------------------------------------------------#----------------------------------------------------------------------------------------------
-------------------------------------------------------#----------------------------------------------------------------------------------------------
-------------------------------------------------------#----------------------------------------------------------------------------------------------
------------------------------------------------------------------------------------------------------------------------------------------------------
-------------------------------------------------------------------------------S------%---------------------------------------------------------------
--------------------------------------------------------------------------------------|---------------------------------------------------------------
--------------------------------------------------------------------------------------|---------------------------%---------------%----------%--------
--------------------------------------------------------------------------------------|---------------------------|--------------g|----------|--------
---------------------------%---%-------------------------------------%------%%%%%-----|-----%---------------------|--------------%|----%-----|--------
----------%----------------|---|---------------------%%-----------%--|------|||||-----|-----|---%%--%%%%%%%%%%%%%%|-%%%--%%-%%%--||--%%|%%%%%|%--%-%%%
%%%%%%%%%%|----------------|---|%------------%%%-----||%----------|--|------|||||%-%%-|-----|---||--|||||||||||||||%|||%-||-|||%%||%-||||||||||--|-|||
|||||||||||XXXXXXXXX-XXXXXX|XXX||X-XXXXXXXXXX|||XXXXX|||XXXXX--XXX|XX|XXXXXX||||||-||-|XXXX-|XXX||XX||||||||||||||||||||X|XX|||||X||X||||||||||--|-|||