------------------------------------------------------------------------------------------------------------------------------------------------------
------------------------------------------------------------------------------------------------------------------------------------------------------
------------------------------------------------------------------------------------------------------------------------------------------------------
------------------------------------------------------------------------------------------------------------------------------------------------------
------------------------------------------------------------------------------------------------------------------------------------------------------
------------------------------------------------------------------------------------------------------------------------------------------------------
------------------------------------------------------------------------------------------------------------------------------------------------------
-----------------------------------------------------------------------------------------%------------------------------------------------------------
-----------------------------------------------------------------------------------------|------------------------------------------------------------
--------------------------------------S-----------------------------S--------------------|------------------------------------------------------------
------------------------------------------------------%--------------%-------------------|----------------------%-------------------------------------
--------S------------------------------------%--------|--------------|---------%---------|----------------------|-------------------------------------
------------------------------------------y--|--------|--------------|---------|----%----|---------%-%%-%%%%%---|%%%%----------%--%-%%%%%%%%----------
--------------------%%--%%%---%-%%%%--%%%%%%%|%-%-----|-----%-%---%-%|---------|----|----%---------|-||-|||||---|||||----------|--|-||||||||----------
%%%%%%%%----------%%||-%|||---|-||||%%|||||||||-|-----|%%-%-|%|%%%|%||%----%%--|%%%%|----|---------|-||%|||||---|||||----------|--|-||||||||----------
||||||||X--XXXXXXX||||X||||---|-|||||||X|||||||X|XXXXX|||X|-|||||||||||----||X-||||||XXXX|X-XX-XXXX|X||||||||XXX|||||XXXXXXXXXX|--|-||||||||XXX-XX-XXX