------------------------------------------------------------------------------------------------------------------------------------------------------
------------------------------------------------------------------------------------------------------------------------------------------------------
------------------------------------------------------------------------------------------------------------------------------------------------------
------------------------------------------------------------------------------------------------------------------------------------------------------
------------------------------------------------------------------------------------------------------------------------------------------------------
------------------------------------------------------------------------------------------------------------------------------------------------------
------------------------------------------------------------------------------------------------------------------------------------------------------
--------------------------------------------------------------------------------------%---------------------------------------------------------------
------------------------------------------------------------------------%-------------|---------------------------------------------------------------
------------------------------------------------------------------------|-------------|---------------------------------------------------------------
------------------------------------------------------%-----------------|-%-----------|---------------------------------------------------------------
------------------------------------------------------|-----------------|-|-----------|-----------------------------------------------------%---------
--------------------%%%-------%-%---%%%%%------%------|---------------%%|%|%-%%------%|--------------------------------------%-----------%%%|%%%%%----
--------------------|||%%-----|-|---|||||------|------|---------------||||||-||%%%---|%%%--%%%%%---------------------%-------|-----------|||||||||----
%%%%%%%%%%----%%%---|||||-----|-|---|||||------|------|---------------||||||-|||||-%-||||--|||||%%%%%%%%%------%%----|---%%%-|%%%--------|||||||||----
||||||||||XXXX|||X--|||||XX---|X|--X|||||XXX---|XXXXXX|XXXXXXX---X----||||||-|||||-|X||||--||||||||||||||XXXXXX||XXXX|XXX|||X||||X-XX-XX-|||||||||----