------------------------------------------------------------------------------------------------------------------------------------------------------
------------------------------------------------------------------------------------------------------------------------------------------------------
------------------------------------------------------------------------------------------------------------------------------------------------------
------------------------------------------------------------------------------------------------------------------------------------------------------
------------------------------------------------------------------------------------------------------------------------------------------------------
------------------------------------------------------------------------------------------------------------------------------------------------------
------------------------------------------------------------------------------------------------------------------------------------------------------
------------------------------------------------------------------------------------------------------------------------------------------------------
--------------------------------------------------------------------T---------------------------------------------------------------------------------
--------------------------------------------------------------------t---------------------------------------------------------------------------------
---------------------------------------------S----------------------t--------------------------------------------------%------------------------------
--------------------------------------------------------------------t-------------------------------------------%%%%---|----------%%------------------
-----------------t%---%------%--%-%%%%%%%%----------------%---------%---------------------%%----------------%%--||||%--|%%--------||%----------%------
-----------------t|---|------|--|-||||||||%---%%--------%-|%----%%%%|-%%------------------%|--%----%%%%---%-||--|||||--|||--------|||%---------|------
%%%%%%%%%%-------t|---|----%%|--|-|||||||||%-%||-----%%-|%||----|||||%||%%----------------||--|----||||---|-||%-|||||--|||-%------||||%%%%-----|------
||||||||||X-XXXXXX|-XX|XXXX|||X-|X||||||||||X|||--XXX||X||||XXX-||||X|||||-XXXXXXXXXXXXX--X|XX|XX--||||XXX|X|||XXXXX|XX|||X|XXXXXX||||||||XXXXX|XXXXXX