------------------------------------------------------------------------------------------------------------------------------------------------------
------------------------------------------------------------------------------------------------------------------------------------------------------
------------------------------------------------------------------------------------------------------------------------------------------------------
------------------------------------------------------------------------------------------------------------------------------------------------------
------------------------------------------------------------------------------------------------------------------------------------------------------
------------------------------------------------------------------------------------------------------------------------------------------------------
------------------------------------------------------------------------------------------------------------------------------------------------------
------------------------------------------------------------------------------------------------------------------------------------------------------
------------------------------------------------------------------------------------------------------------------%-----------------------------------
--------------------------------------------------------#---------------------------------------------------------|-----------------------------------
--------------------------------------------------------#---------------------------------------------------------|-----------------------------------
---------------%----------------------------------------#--------------------------S------------------------------|-----------------------------------
---------------|------------%---%%%%--%%%%%%%%%%-----%--%----%%---%%---------------------%------------------------|-------------%---------------------
---------------|----%%-%%---|%--||||--||||||||||-----|--|----||---||%%%%%%-%%%%%%--------|-----------------------%|-------------|-%%%-%%%-%%%%---%----
%%%%%%%%%%-----|-%--||%||%%%||%%||||-%||||||||||----%|--|---%||---||||||||-||||||%-%%%%-%|%%%%%%%%%%--%%--------%|%-------------|-|||%|||-||||---|----
||||||||||XXXXXX-|XX||||||||||||||||-|||||||||||XXXX||X-|---|||XX-||||||||-|||||||-||||-||||||||||||XX||XXX-XXXX|||-XXXXXXXXXXXX|X|||||||X||||--X|XXXX