------------------------------------------------------------------------------------------------------------------------------------------------------
------------------------------------------------------------------------------------------------------------------------------------------------------
------------------------------------------------------------------------------------------------------------------------------------------------------
------------------------------------------------------------------------------------------------------------------------------------------------------
------------------------------------------------------------------------------------------------------------------------------------------------------
------------------------------------------------------------------------------------------------------------------------------------------------------
-----------------------------C------------------------------------------------------------------------------------------------------------------------
------------------------------------------------------------------------------------------------------------------------------------------------------
-----------------------------------------------------------------------------------------------------------------------------------------------------%
-----------------------------------------------------------------------------------------------------------------------------------------------------|
-----------------------------%--%%%%%----------------------------------------------------------------------------------------------------------------|
-----------------------------|--|||||------------------------%------------------------------------------------------------%----%%-----------%--------|
--------------------%%%------|--|||||------------------------|%---%%%%--%--%--------%-------------------------%-----------|%-%-||---------%-|%-------|
--------------------|||------|--|||||--------------------%---||---||||--|--|-%------|-------------------------|--------%-%|%-|%||---------|-||-------|
%%%%%%%%%%%%%%%%%%--|||------|--|||||--%------------%%%--|---||---||||--|--|-|%-%%--|%-%---------%--%%--------|%-------|-|||-||||---------|%||-------|
||||||||||||||||||-X|||-XXXXX|XX|||||XX|----XXXXXXXX|||--|X--||---||||XX|XX|X||-||XX||X|XXXXXXXXX|XX||XXXXXXXX||XXXXXXXXX||XX|X||XXXXXXXXX|||XXXXXXXX|