------------------------------------------------------------------------------------------------------------------------------------------------------
------------------------------------------------------------------------------------------------------------------------------------------------------
------------------------------------------------------------------------------------------------------------------------------------------------------
------------------------------------------------------------------------------------------------------------------------------------------------------
------------------------------------------------------------------------------------------------------------------------------------------------------
------------------------------------------------------------------------------------------------------------------------------------------------------
------------------------------------------------------------------------------------------------------------------------------------------------------
-----------------------------------------%------------------------------------------------------------------------------------------------------------
-----------------------------------------|-------------%-----%----------------------------------------------------------------------------------------
-----------------------------------------|-------------|-----|----------------------------------------------------------------------------------------
----------------------------%%%%%%%%-----|-------------|-----|----------------------------------------------------------------------------------------
--------------%-------------||||||||-----|-------------|-----|----------------------------------------------------------------------------------------
--------------|----------%%%||||||||-----|---%---------|-----|------------%------------------------%%%----%%-------------------------------%----------
-----------%-%|------%%%-|||||||||||%--%%|%%%|%%%%%%---|%%%%-|------------|------------------------|||----||---------------%---------------|-------%--
%%%%%%%%%%-|-||-%----|||-||||||||||||--|||||||||||||---|||||-|-%----------|----------------%-%%----|||---%||-%-------------|%----%---------|------%|--
||||||||||-|X||-|XXX-|||X||||||||||||XX|||||||||||||---|||||X|X|XXXXXXXXXX|XXXXX-XXXXXXXXX-|X||XXXX|||X--|||X|XXXXXXXXXXXXX||----|XXXXXXXXX|XXXXXX||--