------------------------------------------------------------------------------------------------------------------------------------------------------
------------------------------------------------------------------------------------------------------------------------------------------------------
------------------------------------------------------------------------------------------------------------------------------------------------------
------------------------------------------------------------------------------------------------------------------------------------------------------
------------------------------------------------------------------------------------------D-----------------------------------------------------------
-------------------------------------------------------------------------S----------------------------------------------------------------------------
------------------------------------------------D-----------------------------------------------------------------------------------------------------
-----------------------------------------------------------------%------------------------%-----------------------------------------------------------
-----------------------------------------------------------------|------------------------|-----------------------------------------------------------
-----------------------------------------------------------------|------------------------|-----------------------------------------------------------
-----------------------------------------------------------------|------------------------|--------------------------------------%--------------------
------------------%--------------------------------------%-------|------------------------|---%-------------%-------------%------|--%-----------------
-----------------%|%-------%%%------------------%--------|-------|-------%-%-----%---%%%%%|---|-------------|---%----%----|------|%%|-----------------
-----------------||%%------|||--%%%%%%---%%-%--%|%%%%----|-------|-------|-|----%|%--||||||---|-g-----------|---|----|--%%|%-----||||--%%%%%----------
%%%%%%%%%--------||||------|||--||||||---||%|-%||||||--%-|-------|%------|-|----|||--||||||-%%|----------%--|%--|----|--||||-----||||%-|||||----------
|||||||||XXXXXXXX|X||XXXXXX|||XX||||||X--||||-|||||||--|-X---XXXX||XXXXXX|X|XXXX|||XX||||||X|||XXXXXXXXXX|XX||XX|XXXX|X-||X|XXXXX|||X|-|||||XXXXXXXXXX