------------------------------------------------------------------------------------------------------------------------------------------------------
------------------------------------------------------------------------------------------------------------------------------------------------------
------------------------------------------------------------------------------------------------------------------------------------------------------
------------------------------------------------------------------------------------------------------------------------------------------------------
------------------------------------------------------------------------------------------------------------------------------------------------------
------------------------------------------------------------------------------------------------------------------------------------------------------
------------------------------------------------------------------------------------------------------------------------------------------------------
------------------------------------------------------------------------------------------------------------------------------------------------------
------------------------------------------------------------------------------------------------------------------------------------------------------
----------------------------------------------------------------------------------------%-------------------------------------------------------------
----------------------------------------------------------------------------------------|-------------------------------------------------------------
-------------------------------%%-----------------------%-------------------------------|---%%-g----------------------------------%-------------------
-------------------------------||-----------------------|-------------------%-%%--------|-S-||----------------------------%%%%%%%-|%%%%---------------
-------------------------------||-----%--g--------------|------------%%%%%%%|%||--------|%--||---%---------------------%-%|||||||-|||||-----%%%--%%%%%
%%%%%%%%%%%%---%%%%%%----------||%%%--|---------%-------|------------|||||||||||--------||--||---|%%%-%%%------%-------|%||||||||-X||||-----|||--|||||
||||||||||||---||||||--XXXXXXXXXX|||XXX--XXXXXXX|XXXXXXXXXXXXXXXXXXXX|||||||||||XXX-XX-X||SXXXX--||||-|||XXXXXX|XXXXXXX||||||||||XX||||XXXXX|||--|||||