------------------------------------------------------------------------------------------------------------------------------------------------------
------------------------------------------------------------------------------------------------------------------------------------------------------
------------------------------------------------------------------------------------------------------------------------------------------------------
------------------------------------------------------------------------------------------------------------------------------------------------------
------------------------------------------------------------------------------------------------------------------------------------------------------
------------------------------------------------------------------------------------------------------------------------------------------------------
---------%--------------------------------------------------------------------------------------------------------------------------------------------
---------|--------------------------------------------------------------------------------------------------------------------------------------------
---------|---------------------------------------------------------------------------------------------%----------------------------------------------
---------|----%----------------------------------------------------------------------------------------|----------------------------------------------
---------|----|----------------------------------------------------------------------------------------|---------S---%--------------------------------
---------|----|---------------------%---------------%--------------------------------------------------|-------------|--%-----------------------------
---------|----|---------------------|---------------|---%----------%%%%--------------------------------%-------------|--|--------%-%%%%---------------
---------|----|--------------------%|---------------|-%-|----------||||-%%-------%%%%%%--------%%----%-|%%--%%%%%%%%%|--|--------|-||||%--------------
%%%%%%%%%|%%--|---%%%----%---%%%%%-||-----%%%%%%%%%-%-|%|----------||||-||-------||||||---%%---||%%%%|-|||--||||||||||--|%%%%%%%%|-|||||---%------%---
||||||||||||XX|X--|||XXXX|---|||||X|XXXXXX|||||||||-|X|||X-XXXX-XXX||||-||-------||||||X--||XXX|||||||X|||--||||||||||-X||||||||||-|||||XXX|XXXXXX|XXX