------------------------------------------------------------------------------------------------------------------------------------------------------
------------------------------------------------------------------------------------------------------------------------------------------------------
------------------------------------------------------------------------------------------------------------------------------------------------------
------------------------------------------------------------------------------------------------------------------------------------------------------
------------------------------------------------------------------------------------------------------------------------------------------------------
------------------------------------------------------------------------------------------------------------------------------------------------------
--------------------------------------------------------------------------------------------------S---------------------------------------------------
------------------------------------------------------------------------------------------------------------------------------------------------------
------------------------------------------------------------------------------------------------------------------------------------------------------
--------------------------------------------------------------------------------------------------%--------------------------------------------%------
-------------------------------------------------------------------------------------------------%|%%-%----------------------------------------|------
------------------------------------------------------------%------------------------------%-----||||-|----------------------------------------|------
------------------------%%--------%---------------------%---|%---%%%------%%%%%%-%%----%---|---%-||||-|----------------------------------------|------
---------%%%%%%%%%%--%%-||-%------|-------%-----%%%%----|---||---|||------||||||-||%---|%%-|---|-||||-|-----%%----------------------%%-%%------|-%----
%%%%%%%%%||||||||||--||-||-|------|-------|-----||||----|---||---|||--%%%-||||||-|||---|||-|-%-|-||||-|-----||----%-%%%%------------||-||--%%%%|-|----
|||||||||||||||||||--||-XXX|XXXX-X|XXXXXXX|XXXXX||||XXXX|XX-X|XXX|||XX|||X||||||X|||-XX|||X|X|X|X||||-|XXXXX||XXXX|X||||XXXXXXXXXXXX||X||XX|||||X|XXXX