------------------------------------------------------------------------------------------------------------------------------------------------------
------------------------------------------------------------------------------------------------------------------------------------------------------
------------------------------------------------------------------------------------------------------------------------------------------------------
------------------------------------------------------------------------------------------------------------------------------------------------------
------------------------------------------------------------------------------------------------------------------------------------------------------
------------------------------------------------------------------------------------------------------------------------------------------------------
------------------------------------------------------------------------------------------------------------------------------------------------------
------------------------------------------------------------------------------------------------------------------------------------------------------
------------------------------------------------------------------------------------------------------------------------------------------------------
------------------------------------------------------------------------------------------------------------------------------------------------------
-----------------------------%------------------------------------------------------------------------------------------------------------------------
-------------%---------------|-------------------------------------------%----------------------------------------------------------------------------
-------------|----------%----|#------------------------%---%-------------|-%-------%--%-%%%%---------%%%%-------#----------%--------------------------
-------------|----------|----|#%-----%%---%--%%--------|%r-|%%%%%%%%%----|-|-------|--|-||||---------||||---%---#----------|--------------------------
%%%%%%%%%%%--|%---%-----|---%|%|-----||%%-|--||--------||%-||||||||||----|-|-------|--|-||||-----%---||||---|---#-----%%---|---------%%--%-----%------
|||||||||||XXX|XXX|XXXXX|X--||||XXXX-XX||-|-X||--XXXXXX|||-||||||||||XXXXXX|XXXXXXX|-X|-||||XXXXX|XXX||||XXX|XXXXXXXXX||XXX|XXXXXXXXX||X-|XXXXX|XXXX-X