------------------------------------------------------------------------------------------------------------------------------------------------------
------------------------------------------------------------------------------------------------------------------------------------------------------
------------------------------------------------------------------------------------------------------------------------------------------------------
------------------------------------------------------------------------------------------------------------------------------------------------------
------------------------------------------------------------------------------------------------------------------------------------------------------
------------------------------------------------------------------------------------------------------------------------------------------------------
------------------------------------------------------------------------------------S-----------------------------------------------------------------
------------------------------------------------------------------------------------------------------------------------------------------------------
------------------------------------------------------------------------------------------------------------------------------------------------------
--------------------------------------------------------------%---------------------------------------------------------------------------------------
--------------------------------------------------------------|---------------------%-----------------------------------------------------------------
---------------------------------------t--------------------%%|---------------------|--------------------------------------------t--------------------
-----------------------%%--%%-%%%----%%t---------------%----|||---------------------|------%---------------------------------%%-%t--------------------
-----------------------||--||-|||----||%%%%%%%%--------|----|||--------%-%%%%%%-----|------|%--------------------------------||%|%%%------------------
%%%%%%%%%-----%%%------||--||-|||-%--||||||||||%%%-----|----|||-------%|-||||||%%%%%|%%----||------------------------%-------|||||||------------------
|||||||||XXXXX|||XXXXX-||XX||X|||X|XXXX|||||||||||X-XXXXXXXX|||----XX-||X||||||||||||||XXXX||XXXXXXX--XXXXXXXXXXXXXXX|X-XXXXX|||||||XXXXXXXXXXXXXXXXXX