------------------------------------------------------------------------------------------------------------------------------------------------------
------------------------------------------------------------------------------------------------------------------------------------------------------
------------------------------------------------------------------------------------------------------------------------------------------------------
------------------------------------------------------------------------------------------------------------------------------------------------------
------------------------------------------------------------------------------------------------------------------------------------------------------
------------------------------------------------------------------------------------------------------------------------------------------------------
------------------------------------------------------------------------------------------------------------------------------------------------------
------------------------------------------------------------------------------------------------------------------------------------------------------
--------------------------------------------------------------------SS--%----------S---------------------------------------------------------------%--
------------------------------------------------------------------------|-------------------------SS-----------------------%-----------------------|--
---------------------------------------%--------------------------------|--------------------------------------------------|-----------------------|--
--------%------------------------------|--------------------------------|--------------------------------------------------|----------------g------|--
--------|--%--------------------%---%%%|%--%-------------------%-%-%%%--|%%%%-%-%--%-------------%---------------%%%%%%%---|-----------------------|--
--------|--|--------------------|--%|||||%%|%%%%%%---%%%%%%%%%%|%|%|||--|||||%|%|%%|--%%%--------|%%---------%--%|||||||---|--%%%%--%--------------|--
%%%%%%%%|%%|%%%%%%%%%%--%-------|--|||||||||||||||%%%|||||||||||||||||--||||||||||||--|||-----%%%|||---------|--||||||||---|--||||--|-%%%------%%--|--
||||||||X|||||||||||||XX|XXXXXXX|-X||||||||||||||||||||||||||||||X||||XX||||||||||||XX|||-XXXX||||||--XXX-XXX|--||||||||X-X|--||||XX|-|||XXXX-X||XX|XX