------------------------------------------------------------------------------------------------------------------------------------------------------
------------------------------------------------------------------------------------------------------------------------------------------------------
------------------------------------------------------------------------------------------------------------------------------------------------------
------------------------------------------------------------------------------------------------------------------------------------------------------
------------------------------------------------------------------------------------------------------------------------------------------------------
------------------------------------------------------------------------------------------------------------------------------------------------------
--------------------------------------------%---------------------------------------------------------------------------------------------------------
--------------------------------------------|---------------------------------------------------------------------------------------------------------
--------------------------------------------|--------------------------------------------------------------------------------------------g------------
--------------------------------------%-----|--------------------------------------------------------------------------------------------%------------
--------------------------------------|-----|--------------------------------------------------------------------------%-----------------|------------
--------------------------------------|-----|--------------------------------------------------------------------------|-----------------|------------
----------------------%---------------|-----|---------%------%-------------------------------%-------------------%%%%--|-----------------|------------
----------------------|G--------------|-----|---%%%%%-|%%%%--|-------------------------%%%---|---------------%---||||--|%-----%%---------|------------
%%%%%%%%----%%-----%--|%%-------------|-----|%--|||||-|||||%-|--%--------%-------------|||---|---------------|---||||-%||%%---||---------|--%%-%%%----
||||||||XX--||XXXXX|--X||X-XXXXXXXXX-X|XXXXX||X-XXXXX-|XXXX|-|XX|XXXXXXXX|XXXXXXXXXXXXX|||XXX|XXXXXXXXXXXXXX-|XXX||||-|||||XXX||XXXXXXXXX|XX||X|||XXXX