------------------------------------------------------------------------------------------------------------------------------------------------------
------------------------------------------------------------------------------------------------------------------------------------------------------
------------------------------------------------------------------------------------------------------------------------------------------------------
------------------------------------------------------------------------------------------------------------------------------------------------------
------------------------------------------------------------------------------------------------------------------------------------------------------
------------------------------------------------------------------------------------------------------------------------------------------------------
------------------------------------------------------------------------------------------------------------------------------------------------------
------------------------------------------------------------------------------------------------------------------------------------------------------
------------------------------------------------------------------------------------------------------------------------------------------------------
------------------------------------------------------------------------------------------------------------------------------------------------------
-----------------------------------------------------------------------------------------------------------------------------------------------%%%----
-----------------------------------------------------------------------------------------------------------------------------------------------|||----
----------------------------------------------------------------------%------------------%--------------------------------%--------------------|||%---
---------%----------------------------%-%--%-------------%%-%%%%%%%%--|-%-%%%%%-%%-------|-%%%%--%%----%-%%----%------%---|--------------------||||---
%%%%%%%%%|----------------------------|-|--|%%%%%--------||-||||||||%-|-|-|||||-||-------|-||||--||----|-||%---|------|---|--%%---%------------||||%%-
||||||||||XXXXXXXXXXXXXXXXXXXXXXXXXXXX|-|XXX|||||XXXXXXXX||-|||||||||X|X|X|||||-||XXXXXXX|X||||XX||XXX-|X|||XXX|XXXXXX|XXX|XX||XXX|XXXXXXXXXXXX||||||X