------------------------------------------------------------------------------------------------------------------------------------------------------
------------------------------------------------------------------------------------------------------------------------------------------------------
------------------------------------------------------------------------------------------------------------------------------------------------------
------------------------------------------------------------------------------------------------------------------------------------------------------
------------------------------------------------------------------------------------------------------------------------------------------------------
------------------------------------------------------------------------------------------------------------------------------------------------------
------------------------------------------------------------------------------------------------------------------------------------------------------
------------------------------------------------------------------------------------------------------------------------------------------------------
------------------------------------------------------------------------------------------------------------------------------------------------------
------------------------------------------------------------------------------------------------------------------------------------------------------
------------------------------------------------------------------------------------------------------------------------------------------------------
------------------------------------------------SS-------------------------------------------------------------------%--------------------------------
-----------------%%%%----------%-------------------------------------------------------------------------------------|---------S-------%-%------------
-----------------||||----------|--------------------------------------------------------%---------------%-----%%-----|-----------------|-|--%----%%-%%
%%%%%%%%%%%%%%%%-||||----------|--------------------------%%%%%%-%------%%%-------------|---------------|-----||---%-|--------------%--|%|--|----||-||
||||||||||||||||-||||---XX-XXXX|-XXXXXXXXXXXXXXXXXXXX--XXX||||||X|X-XXX-|||XXXXXXXXXXXXX|XXXXXXXXXXXXXXX|XXXXX||XXX|X|XXXXX--XXXXXXX|XX|||XXXXX-X||XXX