------------------------------------------------------------------------------------------------------------------------------------------------------
------------------------------------------------------------------------------------------------------------------------------------------------------
------------------------------------------------------------------------------------------------------------------------------------------------------
------------------------------------------------------------------------------------------------------------------------------------------------------
------------------------------------------------------------------------------------------------------------------------------------------------------
------------------------------------------------------------------------------------------------------------------------------------------------------
--------------------------------------------------------------------------------------%---------------------------------------------------------------
------------------------------------------------------------------------%------%------|---------------------------------------------------------------
------------------------------------------------------------------------|------|------|---------------------------------------------------------------
----------------------------%-------------------------------------------|------|------|------------------%--------------------------------------------
----------------------------|-------------------------------------------|------|------|-------------#----|--------------------------------------------
----------------------------|----%--------------------------------------|------|------|-------------#g---|-S------------------------------------------
----------------------------|----|-----%-------------%--%%%%%-%%%-%%%%--|--%---|%-%%%%|--%---------%%--%-|--------------------------------%-----------
-----------%%%%--%%-%%%-----|--%-|%%---|--%----------|--|||||-|||-||||--|--|---||-|||||--|-%-%-----||--|%|--------------------------------|---%%%%%%%-
%%%%%%%%%%-||||%%||-|||---%%|--|%|||---|%%|----------|--|||||-|||%||||--|--|---||-|||||--|-|-|-----||--|||--------------------------------|--%|||||||-
||||||||||-||||||||-|||XXX|||--|||||XXX||||XX-XXXXXXX|XXX||||X||||||||XX|--|---||X|||||--|X|X|XXXX-||-X|X|XXXXXXXXXXXXXXXXX--XXXXXXXXXXXX-|XX||||||||X