------------------------------------------------------------------------------------------------------------------------------------------------------
------------------------------------------------------------------------------------------------------------------------------------------------------
------------------------------------------------------------------------------------------------------------------------------------------------------
------------------------------------------------------------------------------------------------------------------------------------------------------
------------------------------------------------------------------------------------------------------------------------------------------------------
------------------------------------------------------------------------------------------------------%-----------------------------------------------
------------------------------------------------------------------------------------------------------|-----------------------------------------------
------------------------------------------------------------------------------------------------------|-----------------------------------------------
------------------------------------------------------------------------------------------------------|-----------------------------------------------
------------------------------------------------------------------------------------------------------|-----------------------------------------------
--------%---------------------------------------------------------------------------------------------|-----------------------------------------------
--------|-----------------------------------------------------------F-------------------%%------------|---------------------------------2-------------
--------|%%--%------------------------------------------------------%-%%%--%%%%--%%%%-%%||%%--%----%%-|-----------------------------------------------
--------|||--|---------%-------------------------------%--------%%--|%|||-%||||--||||-||||||%-|----||-%%%%-------------------------------%----%---%---
%%%%%%%%|||--|----%----|----------------------%--------|--------||--%||||-|||||--||||-|||||||-|----||-||||-------------------------------|----|%%%|%%%
|||||||||||X-|XXX-|XXXXXXXXXXXXXXXXXXXX--XXXX-|XXX----XXXXXXXXXX||--|||||X|||||XX||||X||XX|X|X|XXXX||-||||XXXXXXXX-XXXXXXXXX--XXXXXXXXXXX|X---||||||||