------------------------------------------------------------------------------------------------------------------------------------------------------
------------------------------------------------------------------------------------------------------------------------------------------------------
------------------------------------------------------------------------------------------------------------------------------------------------------
------------------------------------------------------------------------------------------------------------------------------------------------------
------------------------------------------------------------------------------------------------------------------------------------------------------
------------------------------------------------------------------------------------------------------------------------------------------------------
------------------------------------------------------------------------------------------------------------------------------------------------------
------------------------------------------------------------------------------------------------------------------------------------------------------
------------------------------------------------------------------------------------------------------------------------------------------------------
---------------------------------------------S-----2%%---------------------------------------------------------------------------t--------------------
----------------------------------------------------||---------------------------------------------------------------------------t--------------------
----------------------------------------------------||-------------------G-------------------------------------------------------t--------------------
-----------------%%-%----------------------%---%-%%%||-------------------%---------------%%%%%---%--%%----%%%%%%-%%-----%--------%--------%%----------
-----------------||-|---------%-----%-%%%%%|---|-|||||----%%%%%%%---%-%%%|%%%%-%%%%%--%%-|||||---|--||----||||||-||-----|--------|--%-----||------%%--
%%%%%%%%%%%%%%%%-||-|%%%------|-----|%||||||%--|%|||||----|||||||---|-||||||||-|||||--||-|||||%%%|%%||----||||||-||-----|--------|%%|-----||------||--
||||||||||||||||-||X||||XXXXXX|X---X|||||||||X-|||||||----|||||||X--|X||X|||||-|||||XX||X|X|||||||||||XXXX||||||-||XXXXX|XXXXXXXX||||XXXXX||XXXXXX||-X