------------------------------------------------------------------------------------------------------------------------------------------------------
------------------------------------------------------------------------------------------------------------------------------------------------------
------------------------------------------------------------------------------------------------------------------------------------------------------
------------------------------------------------------------------------------------------------------------------------------------------------------
------------------------------------------------------------------------------------------------------------------------------------------------------
------------------------------------------------------------------------------------------------------------------------------------------------------
------------------------------------------------------------------------------------------------------------------------------------------------------
------------------------------------------------------------------------------------------------------------------------------------------------------
------------------------------------------------------------------------------------------------------------------------------------------------------
------------------------------------------------------------------------------------------------------------------------------------------------------
------------------------------------------------------------------------S------------------------------------------------%%%--------------------------
----------------------------------------------%-------%-----------------------------------------------------------%%-----|||--------------------------
-----------------%----%%%------%-%--%%--%--%--|-------|-----------------------------------------------------------||-----|||----S-----%----%--%%%%%%%%
-----------------|----|||------|-|-%||--|--|%-|-------|----%-----------%%-----------------------------------------||%%%%%|||----------|----|--||||||||
%%%%%%%%-%%%%%---|%%--|||-%----|%|-|||%-|--||-|%------|----|-----------||-------------------------%-%-------------||||||||||%%%-%-----%----|--||||||%|
||||||||X|||||---|||--|||X|XXXX|||-||||X|--||X||XXXXXX|XXXX|X--XXXX-XXX||--XXXXXXXXXXXX-XXXXXXXXXX|X|XXXXXXXXXXXXX|X|||||||||||X|XXXXX|XXXX|X-||||||||