------------------------------------------------------------------------------------------------------------------------------------------------------
------------------------------------------------------------------------------------------------------------------------------------------------------
------------------------------------------------------------------------------------------------------------------------------------------------------
------------------------------------------------------------------------------------------------------------------------------------------------------
------------------------------------------------------------------------------------------------------------------------------------------------------
------------------------------------------------------------------------------------------------------------------------------------------------------
------------------------------------------------------------------------------------------------------------------------------------------------------
------------------------------------------------------------------------------------------------------------------------------------------------------
------------------------------------------------------------------------------------------------------------------------------------------------------
------------------------------------------------------------------------------------------------------------------------------------------------------
---------------------------------------------------------%-------------------------------------------------------%------------------------------------
--------%------------------------------------------------|-------------------------------------------------------|-------------------------2----------
--------|--------------------%%-------------------------%|%------------------%%--%---------%-%%-----------------%|---%--------------------%-----------
--------|--------------------||----------------%--------|||%-%%%%%%%%%%%%%%%%||--|--------%|-||%%%%%%%----%----%||-%%|%%%%%%--------------|-----------
%%%%%%%%%%%%%%%%%------------||-------------%--|-------%||||-||||||||||||||||||%-|--------||-|||||||||-%%%|%%%-|||%|||||||||%%%%%-%-------|-------%%%%
|||||||||||||||||XXXXXXXXXXXX||XXXXXXXXXXXXX|XX|XXXXXXX|||||-|||||||||||||||||||X|XXXX-XXX||X|||||||||-|||||||-||||||||||||||||||X|XXXXXXX|XXX----||||