------------------------------------------------------------------------------------------------------------------------------------------------------
------------------------------------------------------------------------------------------------------------------------------------------------------
------------------------------------------------------------------------------------------------------------------------------------------------------
-----------------------------------------#------------------------------------------------------------------------------------------------------------
-----------------------------------------#------------------------------------------------------------------------------------------------------------
-----------------------------------------#------------------------------------------------------------------------------------------------------------
-----------------------------------------%------------------------------------------------------------------------------------------------------------
-----------------------------------------|------------------------------------------------------------------------------------------------------------
-----------%-----------------------------|-------------------------------------------------------------------------------%----------------------------
-----------|-----------------------------D--------------------------------S------%---------------------------------------|----------------------------
-----------|------%----------------------D%------------------------------------%-|------------r--------------------------|----------------------------
-----------|------|-----------------------|-%----------------------------------|-|------------%--------------------------%---------------%%-----------
-----------|------|----%%----------------%%-|-%%%------------------------------|-|-------%%%--|---%---%%---------------%-|------------%%-||-----------
-----------|-%--%-|----||-----%%--%------||-|-|||%%%%%%%--%%-----%-------------|-|-------|||--|---|---||--------%-%%%--|%|%%%%-%------||-||-----------
%%%%%%%%%%%|-|--|%|%%%%||-----||--|%-----||-|%||||||||||--||-%%--|-------------|-|-------|||--|---|---||-%%%%%--|-|||--|||||||%|------||%||-----------
||||||||||||X|--|||||||||X----||XX||XXXXX||-||||||||||||X-||X||XX|X-XXXXX-XXXXX|X|XXXXXXX|||XX|XXXXXXX||X|||||--|X|||--|||||||||XXXXXX|||||X-XXX------