------------------------------------------------------------------------------------------------------------------------------------------------------
------------------------------------------------------------------------------------------------------------------------------------------------------
------------------------------------------------------------------------------------------------------------------------------------------------------
------------------------------------------------------------------------------------------------------------------------------------------------------
------------------------------------------------------------------------------------------------------------------------------------------------------
------------------------------------------------------------------------------------------------------------------------------------------------------
------------------------------------------------------------------------------------------------------------------------------------------------------
----------------------------%-------------------------------------------------------------------------------------------------------------------------
----------------------------|-------------------------------------------------------------------------------------------------------------------------
--------------------------%-|-------------------------------------------------------------------------------------------------------------------------
------------------%----%--|-|-------------------------------------------------------------------------------------------------------------------------
------------------|----|--|-|--T------------------------------%---------------------------------------------------------------------------------------
----------%--C%---|---%|--|-|--t-----------------%%%%----%----|-----------------------------------------------------%%%---%%%%%%%-%%%%%---------------
----------|--%|---|---||--|-|--t-%---------------||||%%%-|---%|-%%%%--%%-%%-%%-%%-----------------%%----------------|||---|||||||-|||||---------------
%%%%%%%%%-|--||-%-|--%||%%|%|--%-|---------------|||||||-|%%%||%||||%%||-||-||-||--------------%%-||----------------|||-%%|||||||-|||||%-%%%%%%%%---%%
|||||||||XXXXX|-|X|XX||||||||--|X|------XXXXXXXXX|||||||X|||||||||||||||X||X||-|XXXXXXXXXXXXXXX||X||XXXXXXXXXXXXXXXX|||-|||||||||-||||||-||||||||XXX||