------------------------------------------------------------------------------------------------------------------------------------------------------
------------------------------------------------------------------------------------------------------------------------------------------------------
------------------------------------------------------------------------------------------------------------------------------------------------------
------------------------------------------------------------------------------------------------------------------------------------------------------
------------------------------------------------------------------------------------------------------------------------------------------------------
------------------------------------------------------------------------------------------------------------------------------------------------------
------------------------------------------------------------------------------------------------------------------------------------------------------
------------------------------------------------------------------------------------------------------------------------------------------------------
------------------------------------------------------------------------------------------------------------------------------------------------------
------------------------------------------------------------------------------------------------------------------------------------------------------
------------------------------------------------------------------------------------------------------------------------------------------------------
-------------------------------------%----------------------------------------------------------------------------------------------------------------
-------------------------------------|----------------------------------------------------------------------------------------------------------------
-------------%%%%%%%%%%%%%%%%%%%%%%%%|%%%%%%%----%%%%%%%%%%%%%%%%-%--%---------------%%--%%---------%---%%%-----------------%%------------------------
%%%%%%%%%%---||||||||||||||||||||||||||||||||%%--||||||||||||||||-|--|---------------||--||-%%--%%%%|--%|||%-------%%%%%--%-||%-----%%%%%%-%%%%-------
||||||||||XX-||||||||||||||||||||||||||||||||||--||||||||||||||||X|XX|XXXXXXXXXXXXXXX||--||X||--|||||--|||||--XXXXX|||||XX|-|||--X--||||||X||||-------