------------------------------------------------------------------------------------------------------------------------------------------------------
------------------------------------------------------------------------------------------------------------------------------------------------------
------------------------------------------------------------------------------------------------------------------------------------------------------
------------------------------------------------------------------------------------------------------------------------------------------------------
------------------------------------------------------------------------------------------------------------------------------------------------------
------------------------------------------------------------------------------------------------------------------------------------------------------
------------------------------------------------------------------------------------------------------------------------------------------------------
-----------------------------------------------------------------------------------------------------------------------------------------------%------
-----------------------------------------------------------------------------------------------------------------------------------------------|------
-----------------------------------------------------------------------------------------------------------------------------------------------|------
-----------------------------------------------------------------------------------------------------------------------------------------------|------
---------%%-----------C------------------------------------------------------------------------------------------------------------------------|------
---------||--------------------------%%%---%---------------------------%-%------------------------------------------------------%%-%%%--%------|------
---------||--------------------------|||--%|---------------------------|-|------------------%%%--%%%%%------%---%%%%%-%%%%---%%-||%|||--|------%------
%%%%%%%%%||%%%%-------------%--------|||--||--------------------%%%%%%%|-|------------------|||--|||||------|-%%|||||-||||---||-||||||--|--%%-%|------
|||||||||||||||XXXXXXXXXX-XX|XXXXXXXX|||XX||XX--XXXXXXXXXXXXX-XX||||||||X|X---XXXX-XXXXXXXXX|||XX|||||XXXXX-|X|||||||X||||---||X||||||XX|-X||X||-XXXXX