------------------------------------------------------------------------------------------------------------------------------------------------------
------------------------------------------------------------------------------------------------------------------------------------------------------
------------------------------------------------------------------------------------------------------------------------------------------------------
------------------------------------------------------------------------------------------------------------------------------------------------------
------------------------------------------------------------------------------------------------------------------------------------------------------
------------------------------------------------------------------------------------------------------------------------------------------------------
------------------------------------------------------------------------------------------------------------------------------------------------------
------------------------------------------------------------------------------------------------------------------------------------------------------
------------------------------------------------------------------------------------------------------------------------------------------------------
------------------------------------------------------------------------------------------------------------------------------------------------------
------------------U-----------------------------------------------------------------------%-----------------------------------------------------------
------------------------------------------------------------------------------------------|-----------------------------------------------------------
----------------------%------%-%--------------------------------#---%%%-------------------|--------------------%-------%-----------------------------%
-------------%------%%|------|-|--%-----------------------------#---|||----%%%------------|---%-%%%------------|-----%-|-----------------------------|
%%%%%%%%-%%%%|-%%%%%|||%%----|-|--|-----------------------------%---|||----|||------------|---|-|||-----------%|-%---|-|---%%%-------------%-----%%%%|
||||||||X|||||X||||||||||XXX-|X|XX|XXXX-XXXXXXXXXXXXX---XXXXXXXX|XXX|||XXXX|||XXXXXXXXXXXX|XXX|-|||XXXXXXXXXXX||X|XXXXX|---|||XXXXXXXXXXXX-|XXXXX|||||