------------------------------------------------------------------------------------------------------------------------------------------------------
------------------------------------------------------------------------------------------------------------------------------------------------------
------------------------------------------------------------------------------------------------------------------------------------------------------
------------------------------------------------------------------------------------------------------------------------------------------------------
------------------------------------------------------------------------------------------------------------------------------------------------------
------------------------------------------------------------------------------------------------------------------------------------------------------
------------------------------------------------------------------------------------------------------------------------------------------------------
-----------------------------------------------------%------------------------------------------------------------------------------------------------
-----------------------------------------------------|------------------------------------------------------------------------------------------------
-----------------------------------------------------|------------------------------------------------------------------------------------------------
----------------------------------------%------------|------------------------------------------------------------------------------------------------
----------------------------------------|------------|------------------------------------------------------------------------------------------------
----------------------------------------|%%----------|-------t%%-----------%------%%%-------------------%%%%---------------------%%%------------------
--------%%%%-%-----%-----%-----%-%------|||-%--%-----|%----%-t||-----------|------|||-------------------||||-------------------%-|||------------------
%%%%%%%%||||-|-----|-----|-%---|-|------|||-|--|--%--||%%--|%%||-----------|---%--|||-------------------||||-------------------|-|||------------------
||||||||||||X|XXX--|XXXXX|X|---|X|XXXXXX|||X|XX|XX|--||||X-|||||XXXXXXXXXXX|-XX|XX|||XXXXXXXX-XXXXXXXX--||||-XXXXXXXXXXXXXXXXXX|X||XXXXXXXXXXXXXXXXXXX