------------------------------------------------------------------------------------------------------------------------------------------------------
------------------------------------------------------------------------------------------------------------------------------------------------------
------------------------------------------------------------------------------------------------------------------------------------------------------
------------------------------------------------------------------------------------------------------------------------------------------------------
------------------------------------------------------------------------------------------------------------------------------------------------------
------------------------------------------------------------------------------------------------------------------------------------------------------
------------------------------------------------------------------------------------------------------------------------------------------------------
------------------------------------------------------------------------------------------------------------------------------------------------------
------------------------------------------------------------------------------------------------------------------------------------------------------
-------------------------------------------------------%----------------------------------------------------------------------------------------------
-------------------------------------------------------|-----------------------------------------------------------------------------%-----------%----
-----------------------------------%--------%------%%%-|-----------------------------------------------------------------------------|--------%--|----
----------%%--%%%%-----------------|---%----|-%%--%|||-|------%%%%%--%%%-------------------------------------------------------------|-----K-%|--|--%-
----------||--||||--------%--------|---|---%|%||--||||-|%-----|||||--|||-----%%%%-%%%%%----------------------------------------------|----%%-||%-|--|-
%%%%%%%%-%||%%||||--------|--------|---|---|||||-%||||-||%----|||||--|||---%%||||-|||||%%%-------%-%--%-------%----------------------|----||-|||-|--|-
||||||||X|||||||||XXXXXXXX|XXXXXXXX|XXX|XXX|X|||X||XXXX|||----|||||XX|||XXX||||||X||||||||XXXXXXX|X|--|XXXXXXX|XXXXXXXXXXXXXXXXXXXXXX|XXXXXXX|XXX|XX|X