------------------------------------------------------------------------------------------------------------------------------------------------------
------------------------------------------------------------------------------------------------------------------------------------------------------
------------------------------------------------------------------------------------------------------------------------------------------------------
------------------------------------------------------------------------------------------------------------------------------------------------------
------------------------------------------------------------------------------------------------------------------------------------------------------
------------------------------------------------------------------------------------------------------------------------------------------------------
------------------------------------------------------------------------------------------------------------------------------------------------------
---------------------------------------%------------------------------------------------------%-------------------------------------------------------
---------------------------------------|------------%-----------------------------------------|-------------------------------------------------------
---------------------------------------|------------|-----------------------------------------|-------------------------------------------------------
---------------------------------------|------------|-----------------------------------------|---------------------%------%--------------------------
---------------------------------------|------------|------------------------------%----------|---------------------|------|-----------------------%--
---------%-------%---------------------|------------|----%%------%%-----%%---------|%%%%%%----|-%-%-----------------|------|---------------------%%|--
---------|-------|---------%%------%---|------------|%%%%||------||-----||---------|||||||---#|-|-|-----------------|---%%%|---------------------|||--
%%%%%%%%%|%%%----|%%%-%-%--||------|---|------------|||||||------||-----||---------|||||||-%%#|-|-|--%%-------------|---||||%%%----------%%%-%---|||--
|||||||||||||----||||-|X|XX||XXXXXX|XXX|XXXXXX-XXXXX|||||||XXXXXX||XXXXX||X--XXXXXX|||||||X||X|-|-|X-||XXXXXXXX-XXXX|---|||||||XXXXXXXXXX|||X|---|||XX