------------------------------------------------------------------------------------------------------------------------------------------------------
------------------------------------------------------------------------------------------------------------------------------------------------------
------------------------------------------------------------------------------------------------------------------------------------------------------
------------------------------------------------------------------------------------------------------------------------------------------------------
------------------------------------------------------------------------------------------------------------------------------------------------------
------------------------------------------------------------------------------------------------------------------------------------------------------
-----------------------------------------------------------------------------------------------------------%------------------------------------------
---------------------------------------%-------------------------------------------------------------------|-----------------------%------------------
---------------------------------------|-------------------------------------------------------------------|-----------------------|------------------
---------------------------------------|-------------------------------------------------------------------|-----------------------|------------------
----------------------------------%%---|-------------------------------------------------------------------|-----------------------|------------------
----------------------------------||---|-------S--------------------------------%-%-----%------------------|-----------------------|------------------
--------------%%%%%--%%%%%%--%%%--||---|%%--------------------------------------|%|%-%%-|%---%%%%----------|---------------%%------|%-----------------
--------------|||||--||||||--|||--||--%|||-%----%%%%--%%-%%%-------%------------||||-||-||--%||||%---%%%%%%|%%-------------||------%|-----------------
%%%%%%%%%%%%--|||||--||||||--|||--||--||||-|----||||--||-|||-------|------------||||-||%||--||||||---|||||||||-%%%%%-------||------||----%%%%---------
||||||||||||XX|||||XX||||||-X|||XX||XXX|||-XXXXX||||XX||X|||XXXXX--|-XXXXXXXXXXX||X|X|||||XX||||||XXX|||||||||-|||||XXXXXXX||XXXXXX||XXXX||||XXXXXXXXX