------------------------------------------------------------------------------------------------------------------------------------------------------
------------------------------------------------------------------------------------------------------------------------------------------------------
------------------------------------------------------------------------------------------------------------------------------------------------------
------------------------------------------------------------------------------------------------------------------------------------------------------
------------------------------------------------------------------------------------------------------------------------------------------------------
------------------------------------------------------------------------------------------------------------------------------------------------------
------------------------------------------------------------------------------------------------------------------------------------------------------
-----------------------------------------------------------S------------------------------------------------------------------------------------------
-------------------------------%----------------------------------------------------------------------------------------------------------------------
-------------------------------|----------------------------------------------------------------------------------------------------------------------
-------------------------------|--------------------------------------------------------------------------------------------------------------------%-
-------------------------------|--------------------------------------------------------------------------------------------------------t-----------|-
-------------------%%%---------|---------------------%--%%--------%%%-%%----------------------------------------------------------------t--%--------|-
----------------%%-|||%%%%%%%%-%%-----%---%%%%%%%%%%%|%-||%%%%%%%%|||-||---%%-----%%%%-%---%%%%%%----%%%%%%%%%%-%%%%%%-%-%%%%%%%%%%%%%%%%%-|-%%-%---|-
%%%%%%%%%%-%%---||-|||||||||||%||%---%|---|||||||||||||-|||||||||||||-||--%||%%%--||||%|---||||||----||||||||||-||||||-|-|||||||||||||||||-%%||-|-%-|%
||||||||||-||XXX||X|||||||||||||||XX-||XXX|||||||||||||-|||||||||||||X||X-||||||--||||||---||||||XXXX||||||||||X||||||-|-|||||||||||||||||-||||-|X|X||