------------------------------------------------------------------------------------------------------------------------------------------------------
------------------------------------------------------------------------------------------------------------------------------------------------------
------------------------------------------------------------------------------------------------------------------------------------------------------
------------------------------------------------------------------------------------------------------------------------------------------------------
------------------------------------------------------------------------------------------------------------------------------------------------------
------------------------------------------------------------------------------------------------------------------------------------------------------
-----------------------------------------------------------------------------------------%------------------------------------------------------------
-----------------------------------------------------------------------------------------|------------------------------------------------------------
-----------------------------------------------------------------------------------------|------------------------------------------------------------
-----------------------------------------------------------------------------------------|------------------------------------------------------------
---------------------------------------------------------------------------%-------------|------------------------------------------------------------
---------------------------------------------------------------------------|-------------|------------------------------------------------------------
---------------------------------------------------------------------------|----%--------|-------------------%---%%%%%-----#--------------------------
---------%%-%%%%%%-%%%%----------------------------------------------------|----|--------|-------------------|---|||||%-%%-%-%%%%--------%--%---------
%%%%%%%%%||%||||||%||||----%------------%---------%------------------------|----|--------|-------------------|---||||||-||-|-||||--------|%%|--%%-----
|||||||||||||||||||||||XXXX|XXXXXXXXXXXX|-XXXXXXXX|XXXXXXXXX-XXXXXXXXXXXXXX|XXXX|XXXXXXXX|XXXXXXXXXXXXXXXXXXX|XXX||||||-||-|X||||XXXXXX-X||||--||-XXXX