------------------------------------------------------------------------------------------------------------------------------------------------------
------------------------------------------------------------------------------------------------------------------------------------------------------
------------------------------------------------------------------------------------------------------------------------------------------------------
------------------------------------------------------------------------------------------------------------------------------------------------------
------------------------------------------------------------------------------------------------------------------------------------------------------
---------------------------------------------------------------------------%--------------------------------------------------------------------------
---------------------------------------------------------------------------|--------------------------------------------------------------------------
---------------------------------------------------------------------------|--------------------------------------------------------------------------
---------------------------------------------------------------------------|--------------------------------------------------------------------------
---------------------------------------------------------------------------|-----------------------------------------%--------------------------------
---------------------------------------------------------------------------|-----------------------------------------|--------------------------------
---------------------------------------------------------------------------|-----------------------------------------|--------------------------------
---------------------------------------------------------------------------|----%--%------------------------%--------|-----------%%---%---------------
------------%%%---%%%%%%%%-----------------------------%------%%%%%%%%%%---|-%%-|%%|--%%-%%---%%------------|------%-|-%---------||---|---------%-----
%%%%%%%%-%--|||%--||||||||--%----------%%%----%%%%%---%|--%%--||||||||||---|%||-||||--||-||---||------------|---%--|-|-|---------||--%|%--------|-%---
||||||||-|XX||||--||||||||XX|XX---XXXXX|||XXXX|||||XXX||--||--||||||||||---||||-||||XX||X||--X||-X--X-XXXXXX|XXX|--|X|X|XXXXXXXXX||XX|||XXXXXXXX|X|XXX