------------------------------------------------------------------------------------------------------------------------------------------------------
------------------------------------------------------------------------------------------------------------------------------------------------------
------------------------------------------------------------------------------------------------------------------------------------------------------
------------------------------------------------------------------------------------------------------------------------------------------------------
------------------------------------------------------------------------------------------------------------------------------------------------------
-----------------------------%------------------------------------------------------------------------------------------------------------------------
-----------------------------|------------------------------------------------------------------------------------------------------------------------
-----------------------------|------------------------------------------------------------------------------------------------------------------%-----
-----------------------------|-------%----------------------------------------------------------------------------------------------------------|-----
-----------------------------|-------|------------------------------------------------------------------------------------------%---------------|-----
-----------------------------|-------|--------%----T-----------------------------------------------------------------%%---------|---------------D-----
-----------------------------|-------|--------|----t-----------------------------------------------------------------||---------|---------------|-----
----------------------------%|-------|-----%--|----t--%%%%%-%%%--%%--------%-------------%-----%---------------------||%%-------|---%%%--%------|-%---
-------------------%--------||%------|-----|-%|----%%%|||||-|||--||--------|-------------|-%%--|---------------------||||%--%%%%|---|||--|------|-|---
%%%%%%%%-----------|%-%%%--%|||-%%-%%|-----|-||----||||||||-|||--||--------|-----%-------|-||--|-------%-------------|||||--|||||---|||--|------|-|---
||||||||-----XXXXXX||-|||XX|X||-||-|||XXXXX|X||-XXXX|||||||-|||XX||XXXXXXXX|XXXXX|XXXXXXX|X||XX|XXXXXXX|XXXXXXXXXXXXX|||||--|||||-XX|||-X|XXXXXX|X|XXX