------------------------------------------------------------------------------------------------------------------------------------------------------
------------------------------------------------------------------------------------------------------------------------------------------------------
------------------------------------------------------------------------------------------------------------------------------------------------------
------------------------------------------------------------------------------------------------------------------------------------------------------
------------------------------------------------------------------------------------------------------------------------------------------------------
------------------------------------------------------------------------------------------------------------------------------------------------------
---------------------------------------------------------------------------------------------------------------------%%-------------------------------
---------------------------------------------------------------------------------------------------------------------||-------------------------------
---------------------------------------------------------------------------------------------------------------------||-------------------------------
---------------------------------------------------------------------------------------------------------------------||-------------------------------
---------------------------------------------------------------------------------------------------------------------||-------------------------------
---------------------------------------------------------------%-----------------------------------------------------||---------%---------------------
------------------%%%%-------------------------%---------%-----|-------------%%%-------------------%%%%%%%%%%%%%%%%--||%-%%-----|-----%---%%------%%%%
------------%--%--||||%%%%%--%%--%%------------|---------|--%--|%%-----------|||---------------%---||||||||||||||||--|||-||-----%----%|%%-||------||||
%%%%%%%%%%-%|--|%%|||||||||--||%-||----------%-|%--------|--|%-|||-----------|||---%-----------|---||||||||||||||||%-|||%||-%%%%|%%%%||||-||------||||
||||||||||-||X-||||||||||||-X|||X||XXXXXXXXXX|-||XXXX-XX-|--X|X|||XX--XXXXXXX|||X-X|-XXXXX-----|--X|||||||||||||||||X||||||X|||||||||||||-||XXXXXX||||