------------------------------------------------------------------------------------------------------------------------------------------------------
------------------------------------------------------------------------------------------------------------------------------------------------------
------------------------------------------------------------------------------------------------------------------------------------------------------
------------------------------------------------------------------------------------------------------------------------------------------------------
------------------------------------------------------------------------------------------------------------------------------------------------------
------------------------------------------------------------------------------------------------------------------------------------------------------
----------------------S-------------------------------------------------------------------------------------------------------------------------------
------------------------------------------------------------------------------------------------------------------------------------------------------
------------------------------------------------------------------------------------------------------------------------------------------------------
------------------------------------------------------------------------------------------------------------------------------------------------------
----------------------%-------------------------------------------%-----------------------------------------------------------------------------------
----------------------|-------------------------------------------|-----------------------------------------------------------------------------------
--------%%%%----------|-----%------------------------%-%-%%-------|-----%%-----------------------------------%--%---%%%%%%%%--------------%---%%%%----
--------||||----%%--%%|%%%%-|-%%%%%---%%%%%%----%----|-|-||-------|-----||--------------g--------------------|--|---||||||||--------------|---||||----
%%%%%%%%||||%%%-||-%|||||||%|%|||||---||||||----|-%--|-|-||-------|-----||------------%----------------%%%%%%|-%|%%%||||||||--------------|---||||----
|||||||||||||||-||X||||||||||||||||-X-||||||XXXX|X|X-|X|X||XXXXXX-|XXXXX||XXXXXXXXXXXX|-XXXXXXXXXXXXXXX|||||||-|||||||||||||--XXXXXXXXXXXX|XX-||||XXXX