------------------------------------------------------------------------------------------------------------------------------------------------------
------------------------------------------------------------------------------------------------------------------------------------------------------
------------------------------------------------------------------------------------------------------------------------------------------------------
------------------------------------------------------------------------------------------------------------------------------------------------------
------------------------------------------------------------------------------------------------------------------------------------------------------
------------------------------------------------------------------------------------------------------------------------------------------------------
------------------------------------------------------------------------------------------------------------------------------------------------------
------------------------------------------------------------------------------------------------------------------------------------------------------
-----------------------------%------------------------------------------------------------------------------------------------------------------------
----------------------------%|------------------------------------------------------------------------------------------------------------------------
----------------------------||------------------------------------------------------------------------------------------------------------------------
--------%------------------%||-----------------------------------------------%---%--------------------------------------------------------------------
--------|---%-------------%||%%----------%---%%-%%%%-------------------------|---|----------------------%%%%%%%%%-----------------%--------%%---------
--------|---|-------------|||||----------|---||-||||---%----U---------------%|---|------------%---------|||||||||-----%%%-%%--%%%%|------%%||---------
%%%%%%%%|---|-------------|||||----------|---||-||||%%%|%-%%-------%%-%-----||---|------------|---------|||||||||-----|||-||--|||||%--%-%||||-%%---%--
||||||||X-XX|XXXXXXXXXXXXX|X|||X-XXXXXXXX|XXX||X|||||||||X||XXXXXXX||X|-XXXX|X---X---XXXXXXXXXXXXXXXXXXX|||||||||-XXXX|||-||--||||||--|-|||||-||--X|XX