------------------------------------------------------------------------------------------------------------------------------------------------------
------------------------------------------------------------------------------------------------------------------------------------------------------
------------------------------------------------------------------------------------------------------------------------------------------------------
------------------------------------------------------------------------------------------------------------------------------------------------------
------------------------------------------------------------------------------------------------------------------------------------------------------
------------------------------------------------------------------------------------------------------------------------------------------------------
------------------------------------------------------------------------------------------------------------------------------------------------------
--------------------------%---------------------------------------------------------------------------------------------------------------------------
--------------------------|---------------------------------------------------------------------------------------------------------------------------
--------------------------|---------------------------------------------------------------------------------------------------------------------------
--------------------------|------------------------------------------%------------------------------g%%---------------------------------------%-------
--------------------------|-----------------SS-S---------------------|-------------------------------||------------------------------------%--|-------
----------%------%--------|-------------------%-----%----------------|-------------------------%-----||-------%----------------------------|--|-------
----------|------|%-----%-|-------------------|-----|%%%-%-----%%%---|------------------------%|-%---||-%%%%%%|-%%%%-%%%%-%%%%%-%%---%----%|--|-------
%%%%%%%%%%|-%----||-----|-|-------------------|-----||||%|-----|||---|%%%%---------%%%--------||-|---||%|||||||%||||%||||-|||||-||%%-|----||--|-------
|||||||||||X|-XX-||XXXXX|X|X-XXXXXXXXXX-XXXXXX|XXXXX||||||XX-XX|||XXX|||||XXXXXXXXX|||XXXXXXXX||-|X--||||||||||||||||||||X|||||X||||-|X---|XXX|XXXXXXX