------------------------------------------------------------------------------------------------------------------------------------------------------
------------------------------------------------------------------------------------------------------------------------------------------------------
------------------------------------------------------------------------------------------------------------------------------------------------------
------------------------------------------------------------------------------------------------------------------------------------------------------
------------------------------------------------------------------------------------------------------------------------------------------------------
------------------------------------------------------------------------------------------------------------------------------------------------------
------------------------------------------------------------------------------------------------------------------------------------------------------
---------------------------------------------------------------------S--------------------------------------------------------------------------------
------------------------------------------------------------------------------------------------------------------------------------------------------
--------------------------------------------------------------------------------------------------------------------------------------------------%-%-
---------%--------------------------------------------------------------------%-------------------------------------------------------------------|-|-
---------|----------------------------------------%------------------%--------|---------%%%----------------------------------------%--------------|-|-
---------|--%%------------------------------------|------------------|----%%%%|%-----%%%|||-----------------%----------------------|%%-------%----|%|-
---------|--||------------------------------------|------------------|----||||||%%%--||||||----------%-%----|---%-%----------%%%%%-|||-%%%---|---%||%-
%%%%%%%%%|%%||%---------------------%%%%%%----%%--|%-----------------|-%%%||||%||||%-||||||--%-------|-|----|---|-|-----%%%%%|||||%|||%|||---|---||||-
|||||||||||||||XXXX-XXXXX---XX-XXX--||||||X---||XX||XXXXXXXXXXXXXXXXX|X|||||||||||||-|||XXXXX|XXXXXXX|X|X-XX|XXX|X|XXXXX|||||||||||X||||||-XX|XXX||||X