------------------------------------------------------------------------------------------------------------------------------------------------------
------------------------------------------------------------------------------------------------------------------------------------------------------
------------------------------------------------------------------------------------------------------------------------------------------------------
------------------------------------------------------------------------------------------------------------------------------------------------------
------------------------------------------------------------------------------------------------------------------------------------------------------
------------------------------------------------------------------------------------------------------------------------------------------------------
------------------------------------------------------------------------------------------------------------------------------------------------------
------------------------------------------------------------------------------------------------------------------------------------------------------
---------------------------------------%--------------------------------------------------------------------------------------------------------------
-----------%%--------------------------|--------------------------------------------------------------------------------------------------------------
-----------||--------------------------|--------------------------------------------------------------------------------------------------------------
-----------||-------------------------%|----------------------------------------------------------------------%---------------------------------------
-----------||-------------------------||-------%%%%%-----%----------------------------------------------------|-----------%--%%%----------------------
-----------||%%-----------------------||-------|||||-----|--%--%----------------------------%---------------%%|-----------|--|||----------------------
%%%%%%%%---||||-----%-----------------||------%|||||-----|--|--|----------------------%%%-%%|%%%%%-%%%%-----|||--%%%%%%%%%|%%|||-%%%%%%%%%------------
||||||||XXX||||-----|XXXXXXXXXXXXXXXXX||XXXXXX||||||-----|--|--|X--XXXXXXXXXX--XX--XXX|||X||||||||X||||XXXXXXX|XX|||||||||||||||X|||||||||XXXXXXXXXXXX