------------------------------------------------------------------------------------------------------------------------------------------------------
------------------------------------------------------------------------------------------------------------------------------------------------------
------------------------------------------------------------------------------------------------------------------------------------------------------
------------------------------------------------------------------------------------------------------------------------------------------------------
------------------------------------------------------------------------------------------------------------------------------------------------------
------------------------------------------------------------------------------------------------------------------------------------------------------
-------------------%----------------------------------------------------------------------------------------------------------------------------------
-------------------|----------------------------------------------------------------------------------------------------------------------------------
-------------------|----------------------------------------------------------------------------------------------------------------------------------
-----------------%-|----------------------------------------------------------------------------------------------------------------------------------
-----------------|-|--------------------------------------%%-----------%---%--------------------------------------------------------------------------
-----------------|-|--------------------------------------||-----------|---|------------------------------------------------%-----------%%------------
--------%%-------|-|-------%--%--------------%------------||-----------|---|---------%2------%-----------------------------%|-----------||----%-------
--------||-------|-|-------|--|--%-----------|----------SC||-----------|---|---------|-------|-----------------------------||---%%%%%%%-||%---|---%---
%%%%%%%%||--%%%%%|-|-------|-%|--|-----------|------------||-----------|---|---%-----|-------|-----------------------------||---|||||||-|||---|-%%|---
||||||||||--||||||X|-XXXXXX|X||XX|XXXX----XXXXXXXXXXXXXXXX||X--XXXXXXXX|XXX|XXX|XXXXX|XXXXXX-|XXXXXX--X----XXX-XXXXXXXXXXXX|XXXX|||||||XXXXXXX|X|||--X