------------------------------------------------------------------------------------------------------------------------------------------------------
------------------------------------------------------------------------------------------------------------------------------------------------------
------------------------------------------------------------------------------------------------------------------------------------------------------
------------------------------------------------------------------------------------------------------------------------------------------------------
------------------------------------------------------------------------------------------------------------------------------------------------------
------------------------------------------------------------------------------------------------------------------------------------------------------
-----------------------%------------------------------------------------------------------------------------------------------------------------------
-----------------------|------------------------------------------------------------------------------------------------------------------------------
-----------------------|------------------------------------------------------------------------------------------------------------------------------
-----------------------|------------------t-----------------------------------------------------------------------------------------------------------
-----------------------|------------------t---------------------------------------------------------%%------------------------------------------------
-----------------------|------------------t---------------------------------------------------------||------------------------------------------------
-----------------------|---------%--------%---------------------------------------------------------||-------%---%%%%---------------------------------
-------------%-%%%%%%--|---%-%%%-|------%-|------------------------%----%%%%-%---------%%%%%%-%%%%%%||-%%----|---||||--------%%%%---------------------
%%%%%%%%%%%%%|-||||||--|---|%|||-|------|-|--------%%--------------|----||||-|----%---%||||||%||||||||%||%%%%|---||||--------||||---------------------
||||||||||||||X||||||XX|XXX|||||X|-XXXXX|X|X-XXXXXX||XXXXXXXX-XXX-X|XXXXXXXXXXXXXX|XXX||||||||||||||||||||||||-X-||||XXXXXXXX||||XXX-XXXXXXXXXXXXXXXXX