------------------------------------------------------------------------------------------------------------------------------------------------------
------------------------------------------------------------------------------------------------------------------------------------------------------
------------------------------------------------------------------------------------------------------------------------------------------------------
------------------------------------------------------------------------------------------------------------------------------------------------------
------------------------------------------------------------------------------------------------------------------------------------------------------
------------------------------------------------------------------------------------------------------------------------------------------------------
------------------------------------------------------------------------------------------------------------------------------------------------------
------------------------------------------------------------------------------------------------------------------------------------------------------
------------------------------------------------------------------------------------------------------------------------------------------------------
------------------------------------------------------------------------------------------------------------------------------------------------------
---------------------------------------------------------------------------------------%%%%-%%%-------------------------------------------------------
-------------------------------------------------%--------------------%%%----%---------||||-|||-------------------------------------------------------
------------%-------------------%%--%---%%%%---%%|-%%%%%%%%%%%%%%%----|||---%|--%---%%%||||-|||-----------------------%-%-----------------------------
------------|-------------------||--|---||||---|||-|||||||||||||||%%%-|||---||%-|---|||||||-|||---%-----------%-------|-|--------------%---------%----
%%%%%%%%%%--|-%%%-%%%-%%--------||--|---||||---|||-||||||||||||||||||%|||%-%|||%|-%%|||||||-|||---|%%%%%%%%%%%|%------|-|----%--%%%----|--%----%-|-%--
||||||||||XX|-|||X|||X||XXXXXXXX||XX|X--||||XXX||X-|||||||||||||||||||||||-||X|||-|||||||||-|||-XX||||||||||||||XXXXXX|X|-XXX|XX|||X-XX|XX|XXXX|X|X|XX