------------------------------------------------------------------------------------------------------------------------------------------------------
------------------------------------------------------------------------------------------------------------------------------------------------------
------------------------------------------------------------------------------------------------------------------------------------------------------
------------------------------------------------------------------------------------------------------------------------------------------------------
------------------------------------------------------------------------------------------------------------------------------------------------------
------------------------------------------------------------------------------------------------------------------------------------------------------
------------------------------------------------------------------------------------------------------------------------------------------------------
------------------------------------------------------------------------------------------------------------------------------------------------------
------------------------------------------------------------------------------------------------------------------------------------------------------
------------------------------------------------------------------------------------------------------------------------------------------------------
-------------------------------------------%%------------------------------%-------------%------------------------------------------------%-----------
----------------------------------%%%------||------------------------------|-------------|-----------------------%----------------%-------|-----------
----------------------%%%---------|||---%--||-----------------%------%%%%%%|-%---%%-%%%--|-----------------------|----------------|-------|-----------
----------------------|||---------|||---|--||-----------------|------|||||||-|---||-|||--|-----------------------|-----%-------%%%|%%%%--%|-----------
%%%%%%%%%%%%----------|||%--------|||---|--||%%%%-%%%%%%------|------|||||||-|---||-|||--|-------------%---------|-----|-------||||||||%%||%%%-%-%%---
||||||||||||XXXXXXXXXX||||XXXXXX--|||XXX|XX||||||X||||||-XXXXXXXXXXXX|||||||-|---||X|||XX|XXXXXXXXXXXXX|XXXXXXXXX|XXXXX|XXXXXXX|||||||||||||||X|X||XXX