------------------------------------------------------------------------------------------------------------------------------------------------------
------------------------------------------------------------------------------------------------------------------------------------------------------
------------------------------------------------------------------------------------------------------------------------------------------------------
------------------------------------------------------------------------------------------------------------------------------------------------------
------------------------------------------------------------------------------------------------------------------------------------------------------
------------------------------------------------------------------------------------------------------------------------------------------------------
------------------------------------------------------------------------------------------------------------------------------------------------------
----------------------------------------------------------------------------C-------------------------------------------------------------------------
-------------------------------------------------C----------------------------------------------------------------------------------------------------
------------------------------------------------------------------------------------------------------------------------------------------------------
--------------------------------D---------------------------------------------------------------------------------------------------------------------
----------------------------------%-------2----#----------------------------%----------------g--------------------------------------------------------
--------%----------------------%--|%-----%----%%%%--------------------------|-----------------------%--------------%%%-----------%------------------%-
--------|------------------%%--|--||%%%%%|%%%-||||-------------------------%|-----------------------|--------------|||%----%-----|-%----------------|%
%%%%%%%%|------------------||%%|%-|||||||||||-||||-------------------------||---%%%-----------------|----------%---||||----|-----|-|---%----%%------||
|||||||||XXXXXXXXXXXXXXXXXX||||||-|||||||||||X||||XXXX---XXXXXXXXXXXXXXXXX-|XXXX|||XXXXXXXXXXXXXXXXX|XXX--XXXXX|-XX||||XXXX|XXXXXX-|XXX|XXXX||XXXXXX|X