------------------------------------------------------------------------------------------------------------------------------------------------------
------------------------------------------------------------------------------------------------------------------------------------------------------
------------------------------------------------------------------------------------------------------------------------------------------------------
------------------------------------------------------------------------------------------------------------------------------------------------------
------------------------------------------------------------------------------------------------------------------------------------------------------
------------------------------------------------------------------------------------------------------------------------------------------------------
------------------------------------------------------------------------------------------------------------------------------------------------------
---------------------------------------------------------------------------------------------------------------------------------------%--------------
---------------------------------------------------------------------------------------------------------------------------------------|--------------
---------------------------------------------------------------------------------------------------------------------------------------|--------------
------------------------------------------------------------C--------%-----------------------------------------------%-----------------|--------------
---------------------------------------------------------------------|-----------------------------------------------|-%---------------|--------------
--------------------%------------------------------------------------|-----------------------------------------------|-|--------%---%%%|%-%%%%--------
--------------------|----%--------------%%%%-%%-%%--%%%-%%%%%-%%--%--|------------------------------------%----------|-|--------|---|||||-||||--------
%%%%%%%%%%%%%%%-%%%%|----|----%--%%%%%%-||||-||%||%-|||%|||||-||--|--|---%--------------------------------|----------|-|-%%-----|---|||||-||||--------
|||||||||||||||-|||||XXXX|XXXX|X-||||||-||||X||||||X|||||||||-||XX|XX|XXX|XXXXXXXXXXXXXXXXXXXXXXXXXXXXXXXX|XXXXXXXXXX|XXX||-XXXX|XXX|||||-||||XXXXXXX-