------------------------------------------------------------------------------------------------------------------------------------------------------
------------------------------------------------------------------------------------------------------------------------------------------------------
------------------------------------------------------------------------------------------------------------------------------------------------------
------------------------------------------------------------------------------------------------------------------------------------------------------
------------------------------------------------------------------------------------------------------------------------------------------------------
------------------------------------------------------------------------------------------------------------------------------------------------------
------------------------------------------------------------------------------------------------------------------------------------------------------
---------------------------------------%--------------------------------------------------------------------------------------------------------------
---------------------------------------|--------------------------------------------------------------------------------------------------------------
---------------------------------------|--------------------------------------------------------------------------------------------------------------
---------------------------------------|--------------------------------------------------------------------------------------------------------------
---------------------------------------|------------------------------%------------------%--------C-%-----------------------------G-------------------
---------------------------------------|------------------------%-----|-------------%%%%%|----------|---------------------------%%%--%-%%------%---%--
---------------------------------------|------------------------|-----|-------------||||||-%-%%%%---|------------------%--------|||-%|-||------|---|-%
%%%%%%%%%%-%%%---%---------------------|---%------------%-------|-----|-------%%----||||||-|-||||%-%|--------%---------|---%%---|||%||-||------|---|-|
||||||||||-|||-XX|XXXXXXXXXXXXXXXXXXXXX|XX-|XXXXXXXXXXXX|XXXXXXX|--XX-|XXXXXXX||XXXX|||||XX|X|||||X||XXX-XXXX|XXXXXXXXX|XXX||XXXXXX|||-||XXXXXX|-XX|X|