------------------------------------------------------------------------------------------------------------------------------------------------------
------------------------------------------------------------------------------------------------------------------------------------------------------
------------------------------------------------------------------------------------------------------------------------------------------------------
------------------------------------------------------------------------------------------------------------------------------------------------------
------------------------------------------------------------------------------------------------------------------------------------------------------
-------------%----------------------------------------------------------------------------------------------------------------------------------------
-------------|----------------------------------------------------------------------------------------------------------------------------------------
-------------|----------------------------------------------------------------------------------------------------------------------------------------
-------------|----------------------------------------------------------------------------------------------------------------------------------------
-------------|----------------------------------------------------------------------------------------------------------------------------------------
-----------%%|%---------------------------------------------------------------------------------------------------------------------------------------
-----------||||------------#--------------------------------------------------------------------------------------------------------------------------
----------%||||------------#------%------------------------------------------%----%---%%%%%------------------------%----------------------------------
----------|||||--------%%%%%------|------------------------------------------|%%%%|-%%|||||------------------------|--------------%-------------------
%%%%%%%%%%|||||%-------|||||-%%-%-|------------------------------------------||||||-|||||||------------------------|--------%----%|-------%%%%%%------
||||||||||||||||XXXXXXX|||||-||-|X|XXXXXXXXXXXXXXXXXXXXXXXXX-XXXXXXXXXXXXX--X||||||X|||||||XXXXXXXXXXXXXXXXXXXXXXXX|XXXXXXXX|XXXX||XX--XXX||||||----XX