------------------------------------------------------------------------------------------------------------------------------------------------------
------------------------------------------------------------------------------------------------------------------------------------------------------
------------------------------------------------------------------------------------------------------------------------------------------------------
------------------------------------------------------------------------------------------------------------------------------------------------------
------------------------------------------------------------------------------------------------------------------------------------------------------
------------------------------------------------------------------------------------------------------------------------------------------------------
------------------------------------------------------------------------------------------------------------------------------------------------------
------------------------------------------------------------------------------------------------------------------------------------------------------
------------------------------------------------------------------------------------------------------------------------------------------------------
---------------------------------------------------------------------------%-----------------------------------------------------------------g--------
---------------------------------------------------------------------------|-----------------------------------------------------------------%--------
---------------------------------------------------------------------------|--------------------------------------%%%------------------------|--------
--------------------------------------------%------------------------------|--------------------------------------|||---------------------%--|%%--%%--
-----------------------------------%--------|---------------------%%%%---%%|%%%%%%%%-%%%%--------%%%%%%%%%%%%%%%%-|||%%%%---%-%-%---------|--%||--||--
%%%%%%%%%----------------------%-%%|------%%|------------------%--||||%%%|||||||||||-||||-%------||||||||||||||||-|||||||%--|-|-|---------|--|||--||--
|||||||||XXXXXXXXXXXXXXXXXXXXXX|X|||XXXXXX|||XXXXXX-XXXXXX-----|XX|||||||||X||||||||X||||X|XXXXXX|||||||||||||||X-XXX|||||-X|X|X|XXXXXXXXX|--|||XX||XX