------------------------------------------------------------------------------------------------------------------------------------------------------
------------------------------------------------------------------------------------------------------------------------------------------------------
------------------------------------------------------------------------------------------------------------------------------------------------------
------------------------------------------------------------------------------------------------------------------------------------------------------
------------------------------------------------------------------------------------------------------------------------------------------------------
----------------------------%-------------------------------------------------------------------------------------------------------------------------
----------------------------|-------------------------------------------------------------------------------------------------------------------------
----------------------------|-------------------------------------------------------------------------------------------------------------------------
----------------------------|-------------------------------------------------------------------------------------------------------------------------
----------------------------|-------------------------------------------------------------------------------------------------------------------------
----------------------------|-------------------------------------------------------------------------------------------------------%-----------------
----------------------------|-------------------------------------------%-----------------------------------------------------------|-----------------
---------------------%%%----|------%------------%----------------------%|-%%%%-%%-%%-%%%%%%%%%%%-%%%--------------------%-----------|%----------------
---------------------|||----|%-----|--%%-%%-----|----------------------||-||||-||-||-|||||||||||-|||-%%-----------------|----%--%%%-||----------------
%%%%%%%%%%%%%%%%%--%-|||%---||-----|--||%||-----|-%---%%%%%------------||-||||-||-||-|||||||||||-|||-||-----------------|----|--|||%||--------%%------
|||||||||||||||||X-|X||||X--||XX-XX|XX|||||X-XXX|-|--X|||||XX-XXXXXXXXX|XX||||X||-||-|||||||||||X|||XXXX-XXXXXX-XXXXXXXX|XXXX|XX|||||XXXXXXXXX||XXXX--