------------------------------------------------------------------------------------------------------------------------------------------------------
------------------------------------------------------------------------------------------------------------------------------------------------------
------------------------------------------------------------------------------------------------------------------------------------------------------
------------------------------------------------------------------------------------------------------------------------------------------------------
---------------------------------------------------------------------%--------------------------------------------------------------------------------
---------------------------------------------------------------------|--------------------------------------------------------------------------------
---------------------------------------------------------------------|--------------------------------------------------------------------------------
---------------------------------------------------------------------|----------------------------------------------------%---------------------------
---------------------------------------------------------------------|----------------------------------------------------|---------------------------
---------------------------------------------------------------------|------------%%--------------------------------------|---------------------------
---------------------------------------------------------------------|------------||--------------------------------------|---------------------------
----------------------------------%----------------------------------|------------||--------------------------------------|---------------------------
-----------------%%%--%---------%%|----------------------------------|-----%%-%%%%%%---%--%%%--%%%%%%%%%%--------------%--|---------------%-%-%%------
----------------%|||--|-%%%-%%--|||-----------------%%%%--%%%%%-%-%-%|%%%%%||-||||||-g-|--|||--||||||||||--------------|--|----%----------|-|-||------
%%%%%%%%%%-----%||||--|%|||-||--|||-------%%--%----%||||-%|||||%|-|-|||||||||-||||||---|--|||-%||||||||||----------%%%%|%%|%%%-|--%%------|-|-||------
||||||||||XXXXX|||||--|||||X||XXXXXXXXXXXX||XX|XX--|||||X||||||||X|X|||||||||X||||||XXX|XX|||X|||||||||||XXXXXXXXXX|||||||||||X|XX||XXXXXX|X|X||XXXXXX