------------------------------------------------------------------------------------------------------------------------------------------------------
------------------------------------------------------------------------------------------------------------------------------------------------------
------------------------------------------------------------------------------------------------------------------------------------------------------
------------------------------------------------------------------------------------------------------------------------------------------------------
------------------------------------------------------------------------------------------------------------------------------------------------------
------------------------------------------------------------------------------------------------------------------------------------------------------
------------------------------------------------------------------------------------------------------------------------------------------------------
------------------------------------------------------------------------------------------------------------------------------------------------------
------------------------------------------------------------------------------------------------------------------------------------------------------
------------------------------------------------------------------------------------------------------------------------------------------------------
------------------------------------------------------------------------------------------------------------------------------------------------------
-------------------------#-------------------%%%%%%%%%-------------------------------------------------------------%----------------------------------
-------------------------%-------------------|||||||||--------------%%%%%------------------------------%%%%%%%%-%%%|---%---%------%%%%%---------------
-------------------------|-------%---%%%%%%-%|||||||||----%%%-------|||||------------------%-----------||||||||-||||---|%--|------|||||---%%--%%-----%
%%%%%%%%%%%%%%%-----%-%%%|%%%%%%-|%--||||||-||||||||||----|||-------|||||-------%--------%-|-----------||||||||-||||%--||--|------|||||%--||-%||-----|
|||||||||||||||XXXXX|X||||||||||-X|X-||||||-|XXXXXXXXXXXXX|||XXXXXXX|||||XXXXXXX|-XXXXXXX|X|XXXXXXXXXXX||||||||X|||X|--||XXXXXXXXX||||||XX||X|||XX-XX|