------------------------------------------------------------------------------------------------------------------------------------------------------
------------------------------------------------------------------------------------------------------------------------------------------------------
------------------------------------------------------------------------------------------------------------------------------------------------------
------------------------------------------------------------------------------------------------------------------------------------------------------
------------------------------------------------------------------------------------------------------------------------------------------------------
------------------------------------------------------------------------------------------------------------------------------------------------------
------------------------------------------------------------------------------------------------------------------------------------------------------
------------------------------------------------------------------------------------------------------------------------------------------------------
------------------------------------------------------------------------------------------------------------------------------------------------------
------------------------------------------------------------------------------------------------------------------------------------------------------
------------------------------------------------------------------------------------------------------------------------------------------------------
--------------------------------------%----%----------------------------------------------------------------------------------------------------------
--------------------------------------|----|------------------------------%%%-%%%%%%t%%%%--%---------------%---------------%------------%-------------
-----------------------%--------%%%%%%|----|%----%%-%%%%%-----------------|||-||||||t||||--|-------%%---%%-|%--------------|------------|-------------
%%%%%%%%%---%-------%--|--------|||||||%%%%||----||-%||||-----------------|||%||||||%||||%%|-------||--%||-||--------------|----------%%%-------------
|||||||||XXX|XXXXXXX|XXXXXX-XXXX|||||||||||||XXXX||-|||||X-XXXXXXXXXXX--XX||||||||||||||||||-------||XX|||X||XXX---XXXXXXXX|XXXXXXXX--|||XXXXXXXXXXXXX