------------------------------------------------------------------------------------------------------------------------------------------------------
------------------------------------------------------------------------------------------------------------------------------------------------------
------------------------------------------------------------------------------------------------------------------------------------------------------
------------------------------------------------------------------------------------------------------------------------------------------------------
------------------------------------------------------------------------------------------------------------------------------------------------------
----------------------------------------#-------------------------------------------------------------------------------------------------------------
----------------------------------------%-------------------------------------------------------------------------------------------------------------
----------------------------------------|-------------------------------------------------------------------------------------------------------------
----------------------------------------|--------------%------------------------------------------S---------------------------------------------------
---------------------C------------------|--------------|------------------------------------------------------------%---------------------------------
----------------------------------------|--------------|-----C------------------------------------------------------|---------------------------------
----------------------------------------|--------------|--------------------------------------------%---------------|---------------------------------
-------------%%-------------------------|-----%--------|-----%%%%%%--------------------------%%%--%%|-------------%-%-%%%%%---%-----------------%%%%--
-------------||----%-------%------------|-----|--------|-----||||||--------------------------|||--|||---%----%%---|-|%|||||---|--------%%-%-----||||-%
%%%%%%%%%----||----|--%%%%-|------------|-----|--------|-----||||||----------%%----%%-%------|||--|||---|----||---|-|||||||---|-%------||-|-----||||-|
|||||||||XXX-||XXXX|XX||||X|XXX-XXXXXXXX|XXXXX|X--XXXXX|--XXX||||||XXXXXXXXXX||XXXX||X|XXXXXX|||XX|||---|XX--||XXX|X|||||||XXX|X|XXXXX-||X|X--X-||||-|