------------------------------------------------------------------------------------------------------------------------------------------------------
------------------------------------------------------------------------------------------------------------------------------------------------------
------------------------------------------------------------------------------------------------------------------------------------------------------
------------------------------------------------------------------------------------------------------------------------------------------------------
---------------------------------------------------------------------------------------------------------D--------------------------------------------
------------------------------------------------------------------------------------------------------------------------------------------------------
------------------------------------------------------------------------------------------------------------------------------------------------------
------------------------------------------------------------------------------------------------------------------------------------------------------
------------------------------------------------------------------------------------------------------------------------------------------------------
-------------------------------------------------------------------------------g-------------------------D--------------------------------------------
------------------------------------------------------------------------------------------------------------------------------------------------------
------------------------------------------------------------------------%-------%%--------------------------------------------------------------------
-----------%%%--------%-------------------------------------------%%%---|-------||---------------------%------------%-----%%%%--%%%%%%-----%%-----%%%%
-----------|||--------|-%%%%-%%%%%%%%%-%----------------------K---|||---|------%||-%%------------------|-----%%-%%%%|-----||||-%||||||%---%||--%--||||
%%%%%%%%%%%|||%%%%%%--|-||||-|||||||||-|%------------------%%%%%%%|||%%-|------|||-||------------------|-----||-|||||-----||||-||||||||---|||--|--||||
||||||||||||||||||||X-|X||||X|||||||||-||-----XXXXXXX--XXXX||||||||||||X|-----X|||-||XXXXXXXXXXXXXXXXXX|-XXXXXXXXXXX|XXXXX||||X||||||||XXX|||X-|XX||||