------------------------------------------------------------------------------------------------------------------------------------------------------
------------------------------------------------------------------------------------------------------------------------------------------------------
------------------------------------------------------------------------------------------------------------------------------------------------------
------------------------------------------------------------------------------------------------------------------------------------------------------
--------------------------------------------------G---------------------------------------------------------------------------------------------------
------------------------------------------------------------------------------------------------------------------------------------------------------
------------------------------------------------------------------------------------------------------------------------------------------------------
------------------------------------------------------%----------------------------------------------------------------------%%-----------------------
------------------------------------------------------|----------------------------------------------------%-----------------||-----------------------
------------------------------------------------------|----------------------------------------------------|-----------------||-----------------------
------------------------------------------------------|------------------------%---------------------------|-----------------||-----------------------
------------------------------------------------------|-#----------------------|---------------------------|-----------------%|-----------------------
--------------------------------%------%--------%--%%%|-%----------------------|-----------%%%-%%---------%|--------%-------%||-----------------------
----------------------------%%%%|%%%%%%|--%%%---|--||||-|%-----%%%%%%%-----%%%%|-----------|||-||--------%||--------|-------|||-----------------------
%%%%%%%%%%%%%---%%----------||||||||||||-%|||---|--||||-||--%--|||||||-----|||||%%%%-------|||-||---%----|||------%%|-------|||-------%%%-------------
|||||||||||||XXX||XXXXXXXX--||||||||||||-||||X-X|--||||X||XX|X-|||||||-----|||||||||XX--XXX|||X||XXX|XXXX|||XX--X-|||---XXXX|||XXXXXXX|||XXXXXXXXXXXXX