------------------------------------------------------------------------------------------------------------------------------------------------------
------------------------------------------------------------------------------------------------------------------------------------------------------
------------------------------------------------------------------------------------------------------------------------------------------------------
------------------------------------------------------------------------------------------------------------------------------------------------------
------------------------------------------------------------------------------------------------------------------------------------------------------
------------------------------------------------------------------------------------------------------------------------------------------------------
------------------------------------------------------------------------------------------------------------------------------------------------------
------------------------------------------------------------------------------------------------------------------------------------------------------
------------------------------------------------------------------------------------------------------------------------------------------------------
---------------------------------------g----------------------------------------------------------------------------------------------------%---------
--------------------------------------------------------------------------------------------------------------------------------------------|---------
----------------------------------------------------g------------------------------------------------------2S---------------t-----%%--------|---------
-------------%%-%------------------%---------%%%--%---%-%%%------------------------------%----------------------------------t-----||--------|---------
-------------||-|-------------%-F%-|---------|||--|---|-|||-------------------------%%%%-|%%%%%%%%%--------------%-------%--%-----||%%%%%%%%|%%-%%-%%%
%%%%%%%%-%%-%||-|-------------|-%|-|---------|||--|---|%|||-------------------------||||-||||||||||-----------%%-|------%|-%|%%%%%|||||||||||||-||-|||
||||||||-||-|||X|XXXXXX-XXXXXX|X||X|XXX-XXXXX|||XX|-XX|||||XX-XXXXXXXXXXXXXXX-XXXXX-||||X||||||||||XXXXXXXXXXX||X|XX----||X||||||||||||||||||||X||X|||