------------------------------------------------------------------------------------------------------------------------------------------------------
------------------------------------------------------------------------------------------------------------------------------------------------------
------------------------------------------------------------------------------------------------------------------------------------------------------
------------------------------------------------------------------------------------------------------------------------------------------------------
------------------------------------------------------------------------------------------------------------------------------------------------------
------------------------------------------------------------------------------------------------------------------------------------------------------
------------------------------------------------------------------------------------------------------------------------------------------------------
------------------------------------------------------------------------------------------------------------------------------------------------------
------------------------------------------------------------------------------------------------------------------------------------------------------
------------------------------------------------------------------------------------------------------------------------------------------------------
----------------------------------------------------------------------------------------------------------------------------%%----------%-------------
-------------------------------------------------S-----------------%--------------------------------------------------------||----------|-------------
--------------------%%------------------------------%-----------%--|---------------------%-%---%%%%--%------------%------%--||------%%--|%%-%%%-------
-----------%--------||-----------%%%--%%-%%%%%%%----|-----------%--|---%-----%%%%%%%-----|-|---||||--|------%-----|%-----|--||------||--|||-|||-------
%%%%%%%%%%-|--------||--%%%--%%%%|||%%||-|||||||----|----%------|%-%%%%|---%-|||||||-----|-|--%||||%-|------|-----||%%%%%|--||%%%%%%||%%|||-|||-------
||||||||||X|XXXXXXXXXXXX|||XX|||||||||||X|||||||XXXX|XXX-|XXXXXXX|X|||||XXX|X|||||||XXXX-|X|XX||||||X|-XXXX-|XXXXX||||||||XX|||||||||||||||-|||XXXXXXX