------------------------------------------------------------------------------------------------------------------------------------------------------
------------------------------------------------------------------------------------------------------------------------------------------------------
------------------------------------------------------------------------------------------------------------------------------------------------------
------------------------------------------------------------------------------------------------------------------------------------------------------
------------------------------------------------------------------------------------------------------------------------------------------------------
------------------------------------------------------------------------------------------------------------------------------------------------------
------------------------------------------------------------------------------------------------------------------------------------------------------
-------------%----------------------------------------------------------------------------------------------------------------------------------------
-------------|----------------------------------------------------------------------------------------------------------------------------------------
-------------|----------------------------------------------------------------------------------------------------------------------------------------
-------------|------------------------------------------------------K--------------------------------------%------------------------------------------
------------%|----------------------------------------------------%%%----%---------------------------------|--%---------------------------------------
------------||---%%%%%%-%----%-%%%%%-%%--------------%%%%%%%%%%%%%|||%---|--------------%---------------%%-%--|%%--------%%------------%%%%---%-------
------------||---||||||-|----|-|||||-||----%---------|||||||||||||||||--%|-%%--%%%%--%%%|--------%%%%%%%||%|%-|||------%-||%%%%%-------||||---|-------
%%%%%%%%%%%%||%%%||||||-|----|%|||||-||----|---------|||||||||||||||||--||%||--||||--||||----%%--||||||||||||-|||------|-|||||||-------||||---|-%%----
|||||||||||||||||||||||-|----|||||||-||XXX-|XXXXXXXX-|||||||||||||XXX|--|X|||-X||||XX|||XXXXX||XX||||||||||||X|XXXXXXXX|X|||||||X-XXXXX||||---XX||XXXX