------------------------------------------------------------------------------------------------------------------------------------------------------
------------------------------------------------------------------------------------------------------------------------------------------------------
------------------------------------------------------------------------------------------------------------------------------------------------------
------------------------------------------------------------------------------------------------------------------------------------------------------
------------------------------------------------------------------------------------------------------------------------------------------------------
------------------------------------------------------------------------------------------------------------------------------------------------------
------------------------------------------------------------------------------------------------------------------------------------------------------
---------------------------------2--------------------------------------------------------------------------------------------------------------------
------------------------------------------------------------------------------------------------------------------------------------------------------
------------------------------------------------------------------------------------------------------------------------------------------------------
----------------------------------------------%----------------%%--------------------%-----------%--------%--%------------------------------------%---
---------------------------------%------------|%%--------------||--------------------|-----------|--------|--|----------------------%-------------|---
--------%--%--------------------%|--%%%-%%%%--|||--------------||%%-%%---------------|-----------|--------|--|--------------------%%|%-------%%---|---
--------|--|%------------%------||--|||-||||%%|||%%-%-----%%%%-||||%||-%%%-----------|----%%%---%|---%%%%-|--|--------------------||||%------||-%%|---
%%%%%%%%|--||%-----------|------||--|||-|||||||||||-|----%||||-|||||||-|||--%%%---%--|-%--|||---||---||||-|--|%---------%---------|||||------||-|||---
|||||||||XXX||XXXXXXXXXXX|XXXXXX|XXX|||-|||||||||||X|XX-X|||||X|||||||-|||XX|||XXX|XX|X|XX|||XXX||-XXXXXXX|X-||XXXXXXXX-|-------XXXX|X|XXXXXX||X|||X--