------------------------------------------------------------------------------------------------------------------------------------------------------
------------------------------------------------------------------------------------------------------------------------------------------------------
------------------------------------------------------------------------------------------------------------------------------------------------------
------------------------------------------------------------------------------------------------------------------------------------------------------
------------------------------------------------------------------------------------------------------------------------------------------------------
------------------------------------------------------------------------------------------------------------------------------------------------------
------------------------------------------------------------------------------------------------------------------------------------------------------
------------------------------------------------------------------------------------------------------------------------------------------------------
------------------------------------------------------------------------------------------------------------------------------------------------------
--------------------------%%---------------------------------------%----------------------------------------------------------------------------------
--------------------------||--%%---------------------------------%-|----------------------------------------------------------------------------------
-----------------------%-%||--||---------------------------------|-|---------------------%%-----------------------------------------------------------
-----------------------|-|||-%||-----------------------%------%%-|%|-------%-#-%%-%------||%%%%%------------------------------------------------------
--------------%%%%%%---|-|||-|||-----------------------|------||-|||-%%%---|-%-||-|------|||||||--%%----%----%-----------------------%-----%%-%-------
%%%%%%%%%%%%%%||||||---|-|||-|||%%-%%%--%------%%---%--|------||-|||-|||--%|-|-||%|---%%%|||||||%%||----|----|--------------------%--|-----||-|------%
||||||||||||||||||||XXX|X|||-|||||-|||XX|XXXXXX||XXX|XX|XXXXXX||X|||-||XX-||-|-||||XXX|||XX|||||||||-XXX|-XXX|XXXXXXXXX--XXXXXXXXX|X-|XXX--||X|XXXXXX|