------------------------------------------------------------------------------------------------------------------------------------------------------
------------------------------------------------------------------------------------------------------------------------------------------------------
------------------------------------------------------------------------------------------------------------------------------------------------------
------------------------------------------------------------------------------------------------------------------------------------------------------
------------------------------------------------------------------------------------------------------------------------------------------------------
-------------------------------------------------------------------------------------------------%----------------------------------------------------
-------------------------------------------------------------------------------------------------|----------------------------------------------------
-------------------------------------------------------------------------------------------------|----------------------------------------------------
---------------------------------------------------------------------------------------------t---|----------------------------------------------------
---------------------------------------------------------------------------------------------t---|----%-----------------------------------------------
--------------%------------------------------------------%%----------------------------------t---|----|-----------------------------------------------
-------------%|------------------------------------------||----------------------------------%---|----|--------------------%------------%-------------
---------%%--||--------------%%--------------------------||-------------------------%-%%---%%|%%%|----|----------%%-%%%%---|%%----------|-------%-----
---------||--||---------%%%%-||%%%%%%%-%%%-%%-%%%%%%%---%||-------------------------|-||---|||||||--%-|----------||-||||---|||----------|-------|-----
%%%%%%%%%||--||--%------||||-|||||||||-|||%||-|||||||---|||--------------------%--%-|-||---|||||||-%|%|-%%%%%%%%%||%||||---|||---%------|------%|-----
|||||||||||XXX|XX|XXXXXX||||-|||||||||-||||||X|||||||XXX|||XXXXXXXXXXXXXXXXXXXX|XX|X|X||XXX|||||||X||||-||||||||||||||||XXXX||XXX|XXXXXX|X---XX||XXXXX