------------------------------------------------------------------------------------------------------------------------------------------------------
------------------------------------------------------------------------------------------------------------------------------------------------------
------------------------------------------------------------------------------------------------------------------------------------------------------
------------------------------------------------------------------------------------------------------------------------------------------------------
------------------------------------------------------------------------------------------------------------------------------------------------------
------------------------------------------------------------------------------------------------------------------------------------------------------
------------------------------------------------------------------------------------------------------------------------------------------------------
----------D-------------------------------------------------------------------------------------------------------------------------------------------
-----------------------------------------------------------------------------------------------------%------------------------------------------------
-----------------------------------------------------------------%-----------------------------------|------------------------------------------------
-----------------------------------------------------------------|-----------------------------------|---------------------------------------------%%-
-----------------------------------------------------------------|---%%------------------------------|--------------------------------%%-%---------||-
--------------%----------------------%----%----------------------|---||------------------------------|------------%%%%%%%%%%%--------%||-|---------||-
----------%%--|---%%%%%---------%---%|%%%-|%%%--%----------------|---||-----------------%%%%%%%%%----|------------|||||||||||%%%-----|||-|---------||-
%%%%%%%%%%||--|---|||||%%-%%%%%%|---|||||%||||%%|%%%%%%%%--------|---%|------%%%%%-----%|||||||||---%|%-----------||||||||||||||-----|||-|%--------||-
||||||||||||XX|X-X|||||||X|||||||---|||||||||||||||||||||XXXXXXXX|XXX|XXXXXXX|||||-----||||||||||---|||XX-XXXXXXXX||||||||||||||XXXX-|XXXX|XX--XXXX||X