------------------------------------------------------------------------------------------------------------------------------------------------------
------------------------------------------------------------------------------------------------------------------------------------------------------
------------------------------------------------------------------------------------------------------------------------------------------------------
------------------------------------------------------------------------------------------------------------------------------------------------------
------------------------------------------------------------------------------------------------------------------------------------------------------
------------------------------------------------------------------------------------------------------------------------------------------------------
------------------------------------------------------------------------------------------------------------------------------------------------------
------------------------------------------------------------------------------------------------------------------------------------------------------
------------------------------------------------------------------------------------------------------------------------------------------------------
---------------------------------------------------------------------------------------------------------------------------------------U--------------
------------------------------------------------------------------------------------------------------------------------------------------------------
--------------------------------%%----------------------------------------%---------------------------------------------------------------------------
---------------------------%%---||-%%-----%%%%%%---%-----------%%%%%------|-------------%%----------------------------%%--%---------------------%-----
---------------%%----------||-%-||-||-----||||||---|-----------|||||------|-------------||---------------------------%||--|-%%%%%%%%%%%%%%%-%---|-----
%%%%%%%%%%%%%%%||%%%%%%%%%%||-|%||-||-----||||||---|-----------|||||------|-------------||%%%%%%%--%-%-------------%-|||%-|-|||||||||||||||-|---|%----
|||||||||||||||||||||||||||||X||XXX||XX---||||||XXX|XX-XX-XXX--|||||XX-XXX|XXXXXXXXXXXXX|||||||||XX|-|XXXXXXXXXXXXX|X|XX|X|X|||||||||||||||X|---||XXXX