------------------------------------------------------------------------------------------------------------------------------------------------------
------------------------------------------------------------------------------------------------------------------------------------------------------
------------------------------------------------------------------------------------------------------------------------------------------------------
------------------------------------------------------------------------------------------------------------------------------------------------------
------------------------------------------------------------------------------------------------------------------------------------------------------
------------------------------------------------------------------------------------------------------------------------------------------------------
------------------------------------------------------------------------------------------------------------------------------------------------------
------------------------------------------------------------------------------------------------------------------------------------------------------
------------------------------------------------------------------------------------------------------------------------------------------------------
------------------------------------------------------------------------------------------------------------------------------------------------------
------------------------------------------------------------------%%---%%--%--------------------------------------------------------------------------
------------------------------------------------------------------||---||--|--------------------------------------------------------------------------
--------------------------------------------------%---------%%---%||-%%||--|----------------------------------------------------------%--%------------
---------------%%%-%%%%---%---%%-%-%%%%%-%%-------|---------||---|||-||||--|---------%%%%%%%---%---%%--%--%%%-------------------------|--|------------
%%%%%%%%%%%%%%%|||-||||---|%%%||%|-|||||-||-------|---------||--%|||-||||--|%%-------|||||||%--|%--||--|--|||%--%%%%------------------|--|------------
||||||||||||||||||-||||XXX||||||||-|||||X||XXXXXXX|XXXXXXXXX||XX||||-||||XX|||XXXXXXX||||||||-X||XX||--|XX||||-X||||X--XXXXXXXXXXXXXXX|XX|X-XXXXXXXXXX