------------------------------------------------------------------------------------------------------------------------------------------------------
------------------------------------------------------------------------------------------------------------------------------------------------------
------------------------------------------------------------------------------------------------------------------------------------------------------
------------------------------------------------------------------------------------------------------------------------------------------------------
------------------------------------------------------------------------------------------------------------------------------------------------------
------------------------------------------------------------------------------------------------------------------------------------------------------
------------------------------%-----------------------------------------------------------------------------------------------------------------------
------------------------------|---------------------%-------------------------------------------------------------------------------------------------
------------------------------|---------------------|-------------------------------------------------------------------------------------------------
------------------------------|---------------------|-----------------------------%------U------------------------------------------------------------
------------------------------|-------%-------------|-----------------------------|----------------------------------------S--------------------------
------------------%-----------|%%%%%%%|-------------|-----------------------------|----D---------------%%---------------------------------------------
------------------|-----------|||||||||----------%--|--------------%-------------%|-%%--%-%%%%--%%%---%||----%%-%%---%%-%-----------------------------
------------------|-----------%||||||||----------|--|--------------|-----------%%|%%||--|%||||--|||%%%|||--%%||-||---||-|--%--%%------------------%%%-
%%%%%%%%--%%%%%-%%|-%---%-----|||||||||----------|--|--------------|---------%%|||||||--||||||--|||||||||--||||-||---||-|--|--||------------------|||-
||||||||XX|||||X||XX|XXX|XXXXX|XXXXXXX|-XXXXXXXXXXXX|--XXXXXXXXXXXX|XXXXX-XXX|||||||||X-||||||--|||||||XXXX||||X||XX-||X|XX|X-||XXXXXXXXXXXXXXXXXX|||X