------------------------------------------------------------------------------------------------------------------------------------------------------
------------------------------------------------------------------------------------------------------------------------------------------------------
------------------------------------------------------------------------------------------------------------------------------------------------------
------------------------------------------------------------------------------------------------------------------------------------------------------
------------------------------------------------------------------------------------------------------------------------------------------------------
------------------------------------------------------------------------------------------------------------------------------------------------------
------------------------------------------------------------------------------------------------------------------------------------------------------
------------------------------------------------------------------------------------------------------------------------------------------------------
------------------------------------------------------------------------------------------------------------------------------------------------------
-----------------------------------------------------------------------------------------------------------------------------------------------------S
------------------------------------------------------------------------------------------------------------------------------------------------------
--------------------------------------------------------------%---------------------------------------------------------------------------------------
--------------------------%%%----%%---------------------------|---%%%--%------------------------------%%-%%-------------------------------------------
--------%-------------%%%%|||----||---------------%%--F%------|---|||--|---%%----%--------------------||-||--%-------%-------%----------------------%%
%%%%%%%%|%%%%---%%%%%%|||||||----||---------%%----||%%%|----%%|%%%|||--|%--||----|------%%%-%---------||-||--|-------|-------|%----------%%-%%%%-%%%||
|||||||||||||---|||||||||||||XXXX||XXXXXXXX-||XXXX||||||XXX-|||||||||--||--||XXXX|XXXXXX|||X|XXXXXXX-X||-||XX|XXX-XXX|XXXXXXXX|XXXXXXXXXX||X||||-|||||