------------------------------------------------------------------------------------------------------------------------------------------------------
------------------------------------------------------------------------------------------------------------------------------------------------------
------------------------------------------------------------------------------------------------------------------------------------------------------
------------------------------------------------------------------------------------------------------------------------------------------------------
------------------------------------------------------------------------------------------------------------------------------------------------------
------------------------------------------------------------------------------------------------------------------------------------------------------
------------------------------------------------------------------------------------------------------------------------------------------------------
------------------------------------------------------------------------------------------------------------------------------------------------------
------------------------------------------------------------------------------------------------------------------------------------------------------
------------------------------------------------------------------------------------------------------------------------------------------------------
-----------------------------------------------------------------------------------%----------------------------------------%-------------------------
-------------------------------------------------------------------------------%---|----------------------------------------|-------------------------
------------------------%--%-----%%%%------%---%%--%%-%------------------------|---|-----------%----------------------------|----%%%%%%%%----%--------
------------------------|--|-----||||-%----|---||--||-|%-----------------------|---|-----------|%---------------%%%--%%%%%--|----||||||||----|%%------
%%%%%%%%%--%--------%%--|--|-----||||-|----|---||--||-||-------------%%%%%%%--%%---|--------%%-||--%------------|||--|||||--|----||||||||----|||------
|||||||||XX|XXX--XXX||XX|X-|XXXXX||||X|XXXXXXXX||XX||-||XXXXXXXXXXXXX|||||||X-||XXX|X----XXX||X||XX|XXXXXXXX-XXXXXX-XXXXXXXX|XXXX||||||||----|||XXXXXX