------------------------------------------------------------------------------------------------------------------------------------------------------
------------------------------------------------------------------------------------------------------------------------------------------------------
------------------------------------------------------------------------------------------------------------------------------------------------------
-----------------#------------------------------------------------------------------------------------------------------------------------------------
-----------------#------------------------------------------------------------------------------------------------------------------------------------
-----------------#------------------------------------------------------------------------------------------------------------------------------------
-----------------%------------------------------------------------------------------------------------------------------------------------------------
-----------------|------------------------------------------------------------------------------------------------------------------------------------
-----------------|----------------------------------------------------------------------------------------------------------------------------%-------
-----------------|----------------------------------------------------------------------------------------------------------------------------|-------
-----------------|--------------------------------------------------------------%-------------------------------------------------------------|-%-----
-----------------|--------------------------------------------------#-----------|----------%--------------------------------------S-----------|-|-----
-----------------|------%%------------------------%--%----%%%%------%-----------|----------|-------------------%---------------------------%%%|-k-----
-----------------%------||-----------%----------%%|-%|-%--||||------|--------%-%|%---------|----------%%%--%---|---------------------------||||%|---%%
%%%%%%%%---------|---%%%||%%%%%%%%---|----------|||-||-|--||||-----%|--%%%%--|-|||---------|----------|||--|---|-%%%-----------%-----------||||||-%-||
||||||||XXXXXXXXX|XXX|||||||||||||XXX|XXXXXXXXXX|||X||X|X-||||XXXXX||XX||||XX|X|||XXXXXXXXXXXXXXXXXXXX|||XX|XXX|X|||XX-XXXXXXXX|XXXXXXXXXXXXX||||X|X||