------------------------------------------------------------------------------------------------------------------------------------------------------
------------------------------------------------------------------------------------------------------------------------------------------------------
------------------------------------------------------------------------------------------------------------------------------------------------------
------------------------------------------------------------------------------------------------------------------------------------------------------
------------------------------------------------------------------------------------------------------------------------------------------------------
------------------------------------------------------------------------------------------------------------------------------------------------------
------------------------------------------------------------------------------%-----------------------------------------------------------------------
----------------------------------------------%-------------------------------|-----------------------------------------------------D-----------------
----------------------------------------------|-------------------------------|-----------------------------------------------------------------------
----------------------------------------------|-------------------------------|-----------------------------------------------------------------------
----------------------------------------------|------------------------------T|---%-------------------------------%------------------%--%%%-----------
----------------------------------------------|------------------------------t|---|-------------------------------|------------------|--|||-----------
-------------------------------%-%%%%---%%--%%|----------------------------%-t|---|-------------------------------|-------%%%%--%%%%-|--|||-----------
---------------%%%%%-----------|-||||---||%%|||-----%---%--%%%%%-%%%%%%%%%%|%%|---|%%%--%%%%%%%%-%%%%%----------%%|%%%-%%%||||--||||-|--|||%%---------
%%%%%%%%%%%%%-%|||||-----------|%||||--%|||||||--%-%|---|--|||||-||||||||||||||---||||--||||||||-|||||%%%%%%%%%%||||||-|||||||--||||-|--|||||%--%-%%--
|||||||||||||X||||||XXXXXXXXXXX||||||--||||||||XX|X||X--|XX|||||-||||||||||X|||XXX||||XX||||||||X|||||||||||||||||||||-|||||||--||||-|XX||||||XX|-||XX