------------------------------------------------------------------------------------------------------------------------------------------------------
------------------------------------------------------------------------------------------------------------------------------------------------------
------------------------------------------------------------------------------------------------------------------------------------------------------
------------------------------------------------------------------------------------------------------------------------------------------------------
------------------------------------------------------------------------------------------------------------------------------------------------------
------------------------------------------------------------------------------------------------------------------------------------------------------
----------------------------D-------------------------------------------------------------------------------------------------------------------------
------------------------------------------------------------------------------------------------------------------------------------------------------
------------------------------------------------------------------------------------------------------------------------------------------------------
---------------------------%t-------------------------------------------------------------------------------------------------------------------------
---------------------------|T------------------------%------------------------------------------------------------------------------------------------
---------------------------|t------------------------|------------------%----------------------------------------------------------%%-----------------
--------------------%------|%-----------%-%%%----%%%%|-----------------%|----%-------------------%%%%-%----------------%%%-------%-||-%---------------
---------%----------|%-%%%-||%%-%%------|-|||----|||||----------%%%%%%-||----|------%------------||||-|----------------|||-------|%||-|%%%%%%%-%%--%%%
%%%%%%%%%|--%-------||-|||-||||%||------|-|||----|||||-%-%%%%%%%||||||%||----|------|------------||||-|-------%%%------|||%------||||-||||||||-||--|||
||||||||||XX|-XXXXXX||X|||X|||||||XXXXXX|-|||---X|||||X|X|||||||||||||||X----|XXXXXX|XXXXXXXXXXXX||||X|XXXXXXX|||XXXXXX||||XX-XXX||XXX||||||||-||X-|||