------------------------------------------------------------------------------------------------------------------------------------------------------
------------------------------------------------------------------------------------------------------------------------------------------------------
------------------------------------------------------------------------------------------------------------------------------------------------------
------------------------------------------------------------------------------------------------------------------------------------------------------
------------------------------------------------------------------------------------------------------------------------------------------------------
----------------------------------------------------%-------------------------------------------------------------------------------------------------
----------------------------------------------------|-------------------------------------------------------------------------------------------------
----------------------------------------------------|-------------------------------------------------------------------------------------------------
----------------------------------------------------|-------------------------------------------------------------------------------------------------
----------------------------------------------------|-------------------------------------------------------------------------------------------------
---------------------------------%------------------|----------%--------------------------------------------------------------------------------------
---------------------------------|------------------|----------|--------------------------------------------------------------------------------------
---------------------------------|------------------|----------|-------------------%-----------------------%---------------------------------------%--
---------------------%%-%%-------|------------------|----------|-------------------|-------%%-%------------|-------------------------------%%------|--
%%%%%%%%---%%%%------||-||%%%%%%-|------------------|--%%%----%|-----------------%%|-%%%%%%||-|-%%---------|-------------------------------||------|%%
||||||||---||||XXXX-X||X||||||||X|XXXXXXXXXXXXXXXXXX|XX|||-XXX||XXXXXXXXXX-XXXXXX|||-||||||||X|-||--XXXXXXX|XXXXXXXXXXXXXXXXXXXXXXXXXXXXXXXXXXXXXXX|||