------------------------------------------------------------------------------------------------------------------------------------------------------
------------------------------------------------------------------------------------------------------------------------------------------------------
------------------------------------------------------------------------------------------------------------------------------------------------------
------------------------------------------------------------------------------------------------------------------------------------------------------
------------------------------------------------------------------------------------------------------------------------------------------------------
------------------------------------------------------------------------------------------------------------------------------------------------------
------------------------------------------------------------------------------------------------------------------------------------------------------
------------------------------------------------------------------------------------------------------------------------------------------------------
------------------------------------------------------------------------------------------------------------------------------------------------------
------------------------------------------------------------------------------------------------------------------------------------------------------
------------------------------------------------------------------------------------------------------------------------------------------------------
-----------------#-------------------------------------------------------------------------------------------------------%----------------------------
-----------------%--%%%%--%--%-----------------------------------------------%%%--------------------%%%---%-%%%%%%-------|----------------------------
----------%%%%---|-%||||--|--|-----------%%-----------%%---------------------|||--------------------|||---|-||||||-------|-----------%----------------
%%%%%%%%%%||||-%-|-|||||%%|%%|%%----%-%%-||----%%-%%%%||%-----%%%%%---------%|||--%%%%%%%%%%%-----%%|||-%-|-||||||-------|--------%%%|%%%%-%%%--------
||||||||||||||X|-|-||X||||||||||----|X||-||XXXX||X|||||||XXXXX|||||---XXXXXX||||XX|||||||||||XXXXX|||||-|X|X||||||XXXXXXXXX-XXXX--||||||||X|||XXXXXXXX