------------------------------------------------------------------------------------------------------------------------------------------------------
------------------------------------------------------------------------------------------------------------------------------------------------------
------------------------------------------------------------------------------------------------------------------------------------------------------
------------------------------------------------------------------------------------------------------------------------------------------------------
------------------------------------------------------------------------------------------------------------------------------------------------------
------------------------------------------------------------------------------------------------------------------------------------------------------
------------------------------------------------------------------------------------------------------------------------------------------------------
-----------------------------------------------------------------------------------------------------------%------------------------------------------
-----------------------------------------------------------------------------------------------------------|------------------------------------------
-----------------------------------------------------------------------------------------------------------|------------------------------------------
-----------------------------------------------------------------------------------------------------------|------------------------------------------
-------------------%---------------------------------------------------------------------------------------|------------------------------------------
-------------------|-------%-----%------%----------------------%%-------------------%--------------------%-|-----------%%%----%-----------------------
--------------%%%%-|%%%%---|%%---|%%%%%%|%%%%%---%%%%----------||%------------------|------%--%%%%%%%%%%-|%|-----------|||----|------%%%-%%-%------%%%
%%%%%%%%--%%%%||||-|||||---|||---|||||||||||||---||||----------|||---------%%-------|-----%|%%||||||||||%|||%%%%%%---%%|||%%%%|--%%--|||-||-|%%%%--|||
||||||||--||||||||XX||||XXX|||X--|||||||||||||XXX||||XXXXXXXXXX|||XX--XXXXX||XXXXXXX|XXXXX||||||||||||||||||||||||---||||||||||X-||-X|||-||-|||||-X|||