------------------------------------------------------------------------------------------------------------------------------------------------------
------------------------------------------------------------------------------------------------------------------------------------------------------
------------------------------------------------------------------------------------------------------------------------------------------------------
------------------------------------------------------------------------------------------------------------------------------------------------------
------------------------------------------------------------------------------------------------------------------------------------------------------
----------------------------------------------------------------------------------------------------------------%-------------------------------------
----------------------------------------------------------------------------------------------------------------|-------------------------------------
----------------------------------------------------------------------------------------------------------------|-------------------------------------
----------------------------------------------------------------------------------------------------------------|-------------------------------------
----------------------------------------------------------------------------------------------------------------|-------------------%-----------------
----------%-----------------------------------------------------------------------------------------------------|-------------------k------g----------
----------|-------------------------------%------------g-----------------------%--------------------------------|--------%---%---%-%|-----------------
----------|%%%%---K-----------------------|---%%------%------------------------|-------%------------------------|-%--%---|---|---|-||----------%%%%%--
----------|||||-%%%%%%%%%%%%%%%%%%%%----%-|%--||%-----|--------2---------------|-%%%-%%|---------------%%%%%%%--|-|--|---|---|#--|-||--------%%|||||--
%%%%%%%%%-|||||-||||||||||||||||||||-%%%|-||--|||-----|----------%%------------|-|||%|||%%%%%%---%%%%%%|||||||--|-|--|%--|---|%%%|-|%%%-%%%%%|||||||%%
|||||||||X|||||X||||||||||||||||||||-||||X||XX|||XXXXX|-XXXXXXXXX||XXXXXXXXXXXXX-|||||||||||||---|||||||||||||XX|X|--||XX|---|||||-||||-||||||||||||||