------------------------------------------------------------------------------------------------------------------------------------------------------
------------------------------------------------------------------------------------------------------------------------------------------------------
------------------------------------------------------------------------------------------------------------------------------------------------------
------------------------------------------------------------------------------------------------------------------------------------------------------
------------------------------------------------------------------------------------------------------------------------------------------------------
------------------------------------------------------------------------------------------------------------------------------------------------------
------------------------------------------------------------------------------------------------------------------------------------------------------
------------------------------------------------------------------------------------------------------------------------------------------------------
------------------------------------------------------------------------------------------------------------------------------------------------------
------------------------------------------------------------------------------------------------------------------------------------------------------
---------------------------------------------------------------------------------------------------------------%--------------------------------------
-------------------------------------------------------------------------------------------------%-------------|---------------------------g----------
---------t---%----%%%%%%%%--%%%-------%------------------------------%%%-%-%%--------------%-----|%%---%%%%%%--|----------------------------%%--------
---------t---|----||||||||--|||---%%%-|%---%%%%---------%------------|||-|-||%%%--%--%%%%%%|-%%%-|||%%-||||||%#|-%%------%%%%%%%%%%%%%%%----||-------%
%%%%%%%%%%---|----||||||||--|||---|||-||%%%||||%--------|------------|||-|-|||||-%|--|||||||-|||-|||||-|||||||#|-||------|||||||||||||||-%%-||%%-%%-%|
||||||||||---|XXXX||||||||XX|||XXX|||X||||||||||XXXXXXXX|XXXXXXXXXX-X|||X|X|||||X||XX|||||||-|||-|||||-|||||||X|-||XXXXXX|||||||||||||||-||X||||X||-||