------------------------------------------------------------------------------------------------------------------------------------------------------
------------------------------------------------------------------------------------------------------------------------------------------------------
------------------------------------------------------------------------------------------------------------------------------------------------------
------------------------------------------------------------------------------------------------------------------------------------------------------
-----------------------------------------------------------------------%------------------------------------------------------------------------------
-----------------------------------------------------------------------|------------------------------------------------------------------------------
-----------------------------------------------------------------------|-----------------------------------------------%------------------------------
-----------------------------------------------------------------------|-----------------------------------------------|------------------------------
-----------------------------------------------------------------------|-----------------------------------------------|------------------------------
-----------------------------------------------------------------------|-----------------------------------------------|-------------------%----------
---------------------%-------------------------------------------------|----------%%----%------------------------------|-------------------|----------
------------------S--|-------------------------------------%-----------|----------||----|-------------------SC---------|-------------------|----------
---------%%----------|---------%----%----------------------|-----------|-----%%-%%||%---|-------%%--------------------%|------%---------%%-|----------
---------||--------%-|%--------|----|-------%----%%%%%%-%%%|%----------|%----||-|||||-%%|-------||------------%-------||--%---|-----%%--||-|----------
%%%%%%%%%||--------|-||--------|----|-------|---%||||||-|||||----------||--%%||-|||||%|||-------||------------|-------||--|%%%|%%%%%||%%||%|----------
|||||||||||XXXXXXXX|-||----XXXX|XXXXXXXXXXXX|XXX|||||||X|||X|XXXXXXXXXX||--||||-|||||||||X---XX-||XXXXXXXXX-XX|XXXXXXX||XX||||||||||||||||||XXXXXX-XXX