------------------------------------------------------------------------------------------------------------------------------------------------------
------------------------------------------------------------------------------------------------------------------------------------------------------
------------------------------------------------------------------------------------------------------------------------------------------------------
------------------------------------------------------------------------------------------------------------------------------------------------------
------------------------------------------------------------------------------------------------------------------------------------------------------
------------------------------------------------------------------------------------------------------------------------------------------------------
-------------------------------------------------------------------------------------------------------------------------------------------------%----
----------------------------------------------------------------------------------------------------%--------------------------------------------|----
----------------------------------------------------------------------------------------------------|--------------------------------------------|----
----------------------------------------------------------------------------------------------------|--------------------------------------------|----
----------------------------------------------------------------------------------------------------|--------------------------------------------|--%%
-------------------------------------------%--------------------------------------------------------|--------------------------------------------|--||
-------------------------%%%%--------------|------------------%%-----%---%%-%-----------------------|--------------r----------------%--------%---|--||
------------------%--%---||||--------------%%---------%%---%--||-----|---||-|%%%--------------------|--------%---%%%----------------|--------|---%--||
%%%%%%%%%---------|%-|---||||----------%---||---------||---|--||-%-%-|%%%||%||||%--%%---------------|--------|---|||-----%--%-%%----|--------|---|--||
|||||||||XXXXXXXXX||X|X--XXXXXXXXX-XXXX|XXX||XXXXXXXXX||XXX|XX||-|X|X||||||||||||--||-XXXXXXXXXXXXXX|XXXXXXXX|-X-|||XXXXX|XX|X||XXXX|XXXXXXXXXXXX|XX||