------------------------------------------------------------------------------------------------------------------------------------------------------
------------------------------------------------------------------------------------------------------------------------------------------------------
------------------------------------------------------------------------------------------------------------------------------------------------------
------------------------------------------------------------------------------------------------------------------------------------------------------
------------------------------------------------------------------------------------------------------------------------------------------------------
------------------------------------------------------------------------------------------------------------------------------------------------------
-------------------------------------------------------------%----------------------------------------------------------------------------------------
-------------------------------------------------------------|----------------------------------------------------------------------------------------
-------------------------------------------------------------|----------------------------------------------------------------------------------------
-------------------------------------------------------------|----------------------------------------------------------------------------------------
-------------------------------------------%-----------------%------------------------------------------------------------------------------------%---
------------------------------------------S|-----------------|------------------------%-----------------------------------------------------------|---
-----------------------------------------%-%---%%%%-------g--|---%%---%---------------|-%---------------------------------%------------%----------|%--
------------------%-%----%-------%-------|-|---||||%%%%-%-%%-|---||---|-------%-%-----|-|---------%-------------%%%%------|----%-%---%-|-%%%%%%%%-||--
%%%%%%%%%%--------|-|%%%-|----%%%|%%%-%%-|-|---||||||||%|%||-|---||---|-----%%|-|%%%--%%|------%%%|------%%%%%--||||------|----|-|---|%|%||||||||%||--
||||||||||XXXXXXXX|X||||-|XX--|||||||X||X|X|XXX|||||||||||||-|XXXXXXXX|XXXXX|||-||||XX||XXXXXXX||||XX-XXX|||||XX||||-XXXXX|XXXF|X|XXX||||||||||||||X--