------------------------------------------------------------------------------------------------------------------------------------------------------
------------------------------------------------------------------------------------------------------------------------------------------------------
------------------------------------------------------------------------------------------------------------------------------------------------------
------------------------------------------------------------------------------------------------------------------------------------------------------
------------------------------------------------------------------------------------------------------------------------------------------------------
---------------------------------%--------------------------------------------------------------------------------------------------------------------
--------------S------------------|--------------------------------------------------------------------------------------------------------------------
---------------------------------k--------------------------------------------------------------------------------------------------------------------
---------------------------------|--------------------------------------------------------------------------------------------------------------------
---------------------------------|--------------------------------------------------------------------------------------------------------------------
----------%---%------------------|--------------------------------------------------------------------------------------------------------------------
----------|---|------------------|----------------------------------------------------------------------------------%%--------------------------------
--------%%|---|---------------%%-|%%----%%%%-%--------------------------------------------------------%------%------||-------------------%--%-----%%-%
--------|||#--|---------------||-|||----||||%|----%%%%%%%-%%%%--%----%%%%%---%------------%-----------|%%----|%%%%-%||-%%%%--------------|--|-----||-|
%%%%%%%%|||#%%|--%-----------%||-|||----||||||----|||||||-||||--|----|||||---|-%%%%%--%%-%|%%---%%%---|||----|||||-|||-||||--%----------%|--|-%---||%|
|||||||||||X|||-X|XXXXXXXXXXX|||-|||----||||||XXXX|||||||-||||XX|XXXX|||||XXX|X|||||XX||-||||X--|||XXX|||XXXX|||||X|XX-||||XX|XX-XXXXXXX||--|-|---||||