------------------------------------------------------------------------------------------------------------------------------------------------------
------------------------------------------------------------------------------------------------------------------------------------------------------
------------------------------------------------------------------------------------------------------------------------------------------------------
------------------------------------------------------------------------------------------------------------------------------------------------------
------------------------------------------------------------------------------------------------------------------------------------------------------
------------------------------------------------------------------------------------------------------------------------------------------------------
------------------------------------------------------------------------------------------------------------------------------------------------------
--------------------------D---------------------------------------------------------------------------------------------------------------------------
-------------------------------------------------------------------------------%----------------------------------------------------------------------
-------------------------------------------------------------------------------|----------------------------------------------------------------------
-------------------------------------------------------------------------------|----------------------------------------------------------------------
--------------------C-----%------------%------------%%-------------------------|------------%-------------------%------------------C------------------
--------------------------|---------%%-|-----------%||----------%-----%--------|------------|-------%---------%%|-------------------------------------
------------------%%-%%-%%|%--------||%|-----------|||--%--%-%--|%----|--%-%%%%|%%%%%---%---|-------|---------|||----------%---%----------------------
%%%%%%%%----------||-||-||||%-------||||-----------|||--|%-|-|%%||----|--|-||||||||||---|-%-|-------|---------|||----------|---|%%--%-----------------
||||||||-XXXX--XXX||X||X|||X|XXXX-XX||||XXXX--X-XXX|||X-||X|-|||||XXXX|XX|X|||||||||X--X|X|X|XXXXXXX|XXXXXXXXX|||---XXXXXXX|---|||-X|XXXXXXXXXXX-XXXXX