------------------------------------------------------------------------------------------------------------------------------------------------------
------------------------------------------------------------------------------------------------------------------------------------------------------
------------------------------------------------------------------------------------------------------------------------------------------------------
------------------------------------------------------------------------------------------------------------------------------------------------------
------------------------------------------------------------------------------------------------------------------------------------------------------
------------------------------------------------------------------------------------------------------------------------------------------------------
---------------------------------------------------S------------------------------------------------%-------------------------------------------------
----------------------------------------------------------------------------------------------------|-------------------------------------------------
----------------------------------------------------------------------------------------------------|-------------------------------------------------
--------------S-------------------------------%-----------------------------------------------------|-------------------------------------------------
------------------------%---------------------|----%------------%----------------------------------%|-------------------------------------------------
------------------------|----%----------------|%---|------------|--------%%------------------------||-----------%%------------------------------------
-----------------------%|--%-|%-----------%---||---|---%--%%--%%|--------||----------------%%%%-%%%||%%%%-------||----------------------%%------------
--------------%%%-----%||--|%||-----------|---||---|---|--||--|||--------||--%%%-----------||||-|||||||||%----%%||---%%-----------------|%------------
%%%%%%%%%%%%%%|||-----|||--||||-----------|---||---|---|-%||--|||-%-%%%--||--|||-----------||||-||||||||||-%--||||---||-%%---%--%-------||---%--------
|||||||||||||||||-XXXX|||XX|XX|XXXXXXXXXXX|XXX||XXX|XXX|X|||--|||-|-|||-XXXXX|||X-X-XXXXXXX||||-||||||||||X|XX||||-XX||X||XXX|XX|XXXXXXX|XXXX|XXXXXXXX