------------------------------------------------------------------------------------------------------------------------------------------------------
------------------------------------------------------------------------------------------------------------------------------------------------------
------------------------------------------------------------------------------------------------------------------------------------------------------
------------------------------------------------------------------------------------------------------------------------------------------------------
------------------------------------------------------------------------------------------------------------------------------------------------------
------------------------------------------------------------------------------------------------------------------------------------------------------
------------------------------------------------------------------------------------------------------------------------------------------------------
------------------------------------t-----------------------------------------------------------------------------------------------------------------
------------------------------------t-----------------------------------------------------------------------------------------------------------------
---------------------------------%--%------------------------------------------------------------------------------------------------g----------------
---------------------------------|--|-----------------------------------------------------------------------------------------------------------------
---------------------------------|--|------------------------------%%--S------------------------------------------------------------------------------
---------------------------------|--|-----------------------------%||%%--%-----------------------%-------------------%--------------------------------
---------%%%%--%-----------%%%%%%|--|-----%---------------%-------|||||--|----%-%--g-------------|-----%%-------%----|-%%%%%%%%%%-%%%---%%-%---%%%%-%%
%%%%%%%%%||||%%|------%%%%%|||||||--|-----|---------------|-------|||||--|-%%-|-|%-----%%%%%%%-%-|-----||-------|%%%%|-||||||||||-|||---||%|---||||-||
||||||||||||||||------||||||||||||XX|XXXXXXXXXXXXXXXXXXXXX|XXXX--X|XX||X-|-||X|-||XXXX-|||||||X|X|-XXXX||XX---XX||||||X||||||||||X|||--X||||---||||X||