------------------------------------------------------------------------------------------------------------------------------------------------------
------------------------------------------------------------------------------------------------------------------------------------------------------
------------------------------------------------------------------------------------------------------------------------------------------------------
------------------------------------------------------------------------------------------------------------------------------------------------------
------------------------------------------------------------------------------------------------------------------------------------------------------
------------------------------------------------------------------------------------------------------------------------------------------------------
------------------------------------------------------------------------------------------------------------------------------------------------------
------------------------------------------------------------------------------------------------------------------------------------------------------
------------------------------------------------------------------------------------------------------------------------------------------------------
------------------------------------------------------------------------------------------------------------------------------------------------------
-------------------------------------------------------------------------------------------------U----------------------------------------------------
------------------------------------------------------------------------------------------------------------------------------------------------------
--------------------------------%--%-%--------%---------------%--------------------%%-------------%------------------------------%---%%%%%%%--%%%%%---
--------------%%%%%%%%%%%%%%%%%-|-%|-|--------|--%------------|--------------------||-----%%-%%%%-|%%%%%%%%%%%%%%%%%------%%%%---|%%-|||||||--|||||--%
%%%%%%%%%%%%-%|||||||||||||||||%|-||-|--------|--|------------|%%%%%---%%%-----%%%%||%----||-||||%||||||||||||||||||------||||%--|||-|||||||--|||||--|
||||||||||||X||||||||||||||||||||X||X|XXXXXXXX|XX|XXXXXXXXXXXX||||||XXX|||XXXX-|||||||---X||X|||||||||||||||||||||||-XXXXX|||||XX|||X|||||||--|||||--|