------------------------------------------------------------------------------------------------------------------------------------------------------
------------------------------------------------------------------------------------------------------------------------------------------------------
------------------------------------------------------------------------------------------------------------------------------------------------------
------------------------------------------------------------------------------------------------------------------------------------------------------
------------------------------------------------------------------------------------------------------------------------------------------------------
------------------------------------------------------------------------------------------------------------------------------------------------------
------------------------------------------------------------------------------------------------------------------------------------------------------
--------------------------------------------------------------------------------------------D---------------------------------------------------------
-------------------S---------------------2------------------------------------------------------------------------------------------------------------
------------------------------------------------------------------------------------------------------------------------------------------------------
---------------------------------------------------------%----------------------------------t--------------------------------------------------%------
-----------------------------------------%-----%---------|----------------------------------T---------%-%-----------%--------------------------|------
-------------------%---------------%%%-%-|%%-%%|%%----%--|%-------------------%-------------t--%---%--|-|-----------%--------------%-----------|------
-----------%-------|%--------------|||-|-|||-|||||%%%%|%%||----------%%-------|-------%-----%%%|%--|%-|%|%%%%%%%%%%%|---------%%%%%|-%----%%%%%|%%---%
%%%%%%%%---|%%-%--%||--------------|||%|-|||-||||||||||||||----------||-------|-------|%%---|||||--||-|||||||||||||||%%%%-----||||||%|-%--||||||||---|
||||||||XXXX||X|XX|||XXXXXXXXXXXXXX|||||-|||-||||||||||||||XXXXXXXXXX||XXXXXXX|XXXXXXX|||XX-|||||XX||-||||||||||||||X||||---XX||||||||X|XX||||||||XXX|