------------------------------------------------------------------------------------------------------------------------------------------------------
------------------------------------------------------------------------------------------------------------------------------------------------------
------------------------------------------------------------------------------------------------------------------------------------------------------
------------------------------------------------------------------------------------------------------------------------------------------------------
------------------------------------------------------------------------------------------------------------------------------------------------------
------------------------------------------------------------------------------------------------------------------------------------------------------
------------------------------------------------------------------------------------------------------------------------------------------------------
------------------------------------------------------------------------------------------------------------------------------------------------------
------------------------------------------------------------------------------------------------------------------------------------------------------
------------------------------------------------------------------------------------------------------------------------------------------------------
-------------%%---------------------------------------------------------------------------------------%%-----------------------------------%----------
-------------||-------------------------------------------------------%----------%--------------------||-----------------------------------|----------
-------------||%-----------------%-----%------------------------------|---%--%%--|--------%%----------||%----------------------------------|--%-------
-------------|||--%%%%%-%%-------|-----|----------------%%------------|%--|%%||--|%-------||--%%%%%%%%|||---%-------------------------%%---|%-|----%%%
%%%%%%%%%%%%%|||%%|||||%||%%%%%%%|-%-%%|%%%-------------||------------||--|||||--||---%---||%%|||||||||||---|-------------------------||---||-|----|||
||||||||||||||||||||||||||||||||||X|X||||||XXX-XXXXXXXX-||XXXXXXXXXXXX||XX|XX||XXX|XXX|XXX|||||||||||||||---|XXXXXXXXXXXXXXXXX-XX--X--||XXX||X|----|||