------------------------------------------------------------------------------------------------------------------------------------------------------
------------------------------------------------------------------------------------------------------------------------------------------------------
------------------------------------------------------------------------------------------------------------------------------------------------------
------------------------------------------------------------------------------------------------S-----------------------------------------------------
------------------------------------------------------------------------------------------------------------------------------------------------------
------------------------------------------------------------------------------------------------------------------------------------------------------
--------------------------------------------------------------------------------------------------2---------------------------------------------------
-----------------%------------------------------------------------------------------------------%-----------------------------------------------------
-----------------|------------------------------------------------------------------------------|-----------------------------------------------------
-----------------|------------------------------------------------------------------------------|-----------------------------------------------------
-----------------|------------------------------------------------------------------------------|-%---------------------------------------------------
-----------------|----------------------------------------k-------------------------------------|-|----------------%%%--------------------------------
-----------------|-----%%%%--%-----%------------------------------------------------------------|-|----%----%%%%%%%|||%%%-%---------------------%%%-%-
-------------%%-%|%%%--||||--|-----|--%----------------%----------------------%-----------------%-|---%|----|||||||||||||-|--%%%%%%%%%%%%%%%%%%%|||-|-
%%%%%%%%-----||-|%|||%%||||--|-----|--|-----%%%--------|----------------------|-----------------|%|---||--%-|||||||||||||-|--||||||||||||||||||||||-|-
||||||||XXXXX||XX||||||||||--|XXXXX|XX|XXXXX|||XXXXXXXX|XXX-XXXXXXXXXXXXXXXXXX|XXXXXXXXXXXXXXXXX|||XXX||XX|-|||||||||||||X|X-||||||||||||||||||||||X|-