------------------------------------------------------------------------------------------------------------------------------------------------------
------------------------------------------------------------------------------------------------------------------------------------------------------
------------------------------------------------------------------------------------------------------------------------------------------------------
------------------------------------------------------------------------------------------------------------------------------------------------------
------------------------------------------------%-----------------------------------------------------------------------------------------------------
------------------------------------------------|-----------------------------------------------------------------------------------------------------
-------------------------------------------%----|-----------------------------------------------------------------------------------------------------
-------------------------------------------|----|-----------------------------------------------------------------------------------------------------
-------------------------------------------|----|-----------------------------------------------------------------------------------------------------
-------------------------------------------|----|-----------------------------------------------------------------------------------------------------
-------------------------------------------|----|-----------------------------------------------------------------------------------------------------
-------------------------------------------|----|---------------------------------------%-------------------------------------------%-----------------
------------%-----%%-------------------%%--|----|--------------------------------%------|-------------------------------------------|-----------------
------------|-----||%%%%--%--%---------||--|----%-------------%%%%%%%%%%%-------%|------|-------------------------------------------|-----------------
%%%%%%%%%%-%|%%%-%||||||--|--|---------||--|----|-----------%%|||||||||||-------||------|%------%--%----------%--------------------%|%------------%%--
||||||||||-|||||-|||||||XX|XX|XXXXXXXXX||XX|XXX-|---XXXXXXXX|||||||||||||XXXXXXX||XXXXXXX|XXXXXX|X-|--XXXXXXX-|XXXXXXXX-XXXXXXXX-XX|||XXXXXXXXXXXX||XX