------------------------------------------------------------------------------------------------------------------------------------------------------
------------------------------------------------------------------------------------------------------------------------------------------------------
------------------------------------------------------------------------------------------------------------------------------------------------------
------------------------------------------------------------------------------------------------------------------------------------------------------
------------------------------------------------------------------------------------------------------------------------------------------------------
------------------------------------------------------------------------------------------------------------------------------------------------------
------------------------------------------------------------------------------------------------------------------------------------------------------
------------------------------------------------------------------------------------------------------------------------------------------------------
------------------------------------------------------------------------------------------------------------------------------------------------------
------------------------%-----------------------------------------------------------------------%-----------------------------------------------------
------------------------|-----------------------------------------------------------------------|-------%--%%-----------------------------------------
------------------------|-----------------------------------------------------------------------|-------|--||-----------------------------------------
------------------------|-%%%%%%--%%---------------------%--%---------------------------%%%---%%|-%-----|--||-%%%------------------------%----------%-
------------------------|%||||||--||----------------%----|%%|-%-------------------------|||---|||-|-----|--||-|||%%%-%-------------------|----------|-
%%%%%%%%-------%--------||||||||--||------%---------|%---||||-|--%----------%-%%%%------|||---|||-|---%-|%%||%||||||-|-%--%--%-%%%-----%%|--------%-|-
||||||||XXXXXXX|XXXXXXXX||||||||XX||XXXXXX|XXXXXXXXX||XXXXX|XX|XX|X--XXXXX--|-||||XX--XX|||XXX|||X|XXX|-||||||||||||-|X|XX|XX|X|||XXXXX|||XX-XXXXX|X|X