------------------------------------------------------------------------------------------------------------------------------------------------------
------------------------------------------------------------------------------------------------------------------------------------------------------
------------------------------------------------------------------------------------------------------------------------------------------------------
------------------------------------------------------------------------------------------------------------------------------------------------------
------------------------------------------------------------------------------------------------------------------------------------------------------
------------------------------------------------------------------------------------------------------------------------------------------------------
------------------------------------------------------------------------------------------------------------------------------------------------------
------------------------------------------------------------------------------------------------------------------------------------------------------
------------------------------------------------------------------------------------------------------------------------------------------------------
--------------------------------------------------------------------------------------------%---------------------------------------------------------
--------------------------------------------------------------------------------------------|---------------------------------------------------------
--------------------------------------g-----------------------------------------------------|-------%-------------------------------------------------
-----------------------------------%%---%%---------------%%%%-------------------------------|-------|----------------------%---%%-%-------------------
-------------------------------g---||--%||%--------------||||-------------------------------|-------|%---------------%-----|---||-|--------%-%%%%%%%%%
%%%%%%%%---------------------------||%-||||----%-----%--%||||--------------%--%-------------|-------||---------%%%--%|%----|-%%||-|--------|-|||||||||
||||||||-----XXX-XX-----XXXXXXXXXXX|||X||||XX--|XXXXX|XX|||XXXXXXXXXXXXXXXX|XX|XXXXXXXX-XXXX|XXXXXXX||-XXXXXXXX|||X-|||X---|X||||-|XXXXXXXX|X|||||||||