------------------------------------------------------------------------------------------------------------------------------------------------------
------------------------------------------------------------------------------------------------------------------------------------------------------
------------------------------------------------------------------------------------------------------------------------------------------------------
------------------------------------------------------------------------------------------------------------------------------------------------------
--------------------------------------------------------------------------------------------------------------------------------------------------S---
------------------------------------------------------------------------------------------------------------------------------------------------------
--------------------%----------------------------------------------------------------------------------------------------------------------------%----
--------------------|----------------------------------------------------------------------------------------------------------------------------|----
--------------------|-------%------------------------------%-------------------------------------------------------------------------------------|-%--
--------------------|-------|------------------------------|-------------------------------------------------------------------------------------|-|--
--------------------|-------|------------------------------|-----------------------------------#-------------------------------------------------|%|--
--------------------|------%%--%%--------------------------|--------------------S--%-----------#-------------------------------------------------|||--
--------------------|------||--||--------------------------|-----------------------|---------%%%%%%%----------------------------%-%-%%%%%-----%%%|||--
-------------r------|-%----||--||---%----------------------|--%%%%--------%--------%%%%%%----|||||||--------%----------%%%%%%---|-%-|||||-----||||||%%
%%%%%%%%%%%%%%%%%%%%%%|%%%-||--||---|------------%-%-------|--||||--------|%-%-----||||||---%|||||||---%----|----------||||||---|-|-|||||%%%--||||||||
||||||||||||||||||||||||||X||X-||XXX|XXXXX-X-XXXX|X|XXXXXXX|XX||||XXXX-XXX||X|XXXXXX|||||XXX||||||||XXX|XXXX|XXXXXXXXXX||||||--XX-X-||||||||--||||||||