------------------------------------------------------------------------------------------------------------------------------------------------------
------------------------------------------------------------------------------------------------------------------------------------------------------
------------------------------------------------------------------------------------------------------------------------------------------------------
------------------------------------------------------------------------------------------------------------------------------------------------------
-------------------------------------------------------------------------------%----------------------------------------------------------------------
-------------------------------------------------------------------------------|----------------------------------------------------------------------
----------------------%-%------------------------------------------------------|--------------------------------------------------%-------------------
----------------------|-|------------------------------------------------------|--------------------------------------------------|-------------------
----------------------|-|------------------------------------------------------|--------------------------------------------------|-------------------
----------------------|-|----------------------------------------------S------%%--------------------------------------------------|-------------------
----------------------|-|-----------------------------------------------------||--------------------------------------------------|-------------------
----------------------|-|-----------------------------------------------------||---------%-----------------SS---------------------|-------------------
------------%%%%%-----|-|--------------%%------%%-----------------------------||------%--|----------------------------------------|---------%---%%----
--------%%--|||||--%%-|%|-%-%%---------||------||%%%%%-%%--%%%----------------||----%-|%%%%---------------------------------------%----%----|---||----
%%%%%%%%||%%|||||%-||-|||-|-||---------||%%%%%-|||||||-||%-|||%%%---%%%--%%---||----|-|||||---%-----------------%------------%----|----|--%-|---||----
||||||||||||||||||X||X|||X|X||XXXXXXXXX|||||||-|||||||X|||X||||||X--|||XX||XXX|XXXXX|X||XX|XXX|XXXXXXXXXXXXXXXXX|XX-XXXXX-XXX|XXXX|XXXX|XX|X|-XX||--XX