------------------------------------------------------------------------------------------------------------------------------------------------------
------------------------------------------------------------------------------------------------------------------------------------------------------
------------------------------------------------------------------------------------------------------------------------------------------------------
------------------------------------------------------------------------------------------------------------------------------------------------------
------------------------------------------------------------------------------------------------------------------------------------------------------
------------------------------------------------------------------------------------------------------------------------------------------------------
------------------------------------------------------------------------------------------------------------------------------------------------------
--------------------------------------------------------------------------------------------------------------------------------%---------------------
--------------------------------------------------------------------------------------------------------------------------------|---------------------
--------------------------------------------------------------------------------------------------------------------------------|---------------------
--------------------------------------------------------------------------------------------------------------------------------|---------------------
--------------%-------------------------------------------%-------------------------------------------C-------------------------|---------------------
--------------|--------%%%--%----------------------%%-----|----------%---------%-----%---%%----------%----------------%---------|---------------------
--------------|--------|||--|----------------------||-----|-----%%%--|---------|-----|---||----------|-------------%--|---------|-------%-------------
%%%%%%%%%%%%%%|%%%-%%--|||--|------------------%%%-||-----|-----|||-%|---%%%%%-|%---%|-%-||--------%%|-------------|--|---------|-------|%%-----------
||||||||||||||||||X||XX|||--|XX-XXXXXXXXXXXXXXX|||X||XX-XX|X-X--|||X||---|||||-||---||-|X||X--XXXXX|||XXXXXXXXXXXXX|XX|X----XXXX|XXXXXXX|||XXXXXXXXXX-