------------------------------------------------------------------------------------------------------------------------------------------------------
------------------------------------------------------------------------------------------------------------------------------------------------------
------------------------------------------------------------------------------------------------------------------------------------------------------
------------------------------------------------------------------------------------------------------------------------------------------------------
------------------------------------------------------------------------------------------------------------------------------------------------------
------------------------------------------------------------------------------------------------------------------------------------------------------
------------------------------------------------------------------------------------------------------------------------------------------------------
------------------------------------------------------------------------------------------------------------------------------------------------------
------------------------------------------------------------------------------------------------------------------------------------------------------
---------------------------------------------------%--------------------------------------------------------------------------------------------------
---------------------------------------------------|----------------------------------------------------------------------t---------------------------
---------#-----------------------------------------|-----------#----------------------------------------------------------t---------------------------
--------%#------%-------------------------%-------%|-------%---%-%-%----------%%--%%-----%%-------------%-----------------t----------------------%----
--------|#--%---|------%%-%%%%%%%-%-%%%%--|%--%%--||-------|---|-|-|----------||--||-----||%------------|-----------------%-%%%%%%%-%---%--------|----
%%%%%%%%|%--|--%|-%%%--||-|||||||-|-||||--||--||%-||%%%%%-%|%%-|-|-|---%------||--||-----|||------%-----|-----------------|-|||||%|-|---|--------|----
||||||||||-X|XX||X|||XX||X|||||||X|X||||-X||X-X||X|||||||X||||X|X|X|--X|XXXXXX||XX||XX-XX|||--XXXX|X-XXX|XXXXXXXXXXXXXXXXX|X|||||||-|XXX|XXX-XXXX|XXXX