------------------------------------------------------------------------------------------------------------------------------------------------------
------------------------------------------------------------------------------------------------------------------------------------------------------
------------------------------------------------------------------------------------------------------------------------------------------------------
------------------------------------------------------------------------------------------------------------------------------------------------------
------------------------------------------------------------------------------------------------------------------------------------------------------
------------------------------------------------------------------------------------------------------------------------------------------------------
------------------------------------------------------------------------------------------------------------------------------------------------------
------------------------------------------------------------------------------------------------------------------------------------------------------
------------------------------------------------------------------------------------------------------------------------------------------------------
------------------------------------------------------------------------------------------------------------------------------------------------------
----------------------------------------------------------------------------------C-------------------------------------------------------------------
-----------------------------------------------%------------------CS----------------------------------------------------------------------------------
-----------%-----------------------------------|-------------------------------------------------------------------------------------------------%%%--
-----------|---------------%------%%%----%%---%|-----------------------%-----------------------%--------------------------%%---------------------|||--
%%%%%%%%%--|-%-------------|------|||----||---||-----------------------|--------%-%------%-----|--------------%-------%---||%-----%--%-----------|||--
|||||||||-X|X|XXXXXXXXXXXXX|XXXXXX|||XXXX||XXX|XX--XXXXXXXXXXXXXXXXXXXX|XXXXXXXX|X|XXXXXX|XXXXX|X----XXXXXXXXX|XXX-XXX|XXXXX|XXXXX|X-|XXXXXXXXXXX|||XX