------------------------------------------------------------------------------------------------------------------------------------------------------
------------------------------------------------------------------------------------------------------------------------------------------------------
------------------------------------------------------------------------------------------------------------------------------------------------------
------------------------------------------------------------------------------------------------------------------------------------------------------
------------------------------------------------------------------------------------------------------------------------------------------------------
------------------------------------S-----------------------------------------------------------------------------------------------------------------
------------------------------------------------------------------------------------------------------------------------------------------------------
------------------------------------------------------------------------------------------------------------------------------------------------------
------------%----------------------------------------------------------------------------------------------------------%------------------------------
------------|----------------------------------------------------------------------------------------------------------|------------------------------
------------|----------------------------------------------------------------------------%-----------------------------|------------------------------
------------|------------------U---------------------------------------------------------|-----------------------------|------------------------------
------------|--------------------%%-%--%----------------------------%%-%%----%-----------|-----------------------------%------------------------------
------------|-%%%----%%-%%-------||-|--|----------------------------||-||----|-----------|-----------------GG----------|-----%%%%%%%%%-----%----------
%%%%%%%%%%--|%|||----||-||%%--%--||-|%-|-----------------%----------||-||----|-----------|------%%--%%--%%%%%-%%---%%%-|-%%%%|||||||||---%%|-----%----
||||||||||--|||||----||X||||XX|XX||-||-|---XXXXXXXXXXXXXX|XXXXXXXXXX||X||X---|XXXXXXXX-XX|XX-XXX||XX||X-|||||X||XXX|||X|X|||||||||||||XX-|||XXXXX|XXXX