------------------------------------------------------------------------------------------------------------------------------------------------------
------------------------------------------------------------------------------------------------------------------------------------------------------
------------------------------------------------------------------------------------------------------------------------------------------------------
------------------------------------------------------------------------------------------------------------------------------------------------------
------------------------------------------------------------------------------------------------------------------------------------------------------
------------------------------------------------------------------------------------------------------------------------------------------------------
------------------------------------------------------------------------------------------------------------------------------------------------------
------------------------------------------------------------------------------------------------------------------------------------------------------
------------------------------------------------------------------------------------------------------------------------------------------------------
--------------------------------------------------------------------------------#---------------------------------------------------------------------
-------------------------------------g---------------------------------------%--%---------%-----------------------------------------------------------
-----------------------------------------------------------------------------|--|---------|-----------------------------------------------------------
------------------%------%-%------------------------------%%-----------------|--|-%%------|------%----------------------------------------------------
------------------|------|-|----------%-------------------||----%-%%--------%|--|-||----%-|-%%%%%|%---g-----------------------------------------------
%%%%%%%%%%%%---%%-|------|-|----------|-------------------||----|-||--%-----||--|-||----|-|%|||||||-------------------------%----%%%%%%%%%----------%-
||||||||||||---||-|XXXXXX|X|XXXXXXXXX-|XXXXXXXXXXXXXXXXXXX||X--X|X||XX|XXX--||XX|X||XXXX|X|||||||||XXXXXXXXXXXXXXXXX-XXXXXXX|X-X-|||||||||XXXXXXXXX-|X