------------------------------------------------------------------------------------------------------------------------------------------------------
------------------------------------------------------------------------------------------------------------------------------------------------------
------------------------------------------------------------------------------------------------------------------------------------------------------
------------------------------------------------------------------------------------------------------------------------------------------------------
------------------------------------------------------------------------------------------------------------------------------------------------------
------------------------------------------------------------------------------------------------------------------------------------------------------
------------------------------------------------------------------------------------------------------------------------------------------------------
---------------------------------------------------------------------------------------D--------------------------------------------------------------
------------------------------------------------------------------------------------------------------------------------------------------------------
------------------------------------------------------------------------------------------------------------------------------------------------------
---------------------------------------------------------------------------------------%----------------------------------------%---------------------
---------------------------------------------------------------------------------------|----%-----------------------%------%%%%-|-------------%---%%--
----------------------------------%%---------------------------------------------------|----|-%%%%------------------|----%-||||-|-------------|---||--
----------------------------------||-%-------%------%-%%%%--%%%%--%%-------------------|%%--|-||||---------%------%%|%---|-||||-|------------%|---||--
%%%%%%%%---%%%%%%%%%%-%%%--------%||-|%------|------|%||||--||||%-||%%---%-%----------%|||--|-||||--------%|------||||---|-||||-|------------||---||--
||||||||---||||||||||X|||XXXX-XXX|||X||XXXXXX|X-XXXX||||||--|||||X||||XXX|-|-XXXXXXXXX||||X-X-||||-XXXXXX-||XXXXXX||X|---|XXXXXX|XXXXXXXXXXXX|X--XXX--