------------------------------------------------------------------------------------------------------------------------------------------------------
------------------------------------------------------------------------------------------------------------------------------------------------------
------------------------------------------------------------------------------------------------------------------------------------------------------
------------------------------------------------------------------------------------------------------------------------------------------------------
------------------------------------------------------------------------------------------------------------------------------------------------------
------------------------------------------------------------------------------------------------------------------------------------------------------
------------------------------------------------------------------------------------------------------------------------------------------------------
--------------------------------------------------------------------------------------------%------------------------D--------------------------------
--------------------------------------------------------------------------------------------|---------------------------------------------------------
--------------------------------------------------------------------------------------------|---------------------------------------------------------
--------------------------------------------------------------------------------------------|-----------------------S---------------------------------
---------------------%%%--------------------------------------------------------------------|------------------------------------------------%--------
--------%----%-----%-|||---%--------------------------------#-------------------------------|------------------------------%-----------------|--------
--------|----|-----|-|||---|------------------%---------%%%%%%%%-----------%%-%-%------%%%%-|------------------%%----%-----|%-r------------%%|--%----%
%%%%%%%%|%%%-|%----|-|||--%|%------%----------|---------||||||||-----------||-|-|---%--||||-|------------------||---%|-----||--------------|||--|--%%|
||||||||||||X||XXXX|X||XXX|||XXXXXX|XXXXXXXXXX|XXXXXXXXX||||||||XXXXXXXXXXX||X|X|--X|XX||||X|-XXXXXXXXXXXXXXXXX||XXX||XXXXX||XXXXXXXXXXXXXX||XXXXX-|||