------------------------------------------------------------------------------------------------------------------------------------------------------
------------------------------------------------------------------------------------------------------------------------------------------------------
------------------------------------------------------------------------------------------------------------------------------------------------------
------------------------------------------------------------------------------------------------------------------------------------------------------
------------------------------------------------------------------------------------------------------------------------------------------------------
------------------------------------------------------------------------------------------------------------------------------------------------------
------------------------------------------------------------------------------------------------------------------------------------------------------
------------------------------------------------------------------------------------------------------------------------------------------------------
---------------------------------------------------------------------------------------------------------------------------------------%--------------
-----------------------------------------------------------%---------------------------------------------------------------------------|--------------
-----------------------------------------------------------|---------------------------------------------------------------------------|--%-----------
-----------------------------------------------------------|%--------------------------------------------------------------------------|--|-----------
-----------%----------------------------------%%%-%%%%-----||-%%---------------------------------------------------------------------%%%--|-%-%-------
-----------|-----%------------------------%%--|||%||||-----||-||%%%%%%%%%%%%%------%%%%------#-------%%%%%%%%------------------------|||%%|%|-|%%-%%%%
%%%%%%%%--%%%----|----%%%%%%%%%%%%%%%--%-%||--||||||||----%||-|||||||||||||||--%%--||||%%--%-%%------||||||||---------------------%--||||||||-|||-||||
||||||||XX|||--XX|XXXX|||||||||||||||XX|X|XXXX||||||||XX--||XX|||||||||||||||XX||XX||||||XX|X||XXXXXXXXXXXXXX-X-XXXXXXXXXXXXXXXX--|XX||||||||-|||X||||