------------------------------------------------------------------------------------------------------------------------------------------------------
------------------------------------------------------------------------------------------------------------------------------------------------------
------------------------------------------------------------------------------------------------------------------------------------------------------
------------------------------------------------------------------------------------------------------------------------------------------------------
------------------------------------------------------------------------------------------------------------------------------------------------------
------------------------------------------------------------------------------------------------------------------------------------------------------
------------------------------------------------------------------------------------------------------------------------------------------------------
------------------------------------------------------------------------------------------------------------------------------------------------------
------------------------------------------------------------------------%-----------------------------------------------------------------------------
------------------------------------------------------------------------|-----------------------------------------------------------------------------
------------------------------------------------------------------------|-----------------------------------------------------------------------------
---------------------------------------------------------F--------------|-----%%%---------------------------------------------------------------------
-----------------%----------------------------%----------%--------------|----%|||---------------------%%---------------------------------------%%-----
-----------%-----|---------------%-%%%%%%--%%-|---%------|--------------|----||||---%%%--%%-----------||---------------------------------------||-----
%%%%%%%%%%%|-----|---------------|-||||||--||-|%%-|-----%|--------------|%---||||---|||--||---------%-||--------%%%%%--%%----------------------||%%-%%
||||||||||||XXXXX|XXXXXX--XXXXXXX|X||||||XX||-|||X|XXXXX||XXXXXXXXXXXXXX||XXX|XXXXXX|||-X||XXXXXXX--|X||XXXXXXXX|||||XX||XXXXXX-XXXXXXXXXXXXXXX||||-||