------------------------------------------------------------------------------------------------------------------------------------------------------
------------------------------------------------------------------------------------------------------------------------------------------------------
------------------------------------------------------------------------------------------------------------------------------------------------------
------------------------------------------------------------------------------------------------------------------------------------------------------
------------------------------------------------------------------------------------------------------------------------------------------------------
------------------------------------------------------------------------------------------------------------------------------------------------------
------------------------------------------------------------------------------------------------------------------------------------------------------
------------------------------------------------------------------------------------------------------------------------------------------------------
-----------------------------------------------------------------------------------------------------------%------------------------------------------
-----------------------------------------------------------------------------------------------------------|---------------------------------------%--
------------------------------------------------------------------%---%%-----------------------------------|---------------------------------------|--
------------------------------------------------------------------|---||--------------------------%---%%---|---------------------------------------|--
-----------%%%%%%%%-%%%%%%%%%------%--------%-%--------%----------|--%||%-%--%--------------------|---||---|%---------------------U--------------%-|--
-----------||||||||%|||||||||------|--------|-|%-------|-2-------%|--||||-|--|%--%----------------%---||---||-%%%%%%%%%%%%-%%%------%%%-----%%---|-|%%
%%%%%%%%%%%||||||||||||||||||------|--------|-||--%%%%%|--%%%%%%%||-%||||-|--||--|----------------|%%-||--%||-||||||||||||%|||------|||-----||%%%|-|||
|||||||||||||||||||||||||||||XXXXXXXXXXXXXXX|X||-X||||||XX|||||||||X|||||X|XX||XX|XXXXXXXXXXXXXXXX|||-||X-|||X||||||||||||||||-XXXXX|||XXXXX||||||-|||