------------------------------------------------------------------------------------------------------------------------------------------------------
------------------------------------------------------------------------------------------------------------------------------------------------------
------------------------------------------------------------------------------------------------------------------------------------------------------
------------------------------------------------------------------------------------------------------------------------------------------------------
------------------------------------------------------------------------------------------------------------------------------------------------------
------------------------------------------------------------------------------------------------------------------------------------------------------
------------------------------------------------------------------------------------------------------------------------------------------------------
--------------------------------------------------------------------------------------------------------------------------S---------------------------
------------------------------------------------------------------------------------------------------------------------------------------------------
-----------------------------------------------------------%--------%---------------------------------------------------------------------------------
-----------------------------------------------------------|--------|-----------------------------------------------------%---------------------------
---------------------%-------------------------------------|--------|-------%%%---------------------------------S---------|---------------------------
---------------------|-----%---%--------------%%-----------|--%%---%|-------|||----------%-----%%----%--%-----------------|-----%---%-----------------
-------------------%%|-----|---|--------------||-----------|-%||-%%||----%%%|||%%%-----%%|-----||----|--|-------------%%--|-----|---|------------%----
%%%%%%%%%%%%%%-----|||-----|--%|--------------||-----------|-|||-||||--%-|||||||||%%---|||%----||----|--|------%--%%-%||--|-----|---|--------%---|----
||||||||||||||XXXXX||XX-XX-|X-||XXXXX---XXXXXX||XXXXXXXXXXX|X|||X||||XX|-|||||||||||---||||X---||---X|XX|XXXXXX|X-||X|||XX|XXXXX|XXXXXX-XXX--|XXX|X-XX