------------------------------------------------------------------------------------------------------------------------------------------------------
------------------------------------------------------------------------------------------------------------------------------------------------------
------------------------------------------------------------------------------------------------------------------------------------------------------
------------------------------------------------------------------------------------------------------------------------------------------------------
------------------------------------------------------------------------------------------------------------------------------------------------------
------------------------------------------------------------------------------------------------------------------------------------------------------
--------------------------------------------------------------------------------------------------------------------D---------------------------------
------------------------------------------------------------------------------------------------------------------------------------------------------
---------------%--------------------------------------------------------------------------------------------------------------------------------------
---------------|--------------------------------------------------------------------------------------------------------------------------------------
---------------|-----------------------------------------------------------------%--------------------------------------------------------------------
---------------|-----------------------------------------------------------------|----------------%---------------------------------------------------
---------%-----|-----------------------------------------%%----------------------|---%------------|-%--------%%---------------------------------------
---------|-%%%%|-----------------------------------%---%-||----------------------|---|%------%%%-%%%|--------||-----%-----------------------%%%---%---
%%%%%%%%-|-|||||-------------%---------------------|-%%|-||-------------%--------|---||-%%---|||-||||--------||-----|-----------------------|||%%%|---
||||||||-|X|||||X--XXXXXXXXX-|XXXXXXXXXXXXX-XXXXXXX|X|||X||-XXXXXXXXXXXX|-XXXXXXX|-XX||X||-X-|||X|X||XXXXXXXX||XX-XX|---XXXXXXXXX--XXXXXXXXX|||||||XXX