------------------------------------------------------------------------------------------------------------------------------------------------------
------------------------------------------------------------------------------------------------------------------------------------------------------
------------------------------------------------------------------------------------------------------------------------------------------------------
------------------------------------------------------------------------------------------------------------------------------------------------------
------------------------------------------------------------------------------------------------------------------------------------------------------
------------------------------------------------------------------------------------------------------------------------------------------------------
------------------------------------------------------------------------------------------------------------------------------------------------------
-----------------------------------------------------------------------------------------------------%------------------------------------------------
-----------------------------------------------------------------------------------------------------|------------------------------------------------
-------------------------------------%---------------------------------------------------------------|------------------------------------------------
---------------------------------%---|---%-----------------------------------------------------------|------------------------------------------------
---------------------------------|---|---|%-------------------------------------%--------------------|---------------------------------------------%%-
----------------%%---------------|--%%---||--------%%---------------------------|--------------------|---------------------------------------------||-
---------%%%%%%%||%%%%%%%%%%%----|--||---||--------||---------------------%%----|%%---%%%%%%%%-%-%%--|--%%%%%%%%----%------%%%--%-----------------%||-
%%%%%%%%-||||||||||||||||||||-%%%|--||--%||%-------||---------------------||----|||---||||||||-|-||--|-%||||||||%%%%|------|||--|------%%%--------|||-
||||||||X||||||||||||||||||||X||||-X||XX||X|XXXXXXX||XXXX-XXXXXXXXXXXXXXXX||X---X||XX-||||||||X|X||-X|-||||||||||||||------|||XX|XXXXXX|||XXXXXXXX|XX-