------------------------------------------------------------------------------------------------------------------------------------------------------
------------------------------------------------------------------------------------------------------------------------------------------------------
------------------------------------------------------------------------------------------------------------------------------------------------------
------------------------------------------------------------------------------------------------------------------------------------------------------
------------------------------------------------------------------------------------------------------------------------------------------------------
------------------------------------------------------------------------------------------------------------------------------------------------------
------------------------------------------------------------------------------------------------------------------------------------------------------
------------------------------------------------------------------------------------------------------------------------------------------------------
----------------------------------------------------------------------------------------------------------------%-------------------------------------
----------------------------------------------------------------------------------------------------------------|-------------------------------------
-------------------------------------------------------------------------------------------------------%--------|-------------------------------------
-----------------------------%%----------------------%%------------------------------------------------|--------|-------------------------------------
-----------------------------||------%%%%%---%-------||%%%%%---------%%%%%%-%%-%%---%%%----------------|---%%%%%|%%%%--%---------------%%%%---%-------
------------%-%--------------||------|||||%%%|-------|||||||---%%%-%-||||||-||-||---|||--------------%-|---||||||||||%%|%--------------||||---|-------
%%%%%%%%%%-%|%|%%------------||%--%%%|||||||||-------|||||||---|||%|%||||||-||-||%-%|||------------%%|%|---||||||||||||||------%%%-----||||%--|-------
||||||||||-||||||XXXXXXXXXXXXX||--||||||||||||XXXXXX-XX|||||XXX||||||||||||X||X|||-||||XXXXXXXXXXXX|||||---||||||||||||||XXXXXX|||XXXXX|XXX|XX|XXXXXX-