------------------------------------------------------------------------------------------------------------------------------------------------------
------------------------------------------------------------------------------------------------------------------------------------------------------
------------------------------------------------------------------------------------------------------------------------------------------------------
------------------------------------------------------------------------------------------------------------------------------------------------------
------------------------------------------------------------------------------------------------------------------------------------------------------
------------------------------------------------------------------------------------------------------------------D-----------------------------------
------------------------------------------------------------------------------------------------------------------------------------------------------
------------------------------------------------------------------------------------------------------------------------------------------------------
------------------------------------------------------------------------------------------------------------------------------------------------------
------------------------------------------------------------------------------------------------------------------------------------------------------
------------------------------------------------------------------------------------------------------------------------------------%%----------------
------------------------------------------------------------------------------------------------------------------%-----------------||----------S-----
--------------------------------%%%%-%--%%%--%%----------------------------------------%---%%%%--%%%---%%-%%%%%%--|%-%--%-----%%%%--||----------------
------------%-------------------||||-|%%|||--||----------------------------------------|---||||--|||---||-||||||--||-|--|----%||||--||%---------------
%%%%%%%%%%%-|------------%%%%%--||||-||||||%%||----------------------------------------|---||||--|||---||-||||||--||-|--|----|||||--|||----%----------
|||||||||||X|XXXXXXXXXXXX|||||XX||||X||||||||||XX-XXXXXXXXXXXXXXXXXXXXXXXX-XXXX-X-XXXXX|XXX||||--|||XXX||-||||||XX||-|XX|XXXXX||||-X|||XXXX|XXXXXXXXXX