------------------------------------------------------------------------------------------------------------------------------------------------------
------------------------------------------------------------------------------------------------------------------------------------------------------
------------------------------------------------------------------------------------------------------------------------------------------------------
------------------------------------------------------------------------------------------------------------------------------------------------------
------------------------------------------------------------------------------------------------------------------------------------------------------
------------------------------------------------------------------------------------------------------------------------------------------------------
------------------------------------------------------------------------------------------------------------------------------------------------------
------------------------------------------------------------------------------------------------------------------------------------------------------
---------------------------------------------------------------------------------------%-------------------------------2------------------------------
---------------------------------------------------------------------------------------|----------------------------T---------------------------------
---------------------------------------------------------------------------------------|----------------------------t-%-------------------------------
-------------------------------------------------%--%%-----%--------------------------%|----------------------------t-|--S----------------------------
----------------------------------%--------------|--||----%|------%%--------------%---||---------------------%%%----t%%%-------%--%%------------------
------------------------%-----%%%%|%-%%%-%-------|--||----||-%%%-%||-%-%-----%-%%%|---||-------%--%%---------|||----%|||-------|--||-----%------------
%%%%%%%%%---------------|-----||||||-|||-|%%-----|--|r----||%|||-|||-|%|-----|-||||--%|%%-%%%%%|--||---------|||---%||||%------|--||-----|--%--------%
|||||||||XXXXXXXXXXXXXXX|-----||||||-|||X|||XXXXXX-XXX--XX||||||-|||X|||XXXXXXX||||--||||X||||||XX||---XXXXXXXXXXXX|XX|||XXXX-X|--||XXXXX|XX|XXXXXXXX|