------------------------------------------------------------------------------------------------------------------------------------------------------
------------------------------------------------------------------------------------------------------------------------------------------------------
------------------------------------------------------------------------------------------------------------------------------------------------------
------------------------------------------------------------------------------------------------------------------------------------------------------
--------------------------------------------------------------------------------------------------------------------S---------------------------------
------------------------------------------------------------------------------------------------------------------------------------------------------
------------------------------------------------------------------------------------------------------------------------------------------------------
----------------------------------------------------------------------------------------------------------------------------------------%-------------
--------------------------------------------------------------------------------------------------------------------D-------------------|-------------
---------------------------------------------------------------------------------------------------------------------%------------------|--%----------
------------------------------%--------------------------------------------------------------------------------------|------------------|--|----------
------------------------------|--------------------------------------------------------------------------------------|------------------|--|----------
-----------------------------U|-----------------%%%%%%%----------%-------------------------------------------%-------%----------------%-|--|----------
------------------------------|-----------------|||||||%%-%------|-------------------------------------------|------%|--------------%%|%%%%|----------
%%%%%%%%----------------------|-----------------|||||||||-|%-----|%%-%%%%--%----------%---%-%---------%---%%%|----%-||---%-%%%%-%%--||||||||----------
||||||||XXXXXXXXXXXXXXXXXXXXXX|XXXXXXXX--XXXXXXXX||||||||X||X--XX|||X||||XX|XXXXXXXXXX|XXX|X|XXXXXXX--|X--||||XXXX|X||XXX|X||||-||XX||||||||XXXXXXXXXX