------------------------------------------------------------------------------------------------------------------------------------------------------
------------------------------------------------------------------------------------------------------------------------------------------------------
------------------------------------------------------------------------------------------------------------------------------------------------------
------------------------------------------------------------------------------------------------------------------------------------------------------
------------------------------------------------------------------------------------------------------------------------------------------------------
------------------------------------------------------------------------------------------------------------------------------------------------------
------------------------------------------------------------------------------------------------------------------------------------------------------
------------------------------------------------------------------------------------------------------------------------------------------------------
------------------------------------------------------------------------------------------------------------------------------------------------------
------------------------------------------------------------------------------------------------------------------------------------------------------
------------------------------------------------------------------------------------------------------------------------------------------------------
-------------------------------------------%------------------------------------------------g------------------------------------------------%--------
----------------------------------------%%-|-----------------------------%-----------------%---------------------------------------%%--------|--------
----------------------------------------||-|--------%---------%%---------|-%-------------%%|--%%%--%%%%----------------%---%%-----%||--%%%%%%|--------
%%%%%%%%%%-%%%%%%%%%%%--------%%-------%||-|-%------|---%----%||--------%|-|%%%%%%-%%%---|||--|||--||||-----%----%%%%-%|%%-||%%-%%|%%%%|||||||%-------
||||||||||X|||||||||||XXXXXXXX||XXXXXXX|XXX|-|XXXXXX|XX-|----|||XXXXXXXX||X|||||||X|||--X|||X-|||--||||X----|XXXX||||X||||-||||-||X||||||||||X|-----XX