------------------------------------------------------------------------------------------------------------------------------------------------------
------------------------------------------------------------------------------------------------------------------------------------------------------
------------------------------------------------------------------------------------------------------------------------------------------------------
------------------------------------------------------------------------------------------------------------------------------------------------------
------------------------------------------------------------------------------------------------------------------------------------------------------
------------------------------------------------------------------------------------------------------------------------------------------------------
------------------------------------------------------------------------------------------------------------------------------------------------------
------------------------------------------------------------------------------------------------------------------------------------------------------
------------------------------------------------------------------------------------------------------------------------------------------------------
------------------------------------------------------------------------------------------------------------------------------------------------------
------------------------------------------------------------------------------------------------------------------------------------------------------
------------------------------------------------------------------------------------------------------------------------SS----%-----------------------
---------------------------------------------------------------------------------%-----------%------%-------------------------|---%%----%%%%----------
--------------------------------------------------------%-%----------------------|-%-------%%|-g-%-%|%%%-------------%--------|---||----||||----------
%%%%%%%%%%%%%%%%----------------%%--------%%%%----%%%%%%|-|----------------------|-|-------|||---|%|||||---%%%%--%---|--------|%%%||----||||%%-%%-%---
||||||||||||||||XXXXXXXXXXXXXXXX||XXXXXXXX||||XX--|||||||X|-XXX-----XXXXXXXXXXXXX|X|XXX-XXX||XXXX|||||||X--||||X-|XXX|XXXXXXXX||||||----||||||-||X|XXX