------------------------------------------------------------------------------------------------------------------------------------------------------
------------------------------------------------------------------------------------------------------------------------------------------------------
------------------------------------------------------------------------------------------------------------------------------------------------------
------------------------------------------------------------------------------------------------------------------------------------------------------
-----------------------------------------------------------------------D------------------------------------------------------------------------------
------------------S-----------------------------------------------------------------------------------------------------------------------------------
------------------------------------------------------------------------------------------------------------------------------------------------------
------------------------------------------------------------------------------------------------------------------------------------------------------
------------------------------------------------------------------------------------------------------------------------------------------------------
-----------------------------------%-----------------------------------D------------------------------------------------------------------------------
-----------------------------------|------------------------------------------------------------------------------------------------------------------
------------------%----------------|--------------------------C---------------------------------------------------------------------------------------
------------------|----%%%%--%-----|---%-------%---%---------%--------%--%%%%----------------------------------------%%------%-%%-------------------%%
---------%---%%%%%|%%%%||||--|-----|---|-------|---|---------|-%-#----|--||||----------------------------------%-#---||---%%-|-||%%%%%--------------||
%%%%%%%%%|%%%||||||||||||||--|-----|---|-%-----|---|---------|-|-%%---|--||||%%--------------%------%---%-----%|%%%--||---||-|-|||||||--------------||
|||||||||||||||||||||||||||XX|XXXXX|XXX|-|XXXXX|XXX|XXXXXXXXX|X|X||XX-|X-||||||-XX--XXXXXXXX-|XXXXXX|X-X|-----|||||XX||XXXXX-|X|||||||XXXXXXXXXXXXXX||