------------------------------------------------------------------------------------------------------------------------------------------------------
------------------------------------------------------------------------------------------------------------------------------------------------------
------------------------------------------------------------------------------------------------------------------------------------------------------
------------------------------------------------------------------------------------------------------------------------------------------------------
------------------------------------------------------------------------------------------------------------------------------------------------------
------------------------------------------------------------------------------------------------------------------------------------------------------
------------------------------------------------------------------------------------------------------------------------------------------------------
------------------------------------------------------------------------------------------------------------------------------------------------------
------------------------------------------------------------------------------------------------------------------------------------------------------
------------------------------------------------------------------------------------------------------------------------------------------------------
---------------------------------------------------------------------------------%-------------------%%-----------------------------------------------
-----------------------%%%-g-------------------------%---------------------------|-------------------||----------------g----------------------%-------
--------%------%---%%--|||-----%%%-----------------%-|%-%-------------%%----%%%--|-------------------||-------%-------%----------------------%|-------
--------|------|---||%-|||-----|||-------------%%%%|%||-|-------------||-%--|||--|----------%%%%%%---||-------|-------|----------------------||-------
%%%%%%%%|------|---|||-|||-----|||-------------||||||||-|-------------||-|--|||-%|%%--------||||||%%%||-------|-------|----------------------||-------
|||||||||XXXXXX|XX-||XXXXXXXXXX|||XXXXXXXXXXXXX||||||XXX|-XXXXXXXXXXXXXXX|XX|||X||||XXXX-XX-|||||||||||XXXXXXX|XXXXXXX|XXXXXXXXXXXXXXXXXX--XX||XXXXXXX