------------------------------------------------------------------------------------------------------------------------------------------------------
------------------------------------------------------------------------------------------------------------------------------------------------------
------------------------------------------------------------------------------------------------------------------------------------------------------
------------------------------------------------------------------------------------------------------------------------------------------------------
---------------------------------------------------------------------------------------------------------------t--------------------------------------
---------------------------------------------------------------------------------------------------------------t--------------------------------------
---------------------------------------------------------------------------------------------------------------t--------------------------------------
-----------------------------------------------------------------------------%---------------------------------%--------------------------------------
-----------------------------------------------------------------------------|---------------------------------|--------------------------------------
-----------------------------------------------------------------------------|---------------------------------|--------------------------%-----------
-----------------------------------------------------------------------------|---------------------------------|---------%----------------|-----------
---------------------------------------------------%-------------------------|--------------------------------%|------t--|----------------|----------%
-----------------------------------------%---------|----------%---------%%%--|----------------------%%--------||----%-t%-|----------------|---%------|
-----------------------------------------|-%---%%%%|%%%%-----%|---------|||--%-%%-------------------||-----%%%||----|-t|-|----------------|-%-|%%-%%%|
%%%%%%%%---------------------------------|-|---||||%||||%%%-%||%--------|||--|-||---%-----%%%%%-%%--||---%%|||||%-%-|%%|-|----------------|-|-|||-||||
||||||||XXXXX-XXXXXXXXXXXXXXXXXXXXXXXXXXXXXX---||||||||||||X||||XXXXXXXX|||XX|X||XXX|X----|||||-||XX||XXX|||||X||-|X||||X|XXXXXXXXXXX-----|X|X|||X||||