------------------------------------------------------------------------------------------------------------------------------------------------------
------------------------------------------------------------------------------------------------------------------------------------------------------
------------------------------------------------------------------------------------------------------------------------------------------------------
------------------------------------------------------------------------------------------------------------------------------------------------------
----------------------------------------------------------------------------------------------D-------------------------------------------------------
------------------------------------------------------------------------------------------------------------------------------------------------------
------------------------------------------------------------%-----------------------------------------------------------------------------------------
------------------------------------------------------------|---------------------------------------------------%-----------------------%-------------
------------------------------------------------------------|---------------------------------------------------|-----------------------|-------------
------------------------------------------------------------|---------------------------------------------------|-----------------------|-------------
--------------------------------------------------%---------|---------------------------------%-----------------|-----------------------|-------------
--------------------------------------------------|---------|-----------------%%--------------|-----------------|-----------------------|-------------
----------------%--%--------%---------------------|---------|%%%%%%%%%--------||--------------|-%---------------|-----------------------|%---%%%%----%
-------------%--|--|--------|---------------------|---%-----||||||||||%%------||----------%%%-|-|-------------%-%%--------%-------------||#--||||--%%|
%%%%%%%%%%-%%|%%|--|------%-|-%-%-----------------|---|-----||||||||||||---%%-||-%%%%%%%%%|||-|-|---%--------%|-||--%%%-%-|----------%%%||%--||||--|||
||||||||||-||||||XX|X--XXX|X|X|-|XXXXXXXXXXXXXXXXX|XXX|XXXXX||||||||||||XXX||XXXX||||||||||||X|X|X--|XXX-X-XX||-||--|||X|X|XXXXXXXXXX||||||X-||||--|||