------------------------------------------------------------------------------------------------------------------------------------------------------
------------------------------------------------------------------------------------------------------------------------------------------------------
------------------------------------------------------------------------------------------------------------------------------------------------------
------------------------------------------------------------------------------------------------------------------------------------------------------
------------------------------------------------------------------------------------------------------------------------------------------------------
------------------------------------------------------------------------------------------------------------------------------------------------------
------------------------------------------------------------------------------------------------------------------------------------------------------
-------------------------------------------------------%----------------------------------------------------------------------------------------------
-------------------------------------------------------|----------------------------------------------------------------------------------------------
---------------------------------------------------%---|----------------------------------------------------------------------------------------------
--------------------------------G------------------|---|----------------------%-----------------------------------------------------------------------
--------------S-----------------%------------------|---|%---------------------|-------T---------------------------------------------------------------
-------------%-----------%------|------------%%%-%-|---||--------------%%---%%|%%-----t---------------------------------------------------------------
-------------|--%--------|------|------------|||-|-|%%-%%%%%-----------||---|||||-----t------------------------%-%--%%%%%%%-%----------------------%--
%%%%%%%%-----|--|%%----%-|------|--%%%-%-%%%%|||-|-|||-|||||--%-----%-%||---|||||%%%%%%%%-%---------%---------%|-|--|||||||-|-----%%----%----------|--
||||||||--XXX|XX|||XXXX|X|X--XXXXXX|||X|-|||||||X|X|||X|||||XX|-----|X|||XXX|||||||||||||X|XX-XXXXXX|XXXXXXXXX||X|XX|||||||XXXXXXX||XXXX|XXXXXXXXXX|XX