------------------------------------------------------------------------------------------------------------------------------------------------------
------------------------------------------------------------------------------------------------------------------------------------------------------
------------------------------------------------------------------------------------------------------------------------------------------------------
------------------------------------------------------------------------------------------------------------------------------------------------------
------------------------------------------------------------------------------------------------------------------------------------------------------
------------------------------------------------------------------------------------------------------------------------------------------------------
------------------------------------------------------------------------------------------------------------------------------------------------------
------------------------------------------------------------------------------------------------------------------------------------------------%%--%-
------------------------------------------------------------------------------------------------------------------------------------------------||--|-
----------------------------------------------------------S-------------------------------------------------------------------------------------||--|-
----------%-------------------------------------------------------------------%---------------------------------%%------------------------------||--|%
----------|----------------------%-------------------------------------%%%----|%--------------------------------||------------------------------||--||
----------|--%------%----------%-|-------------------------------------|||%---||-%%%%%--------------------------||------------------------%-%%--||--||
----------|%-|%%----|----------|-|-----------------------%-------------||||---||-|||||------------------%-------||----------%%%%%%%%%%%---|-||--||%-||
%%%%%%%%%%||-|||--%-|---------%|-|---%%%-%%-%%%%%-------%|----%%%%-%%-%||||---||-|||||-%------------%---|-------||----------|||||||||||---|%||--|||-||
||||||||||||-|||X-|X|XXXXX-XXX||X|XXX|||X||-|||||-XXXXXX|XXXX-||||X||X|XXX|XXX|XX|||||X|---XXXXXXXXX|XXX|XXXXXXX||XXXXXXX--X|||||||||||XXX||||XX|||X||