------------------------------------------------------------------------------------------------------------------------------------------------------
------------------------------------------------------------------------------------------------------------------------------------------------------
------------------------------------------------------------------------------------------------------------------------------------------------------
------------------------------------------------------------------------------------------------------------------------------------------------------
------------------------------------------------------------------------------------------------------------------------------------------------------
------------------------------------------------------------------------------------------------------------------------------------------------------
------------------------------------------------------------------------------------------------------------------------------------------------------
------------------------------------------------------------------------------------------------------------------------------------------------------
----------------------------------------------------------------------------------------------------------------------------------------%-------------
--------------------------------------------------------------------------------------------------------------%-------------------------|-------------
----------------------------------------------------------------------------------------------------------%---|-------------------------|-------------
----------------------------------------------------------------------------------------------S-----------|---|-------------------------|-------------
-----------------%%%%%%%%%%---%%%%--%%---------------------------------------------------------------%----|---|-------------------------|-------------
-----------------||||||||||---||||--||---%-----------------------------%------%----------------------|----|---|--------%%%%%%%--%%%%%%%%|%%%%--%------
%%%%%%%%%%%%%%%%%||||||||||-%%||||--||%%-|------------%----------------|------|----------%----------%|%---|---|-------%|||||||--|||||||||||||--|%%----
|||||||||||||||||||||||||||X||||||XX||||X|XXXXXXXXXXXX|XXXXXXXXXX-----X|XXXXXX|XXXXXXXXXX|XXXXXXX-XX|X|XXX|XXX|XXXXXXX||||||||XX|||||||||||||--|||XXXX