------------------------------------------------------------------------------------------------------------------------------------------------------
------------------------------------------------------------------------------------------------------------------------------------------------------
------------------------------------------------------------------------------------------------------------------------------------------------------
------------------------------------------------------------------------------------------------------------------------------------------------------
------------------------------------------------------------------------------------------------------------------------------------------------------
------------------------------------------------------------------------------------------------------------------------------------------------------
------------------------------------------------------------------S-----------------------------------------------------------------------------------
----------------------------------------------------------------------------------------------------------------------------------------------------S-
------------------------------------------------------------------------------------------------------------------------------------------------------
--------------------------------------------------t---------------------------------------------------------------------------------------------------
--------------------------------------------------T-------------%-%--------------%----------%---------------------------------------------------------
--------------------------------------------------%-------------|-|--------------|----------|-----------------------------------%----2--------------%-
--------------%-------------------%%-%%-----------|---------%%%-|-|---%-----%%-%%|-----%----|%%---------------------------------|%%---%%%%%%%%%%-%--|-
--------------|-------------------||-||-%%-%%%%%%%|-%%%--%%-|||-|-|---|-%---||-|||-----|----|||-----------------%---------------|||---||||||||||-|--|-
%%%%%%%%%----%|---------%---%%----||-||-||-||||||||-|||--||-|||-|-|---|-|---||-|||-----|----|||-----------------|---------------|||---||||||||||-|--|-
|||||||||XXXX||XXXXXXXXX|XXX||-XXX||-||X||X||||||||-|||-X||X|||-|X|---|X|-XXX|XXX|XXXXX|XXXX|||X-XXXXXXXXXXXXXXX|XXXXXXXXXXXXXXX|||--X|XXX||||||X|XX|X