------------------------------------------------------------------------------------------------------------------------------------------------------
------------------------------------------------------------------------------------------------------------------------------------------------------
------------------------------------------------------------------------------------------------------------------------------------------------------
------------------------------------------------------------------------------------------------------------------------------------------------------
------------------------------------------------------------------------------------------------------------------------------------------------------
------------------------------------------------------------------------------D-----------------------------------------------------------------------
-----------------------------------------------------------------------------------------------------------------------------------------------------%
-----------------------------------------------------------------%-----------------------------------------------------------------------------------|
-----------------------------------------------------------------|-----------------------------------------------------------------------------------|
-----------------------------------------------------------------|-----------------------------------------------------------------------------------|
--------%--------------------------------------------%-----------|-----------------------------------------------------------------------------------|
--------|-------%------------------------------------|%%%%-------|------------%---%-----%%-----------------------------------------------------------|
--------|-------|-------------------------------%%2-%|||||-------|------------|--%|-----||------------------------------------%%------------------%%%|
--------|-------|--------------%%%--------------||--||||||---%--%|----------%-|--||----K||------------------------------------||------%%----------||||
%%%%%%%%|%%%%%%-|%%%----%%----%|||----%---------||--||||||---|--||----------|-|y-||----%||----%%%%%%----------------------%%--||--%---||----------||||
|||||||||||||||X||||XXXX||-XXX|XXXXXXX|XXXXXXXXXXXX-||XXXXXXX|XX||XXXXXXXXXX|X|XXX|XXXX|||XXXX||||||XXXXXXXXXXXXXXXXXXXXXX||XX||XX|-XX||XXXXXXXXXX||||