------------------------------------------------------------------------------------------------------------------------------------------------------
------------------------------------------------------------------------------------------------------------------------------------------------------
------------------------------------------------------------------------------------------------------------------------------------------------------
------------------------------------------------------------------------------------------------------------------------------------------------------
------------------------------------------------------------------------------------------------------------------------------------------------------
------------------------------------------------------------------------------------------------------------------------------------------------------
------------------------------------------------------------------------------------------------------------------------------------------------------
------------------------------------------------------------------------------------------------------------------------------------------------------
------------------------------------------------------------------------------------------------------------------------------------------------------
------------------------------------------------------------------------------------------------------------------------------------------------------
-------------------------------------------------------------------------------------------------------------------------t---------%------------------
-----------------------------S----------------------%--------------------------------------------------------------------t---------|------------------
--------------------------%%%-%%%%%%-%--%%-%--------|----------%---%%%%%%%%------------------------%%%--%%%%-%------%%---t---------|-----------%%--%%-
--------------------------|||-||||||%|--||-|%%%%%%%%|%%%%%%%---|---||||||||------------------------|||--||||-|--%---||---t---------|-----------||--||-
%%%%%%%%%%%%%%%%----------|||-||||||||--||%|||||||||||||||||%--|---||||||||%-%-%%%-%---%--%%%--%---|||--||||-|-%|---||-%%%%--------|-----------||--||%
||||||||||||||||-XXXXXXXXX|||X||||||||XX|||||||||||||||||||||XX|---|||||||||-|X|||X|X-X|-X|||X-|XXX|||X-||||X|-||---||X||||XXXXXXXX|XXXXXXXXXXX||XX|||