------------------------------------------------------------------------------------------------------------------------------------------------------
------------------------------------------------------------------------------------------------------------------------------------------------------
------------------------------------------------------------------------------------------------------------------------------------------------------
------------------------------------------------------------------------------------------------------------------------------------------------------
------------------------------------------------------------------------------------------------------------------------------------------------------
------------------------------------------------------------------------------------------------------------------------------------------------------
------------------------------------------------------------------------------------------------------------------------------------------------------
---------------%--------------------------------------------------------------------------------------------------------------------------------------
---------------|-----------------------------------------------------------%--------------------------------------------------------------------------
---------------|-----------------------------------------------------------|--------------------------------------------------------------------------
---------------|----------%------------------------------------------------|---------------%----------------------------------------------------------
---------------|----------|------------------------------------------------|%--------------|----------------------------------------------------------
---------------|---------%|%%%---------------------%%%--%------------------||----------%-%%|%%----------------------%-----%--------------------%%%-%-%
---------%%%%--|%%%%%%%%%|||||----%--%%----g-------|||--|--------%-----%%%-|%----------|-|||||-------------%--------|-----|----------2---------|||-|-|
%%%%%%%%-||||%%|||||||||||||||----|--||------------|||--|--------|-----|||-||----------|-|||||------------%|--------|%----|---------------%----|||-|-|
||||||||X|||||||||||||||||||||XXXX|XX||XXXX-XXX-XXX|||XX|XXXXXXXXXXXXXXXXX-|XXXXXXXXXXX|X|||||XXXXXXXXXXXX||XXXXXXXX||-XXX|XXXXXXXXXXXXXXX|XXXX|||-|X|