------------------------------------------------------------------------------------------------------------------------------------------------------
------------------------------------------------------------------------------------------------------------------------------------------------------
------------------------------------------------------------------------------------------------------------------------------------------------------
------------------------------------------------------------------------------------------------------------------------------------------------------
------------------------------------------------------------------------------------------------------------------------------------------------------
------------------------------------------------------------------------------------------------------------------------------------------------------
------------------------------------------------------------------------------------------------------------------------------------------------------
------------------------------------------------------------------------------------------------------------------------------------------------------
------------------------------------------------------------------------------------------------------------------------------------------------------
-----------------------------------------------------------------------------------%------------------------------------------------------------------
---------------%%%%%---------------------------------------------------------------|-%----------------------------------------------------%-----------
---------------|||||---------------------------------------------------------------|-|---------------------------------------%------------|-----------
---------------|||||----------------------------------%----------------------------|%|--%%%%%%-%%%%%-------------------------|------------|-----------
---------------|||||----------------------------%--%%%|-------------%----%%%%%%%%--|||--||||||-|||||%%%%---%%%--%%%%%%%%-%---|------------|-----%----%
%%%%%%%%%------|||||%----%%%%-----%%------%%-%%-|-%||||-------------|----||||||||--|||--||||||-|||||||||-%%|||--||||||||-|---|------------|-----|%---|
|||||||||XXX---||||||X-XX||||XXXX-||XXXXXX||X||-|-|||||--XXXXXXXXXXX|XXXX||||||||--|||XX||||||-|||||||||X|||||XX||||||||X|XXXXXXXXXXXXXXXX|XXXXXX|XXXX