------------------------------------------------------------------------------------------------------------------------------------------------------
------------------------------------------------------------------------------------------------------------------------------------------------------
------------------------------------------------------------------------------------------------------------------------------------------------------
------------------------------------------------------------------------------------------------------------------------------------------------------
------------------------------------------------------------------------------------------------------------------------------------------------------
------------------------------------------------------------------------------------------------------------------------------------------------------
------------------------------------------------------------------------------------------------------------------------------------------------------
------------------------------------------------------------------------------------------------------------------------------------------------------
---------------------------------------------------------%--------------------------------------------------------------------------------------------
---------------------------------------------------------|--------------------------------------------------------------------------------------C-----
---------------------------------------------------------|-------------------------------------%------%%----------------------------------------------
---------------------------------------------------------|-------------------------------------|------||----------------------------------------------
-------------%%------%-----%-------------%---%%-%%-%%--%-|-------------------------------------|------||-------------------%-%----------%------------%
-------------||---%--|-----|-%-----------|---||-||-||--|-|%%%%%%%---------%%-------------------|------||-------------------|-|----------|--%---%%%%--|
%%%%%%%%%%%%-||---|%-|-----|%|%-%%%-%%--%|---||-||-||-%|%||||||||--%%%%%-%||------------%%%%%%-|%-%%%%||-------------------|-|----------|--|---||||--|
||||||||||||-||XXX||-|XXXXX||X|X|||X||XX||XX-||X||-||-|||||||||||XX|||||X|||XXXXXXXXXXXX||||||X||X||||||XXXXXXXXX-XXXXXXXXX|X|XXXXXXXXXXX-X|XX-||||X-|