------------------------------------------------------------------------------------------------------------------------------------------------------
------------------------------------------------------------------------------------------------------------------------------------------------------
------------------------------------------------------------------------------------------------------------------------------------------------------
------------------------------------------------------------------------------------------------------------------------------------------------------
------------------------------------------------------------------------------------------------------------------------------------------------------
------------------------------------------------------------------------------------------------------------------------------------------------------
------------------------------------------------------------------------------------------------------------------------------------------------------
---------------------------------------%--------------------------------------------------------------------------------------------------------------
---------------------------------------|--------------------------------------------------------------------------------------------------------------
---------------------------------------|--------------------------------------------------------------------------------------------------------------
---------------------------------------|------------------------------------------------------------------%-------------------------------------------
---------------------------------------|------------------------------------------------------------------|-----------%-------------------------------
---------------------------------------|%%%%-%------------------------------------------------------------|----%------|--------------K------------%---
-------------------%%%%-------%-%%%%%--|||||-|--%---------------------------g--------------%%%%%%%--%%----|----|%-----|------------%%%%%%-----%---|---
%%%%%%%%-----------||||-------|-|||||--|||||-|%%|----------------------------%--------%%---|||||||--||----|----||-----|------------||||||-----|---|---
||||||||XXXXXXXXXXX||||XXXXXXX|X|||||X-|||||X||||XXXXXXXXXXXXXXXXXXXXXXXXXXX-|X----X--||---|||||||-X||XXXX|-XXX||XXX-X|XXXXX---XXX-||||||XXXX-|XXX|XXX