------------------------------------------------------------------------------------------------------------------------------------------------------
------------------------------------------------------------------------------------------------------------------------------------------------------
------------------------------------------------------------------------------------------------------------------------------------------------------
------------------------------------------------------------------------------------------------------------------------------------------------------
------------------------------------------------------------------------------------------------------------------------------------------------------
------------------------------------------------------------------------------------------------------------------------------------------------------
--------------------------------------------------------------------------------------------------------------------------------------%---------------
--------------------------------------------------%-----------------------------------------------------------------------------------|------DD-------
--------------------------------------------------|-----------------------------------------------------------------------------------|---------------
-----------------------------------------------%--|-----------------------------------------------------------------------------------|---------------
-----------------------------------------------|--|----------------------------------------%------------------------------------------|---------------
-----------------------------------------------|--|--------------------------------%-------|-g----------------------------------------|---------------
--------------------%-%------------------------|--|%%--%---------------%-----------|------%|-%%%--%%-%%%--------------%---------------|---------------
-----------------%%-|-|%%----------%-----------|--|||%%|%%%%%----------|-----------|------||%|||--||-|||--------------|----%%%--------|-----%%%-------
%%%%%%%%%%%%%%--%||-|-|||-%%%%%%---|-----------|--|||||||||||%-%%------|------%%%%%%%%%%%%||||||--||-|||--------------|----|||%-%-----|-----|||-------
||||||||||||||XX|||-|X|||X||||||XXX|XXXXXXXXXXX|XX||||||||||||-||XXXXXX|XXXXXX||||||||||||||||||XX||X|||XX-X-XXXXXXXXX|X--X||||X|XXXX-|XXXXX|||XXXXXXX