------------------------------------------------------------------------------------------------------------------------------------------------------
------------------------------------------------------------------------------------------------------------------------------------------------------
------------------------------------------------------------------------------------------------------------------------------------------------------
------------------------------------------------------------------------------------------------------------------------------------------------------
------------------------------------------------------------------------------------------------------------------------------------------------------
------------------------------------------------------------------------------------------------------------------------------------------------------
------------------------------------------------------------------------------------------------------------------------------------------------------
------------------------------------------------------------------------------------------------------------------------------------------------------
------------------------------------------------------------------------------------------------------------------------------------------------------
------------------------------------------------------------------------------------------------------------------------------------------------------
--------------------------------------------------------------------------%---------------------------------------------------------------------------
--------------------------------------------------------------------------|--------------------------------------%------------------------------------
-------------------------------------%-%------------%%%-------------------|---------%--%%--%%--------------------|%----------------------------------%
---------------------%---------------|-|------------|||----%%-------------|-%%--%%%-|--||%-||----%-------------%-||----------------------------------|
%%%%%%%%%%--%%%-%%%%-|%%%%-----------|-|------------|||----||---------%%%%|%||--|||-|--|||-||----|-%%%%--%%----|-||%%----------%%-%%%----------------|
||||||||||--|||-||||-|||||XXXXXXXXXXX|X|XXXXXXXXXXXX|||-XX-||XXXXXXXXX||||||||-X|||X|--|||X||X---|X||||XX||XXXX|XX|||XXXXXXXXXX||-|||XXXXXXXXXXXXXXXX|