------------------------------------------------------------------------------------------------------------------------------------------------------
------------------------------------------------------------------------------------------------------------------------------------------------------
------------------------------------------------------------------------------------------------------------------------------------------------------
------------------------------------------------------------------------------------------------------------------------------------------------------
------------------------------------------------------------------------------------------------------------------------------------------------------
------------------------------------------------------------------------------------------------------------------------------------------------------
---------------------------------------------------------------------------------------------------------------------%-%------------------------------
---------------------------------------------------------------------------------------------------------------------|-|------------------------------
-----------------------C---------------------------%-----------------------------------------------------------------|-|------------------------------
---------------------------------------------------|-----------------------------------------------------------------|-|------------------------------
---------------------------------------------------|-----------------------------------------------------------------|-|------------------------------
---------------------------------------------------|------%--------------------------------------C-------------------|-|------------------------------
------------%--------%%%%%%----%%%-----------------|------|---%--------------------------%------------------%--------|-|---------%%%%-----------------
------------|-------%||||||----|||-----------------|------|---|--------------------------|%%%%--%-%---------|--------|-|---%-t---||||-----------------
%%%%%%%%%%%%|%%%%%%%|||||||----|||----------%-----%|------|---|--------------------------|||||%-|-|--------%|--------|-|%--|%t---||||-----------%%%%%%
|||||||||||||||||||||||||||X---|||X-XXXXXXXX|XXXXX||XXXXXXXXXX|-XXXXXXXXXXXXXXXXXXXXXXXXX||||||-|X|XXXXXXXX||XX-XXXXX|X||X-||XXXX||||XXXX-XXXXXX||||||