------------------------------------------------------------------------------------------------------------------------------------------------------
------------------------------------------------------------------------------------------------------------------------------------------------------
------------------------------------------------------------------------------------------------------------------------------------------------------
------------------------------------------------------------------------------------------------------------------------------------------------------
------------------------------------------------------------------------------------------------------------------------------------------------------
------------------------------------------------------------------------------------------------------------------------------------------------------
------------------------------------------------------------------------------------------------------------------------------------------------------
------------------------------------------------------------------------------------------------------------------------------------------------------
---------------------------------------------------------------------------r---------k----------------------------------------------------------------
----------------%-------------------------------------------------------------------------------------------------------------------------------------
----------------|----------------------%------%-----------------%---%%---------------%---------------------------%------------------------------------
----------------|----------------------|------|-----------------|---||---------------|-----------------%---------|------------------------------------
---------------%|%---------------------|------|U----------------|---||----------%%%%%|-%%------%---%-%%|%%--%---%%K-------%%--------------------------
------------%%%|||%%%%%-%%---%---------|---%--|-----------------|---||----------||||||%||--%%%-|---|-|||||--|-%-||U-------||---%%-%%------------------
%%%%%%%%--%%|||||||||||-||---|---------|---|%-|---------------%%|%%%||------%---|||||||||-%|||%|%%-|-|||||--|-|-||--------||---||-||-%%%%---%%--------
||||||||--|||||||||||||X||XXX|XXXXXXXXX|XX-||-|XXXXXXXXXXXXXXX||||||||XXX---|XXX|||||||||-||||||||X|X|||||XX|-XX||XXXXXXXX||XXX||-||X||||XXX||XXXXXXXX