------------------------------------------------------------------------------------------------------------------------------------------------------
------------------------------------------------------------------------------------------------------------------------------------------------------
------------------------------------------------------------------------------------------------------------------------------------------------------
------------------------------------------------------------------------------------------------------------------------------------------------------
------------------------------------------------------------------------------------------------------------------------------------------------------
------------------------------------------------------------------------------------------------------------------------------------------------------
-----------------------------------------------------------------------------------------------------------------------%------------------------------
-----------------------------------------------------------------------------------------------------------------------|------------------------------
-----------------------------------------------------------------------------------------------------------------------|------------------------------
-----------------------------------------------------------------------------------------------------------------------|------------------------------
-----------------------------------------------------------------------------------------------------------------------|------------------------------
-----------------------------------------------------------------------C-----------------------------------------------|------------------------------
-------------%%%-------------------------------------------%-------%%--------%-----------%-----------------------------|------------------------------
-------------|||------%---------%----------------%---------|-------||--------|-----------|---------%%-%%%%%%%%---------|--------------%-%%%%-%--------
%%%%%%%%%----|||------|-%%------|--%%%%-------%--|---------|%------||%%------|-----------|---%-----||-||||||||---------|--------%-----|-||||-|--------
|||||||||XXX-|||X--XXX|X||XXXXX-|XX||||XXXXXXX|XXXXXX-XXXXX||XXX-XX||||X-XXXX|-XXXXXXXXXX|XXX|XXXX-||-||||||||XXXXXXXXX|XXXXXXXX|XXXXX|X||||X|----XXXX