------------------------------------------------------------------------------------------------------------------------------------------------------
------------------------------------------------------------------------------------------------------------------------------------------------------
------------------------------------------------------------------------------------------------------------------------------------------------------
------------------------------------------------------------------------------------------------------------------------------------------------------
------------------------------------------------------------------------------------------------------------------------------------------------------
------------------------------------------------------------------------------------------------------------------------------------------------------
------------------------------------------------------------------------------------------------------------------------------------------------------
------------------------------------------------------------------------------------------------------------------------------------------------------
------------------------------------------------------------------------------------------------------------------------------------------------------
------------------------------------------------------------------------------------------------------------------------------------------------------
------------------------------------------------------------------------------------------------------------------------------------------------------
---------------------------------------------------------------------------------------------------------------------------------%--------------------
-----------------------------------------%-------------------------%------%-----------------------%%%%%%%%%%--------%%-----%%%---|-%------------------
--------%-------------%----------%%------|-------------------------|------|-------------%%-----%--||||||||||--------||-----|||---|-|------------------
%%%%%%%%|%%%%----%%%%%|%%%%------||-%%---|------------------------%|------|--------%----||-----|-%||||||||||--------||-%%--|||-%%|-|------------------
|||||||||||||-X--||||||||||-XXXXX||X||XXX|XX-XXXXXXXXXXXXXXXXXXXXX||XXXXXX|XXXXXXXX|XXXXXX---XXXX|||||||||||XXXXXX--||X||XX|||X|||X|XXXXXXXXXXXXXXXXXX