------------------------------------------------------------------------------------------------------------------------------------------------------
------------------------------------------------------------------------------------------------------------------------------------------------------
------------------------------------------------------------------------------------------------------------------------------------------------------
------------------------------------------------------------------------------------------------------------------------------------------------------
------------------------------------------------------------------------------------------------------------------------------------------------------
------------------------------------------------------------------------------------------------------------------------------------------------------
------------------------------------------------------------------------------------------------------------------------------------------------------
------------------------------------------------------------------------------------------------------------------------------------------------------
------------------------------------------------------------------------------------------------------------------------------------------------------
------------------------------------------------------------------------------------------------------------------------------------------------------
-------------------------%----------------------------------------------------------------------------------------------------------------------------
-------------------------|----------------------------------------------------------------S%----------------------------------------------------------
-------------%-----------|----------%-----%%-----------------------------------------------|------------------%%%----------------%-%%%-%%%%%%-%%%-----
-------------|----------%|----%%%%%-|%-%%%||%%%%%%--%--------------%-----------------------|------%----%---%--|||----------------|%|||-||||||-|||-----
%%%%%%%%%%%--|%%----%%%%||----|||||-||-|||||||||||%%|%-%%-%---%%---|----%%%%-%---------%---|------|%---|---|--|||----------------|||||-||||||-|||--%%-
|||||||||||XX|||XXXX||||||-X-X|||||-||-|||||||||||||||X||-|XXX||X-X|XXXX||||X|XXXXXXXXX|XXXX--XXXX||XXX|XXX|--|XXXXXXXXXXXXXXXXXX|||||-||||||X|||XX||-