------------------------------------------------------------------------------------------------------------------------------------------------------
------------------------------------------------------------------------------------------------------------------------------------------------------
------------------------------------------------------------------------------------------------------------------------------------------------------
------------------------------------------------------------------------------------------------------------------------------------------------------
------------------------------------------------------------------------------------------------------------------------------------------------------
----------------------------------------------------------------------%-------------------------------------------------------------------------------
----------------------------------------------------------------------|-------------------------------------------------------------------------------
----------------------------------------------------------------------|-------------------------------------------------------------------------------
----------------------------------------------------------------------|-------------------------------------------------------------------------------
----------------------------------------------------------------------|-------------------------------------------------------------------------------
-----------------------------------------------------------------%----|----------%----%%%-------------------------------------------------------------
-----------------------------------------------------------------|----|----------|----|||-------------------------------------------------------------
-----------%---------------------------------------%%--------%%%%|----|---------%|----|||---------------------%%%%%%---%-%%---------------------------
-----------|%%%%%%----------%%%%-------------------||--------|||||----|%%%%%%---||----|||--%%%%---------------||||||---|-||---------------------------
%%%%%%%%%%-|||||||----------||||--------------%----||%%%--%--|||||----|||||||---||---%|||--||||%--------------||||||---|-||----------%----------------
||||||||||X|XXXXXX--XXXXX--X||||XXXXXXXXXXXXXX|XXXXXX|||--|XX|||||XXXX|||||||X--||--X||||X-|||||X-XXXXXXXXXXXX||||||XXX|X||XXXXXXXXXX|XXXXXXXXXXXXXXXX