------------------------------------------------------------------------------------------------------------------------------------------------------
------------------------------------------------------------------------------------------------------------------------------------------------------
------------------------------------------------------------------------------------------------------------------------------------------------------
------------------------------------------------------------------------------------------------------------------------------------------------------
------------------------------------------------------------------------------------------------------------------------------------------------------
------------------------------------------------------------------------------------------------------------------------------------------------------
----------------------------------------------------------------%-------------------------------------------------------------------------------------
----------------------------------------------------------------|-------------------------------------------------------------------------------------
----------------------------------------------------------------|-------------------------------------------------------------------------------------
----------------------------------------------------------------|-------------------------------------------------------------------------------------
-------------------------%----------------------%---------------|-------------------------------------------------------------------------------------
-----------------G-------|-------------%%-------|---------------|-------------------------------------------------------------------------------------
----------------%%-------|%%%----------||%%-----|%--%----%%%----|--------------------%------%%%%%--%---------%%---------------------------------------
----------------||-----%-||||----------||||-----||--|%%--|||----|%------------------%|------|||||--|---------||-----------------------%---------------
%%%%%%%%%%%-----||-----|-||||---%%%%%%%||||%%%%%||--|||--|||-%--||-%%%----%%%%%%%%--||------|||||--|--%------||---%-------------------|-%-------------
|||||||||||-XX--||XXXXX|X||||-XX||||||||||||||||||XX|||XXXXXX|XX|XX|||XXXX||||||||XX||XXXXX-|||||XX|XX|XXXXXX||XXX|XXX-XXXXXXXXXXXXXXX|X|XXXX---XXX-X-