------------------------------------------------------------------------------------------------------------------------------------------------------
------------------------------------------------------------------------------------------------------------------------------------------------------
------------------------------------------------------------------------------------------------------------------------------------------------------
------------------------------------------------------------------------------------------------------------------------------------------------------
------------------------------------------------------------------------------------------------------------------------------------------------------
------------------------------------------------------------------------------------------------------------------------------------------------------
------------------------------------------------------------------------------------------------------------------------------------------------------
------------------------------------------------------------------------------------------------------------------------------------------------------
--------------------------------------------------------------------------------k---------------------------------------------------------------------
--------------------------------------------------------------------%%------------------------------D-----------------------------------%-------------
--------------------------------------------------------------------||----------%-------------------------------------------------------|-------------
----------------------------%---------------------------------------||----------|-------------------------------------%%%---------------|%------------
--------%------------------%%-------%----%--%--------------------%--||----%%----|------------%%%%%---------------%----|||---------------||--%---------
--------|------------------||-------|----|--|--------------------|--||----||----|------------|||||%--%%%%%-------|----|||----%----------||--|---------
%%%%%%%%|%%%%%%%-----------||-------|----|--|------%-------------|%%||----||----|-----------%||||||--|||||-------|----|||----|----------||--|---------
||||||||||||||||XXXXXXX-XXX||XXX-XXX|XXXX|XXXXXXXXX|XXXXXXXXXXXXX|||||XXXX||XXXX|---XXXXXXXX|||||||XX|||||XXXXXXX|XXXXXXXXXXX|XXXXXXXXXX|XXX|-XXXXXXXX