------------------------------------------------------------------------------------------------------------------------------------------------------
------------------------------------------------------------------------------------------------------------------------------------------------------
------------------------------------------------------------------------------------------------------------------------------------------------------
------------------------------------------------------------------------------------------------------------------------------------------------------
------------------------------------------------------------------------------------------------------------------------------------------------------
------------------------------------------------------------------------------------------------------------------------------------------------------
------------------------------------------------------------------------------------------------------------------------------------------------------
------------------------------------------------------------------------------------------------------------------------------------------------------
------------------------------------------------------------------------------------------------------------------------------------------------------
---------%--------------------------------------------------------------------------------------------------------------------------------------------
---------|--------------------------------------------------------------------------------------------------------------------------------------------
---------|--------------------------------------------------------------------------------------------------------------------------------------------
---------|%%----%%%--------------------------------------%--------------------%-------------#-----------------------------------%---%%----------------
--------%|||----|||----------------------%-------%--%%%%%|%-%%%-%%%%%%-%-%-%%%|%-----%%-----%%-----------%---------------------%|---||%%--------%%----
%%%%%%%%||||----|||--%%%%%%%%%%%%%%------|-------|--|||||||-|||-||||||-|-|-|||||-%---||-----||-%---------|---------%-------%---||---||||%-------||----
||||||||||X|-XXX|||--||||||||||||||XXXXXX|XX-XXXX|--|||||||-|||X||||||X|X|X|||||-|---||XXXXX||X|XXXXXXXXXX-X-XXXXXX|XXX--X-|XXX||XXX|X|||XXXXXXX||X---