------------------------------------------------------------------------------------------------------------------------------------------------------
------------------------------------------------------------------------------------------------------------------------------------------------------
------------------------------------------------------------------------------------------------------------------------------------------------------
------------------------------------------------------------------------------------------------------------------------------------------------------
------------------------------------------------------------------------------------------------------------------------------------------------------
------------------------------------------------------------------------------------------------------------------------------------------------------
------------------------------------------------------------------------------------------------------------------------------------------------------
------------------------------------------------------------------------------------------------------------------------------------------------------
------------------------------------------------------------------------------------------------------------------------------------------------------
------------------------------------------------------------------------------------------------------------------------------------------------------
------------------------------------------------------------------------------------------------------------------------------------------------------
----------------------------------------------------------------------------------------%S-----------------------------------------%------------------
---------------------------------------------------------------------------------%------|-%------------------------------------%-%-|--%---%-----------
------------------------%%%%%%-%--%%%%%%%-%%%%%%%%%%%%%%--%----------------------|--%---|-|-----------------------------------%|-|-|--|---|-----------
%%%%%%%%%%%%%%%%%%%%----||||||%|--|||||||-||||||||||||||--|-------------%%%------|--|-%%%-|-------------%%----------%------%-%||%|-|%%|%%%|%%--%%%%--%
||||||||||||||||||||----||||||||XX|||||||X||||||||||||||XX|XXXXXXXXXXXXX|||----XX|XX|X|||X|--XXXXXXXXXXX||-XXXXXXXXX|-X-XXX|X|||||X||||||||||--||||XX|