------------------------------------------------------------------------------------------------------------------------------------------------------
------------------------------------------------------------------------------------------------------------------------------------------------------
------------------------------------------------------------------------------------------------------------------------------------------------------
------------------------------------------------------------------------------------------------------------------------------------------------------
------------------------------------------------------------------------------------------------------------------------------------------------------
------------------------------------------------------------------------------------------------------------------------------------------------------
----------------------------------------------------------------------------------------------------------------------------------------------S-------
------------------------------------------------------------------------------------------------------------------------------------------------------
------------------------------------------------------------------------------------------------------------------------------------------------------
------------------------------------------------------------------------------------------------------------------------------------------------------
-----------%--------------------------------------------------C-------------------------------------------------------------------------------%-------
----------%|----------%-----------------------------------------%------------------------------------%----------------------------------------|---%%%%
----------||--------%%|--------------------------------%-%%-----|------------------------------------|------------------------------------%%--|%%-||||
--------%-||-----%--|||--------------------------------|-||-----|--%%--%%----------------------------|----K--%----------%---%-----%%--%%--||--|||%||||
%%%%%%%%|%||%%%%%|--|||----------------------%%%%%%%%%%|%||%%%%%%-%||--||---------------------%%---%-|-%--%%%|--%%------|---|-----||-%||--||--||||||||
||||||||||||||||||-X||XXXXXXXXXXXXXXXXXXXXXXX||||||||||||||||||||X|||X-||XXXXXXXXXXXXXXXXXXXXX||X-X|X|X|XX||||XX||---XXX|XXX|XXXX-||X|||XX||XX||||||||