------------------------------------------------------------------------------------------------------------------------------------------------------
------------------------------------------------------------------------------------------------------------------------------------------------------
------------------------------------------------------------------------------------------------------------------------------------------------------
------------------------------------------------------------------------------------------------------------------------------------------------------
------------------------------------------------------------------------------------------------------------------------------------------------------
------------------------------------------------------------------------------------------------------------------------------------------------------
--------------------------------------------------------S---------------------------------------------------------------------------------------------
------------%-----------------------------------------------------------------------------------------------------------------------------------------
------------|-----------------------------------------------------------------------------------------------------------------------------------------
------------|-----------------------------------------------------------------------------------------------------------------------------------------
------------|-------------------------------------------%---------------------------------------------------------------------------------------%-----
------------|-------------------------------------------|-----%-----------------------------C---------------------------------------------------|-----
------------|-------------------------------------------|-----|-------%%---%----------------%-%-------------------------------------------------%%%%--
------------|------%%-------%%%%%-%---%%%-----%---------|----%|%%-----||---|%%---%-----%----|%|-------------------------------------------------||||--
%%%%%%%%%%%%|%%%%%-||-------|||||-|%%%|||-----|---------|----||||-----||---|||---|-----|----|||%%%%%%%%%%%-%%-------------------%-%-------------||||--
||||||||||||||||||X||XXXXXXX|||||X|||||||XXXXX|--XX-XXXX|XXXXXXXXXXXXX||--X|||XXX|XXXXX|XXXXX|||||||||||||X||-XXXXXXXXXXXXXXX-XX|X|XXXXXXXXXXX-X||||XX