------------------------------------------------------------------------------------------------------------------------------------------------------
------------------------------------------------------------------------------------------------------------------------------------------------------
------------------------------------------------------------------------------------------------------------------------------------------------------
------------------------------------------------------------------------------------------------------------------------------------------------------
------------------------------------------------------------------------------------------------------------------------------------------------------
------------------------------------------------------------------------------------------------------------------------------------------------------
------------------------------------------------------------------------------------------------------------------------------------------------------
------------------------------------------------------------------------------------------------------------------------------------------------------
------------------------------------------------------------------------------------------------------------------------------------------------------
----------------------------------------------------%-------------------------------------------------------------------------------------------------
----------------------------------------------------|--%----------------------------------------------------------------------------------------------
-----------------%----------------------------------|--|---------------------------------------------------------g---------S--------------------------
-----------------%-%---------------------------%----|--|------------------------------%---%----------%------%---%--------------------------------%%---
----------%%--%%%|%|--%%--%%-------------------|----|--|----%------------------G----%%|--%|----------|-----%|%%%|-%-%%-%-----------------------%-||---
%%%%%%%%-%||--||||||--||--||-------%--%-%%%%%%%|----|--|-%--|%%%---%---------%-%----|||--||%-%%%%-%--|-----||||||-|-||-|--------------%%-------|-||---
||||||||-|||--|||X||XX||X-||-XXX---|--|X|||||||X--XX|XX|X|-X||||X--|--XXXXXXX|X|XXXXXX|XX|||X||||X|XX|-XXXX||||||X|X||X|XXXXXX-XXXXXXX||XXXXXXX|X||---