------------------------------------------------------------------------------------------------------------------------------------------------------
------------------------------------------------------------------------------------------------------------------------------------------------------
------------------------------------------------------------------------------------------------------------------------------------------------------
------------------------------------------------------------------------------------------------------------------------------------------------------
------------------------------------------------------------------------------------------------------------------------------------------------------
------------------------------------------------------------------------------------------------------------------------------------------------------
------------------------------------------------------------------------------------------------------------------------------------------------------
------------------------------------------------------------------------------------------------------------------------------------------------------
------------------------------------------------------------------------------------------------------------------------------------------------------
-------------------------------*----------------------------------------------------------------------------------------------------------------------
-------------------------------*----------------------------------------------------------------------------------------------G-----------------------
-------------------------------*---------------------------------------------------------------------------------------------%%-----------------------
----------%--------------%-----*-------------------------------------------------------------------------%-------------------||-----------------------
----------|--------------|-----%--------------%---------------------------------------%%%--------%%---%--|%--%%%--%%%%%%%%%%-||---------------%%%----%
%%%%%%%%%%|--------------|-----|--------------|--%%%%%%-%%%%--------------------------|||-%--%%%-||---|--||--|||%-||||||||||%||---------------|||--%-|
|||||||||||XXXXXXXXXXXXXX|XXXXX|XXXXXXXXXXXXXXXXX||||||-||||X---XXXXXXXXXXXXXXXXXXXXXX|||X|--|||X||XXX|XX||X-||||-|||||||||||XXXXXX-XXXXXXXXXX|||XX|X|