------------------------------------------------------------------------------------------------------------------------------------------------------
------------------------------------------------------------------------------------------------------------------------------------------------------
------------------------------------------------------------------------------------------------------------------------------------------------------
------------------------------------------------------------------------------------------------------------------------------------------------------
------------------------------------------------------------------------------------------------------------------------------------------------------
------------------------------------------------------------------------------------------------------------------------------------------------------
------------------------------------------------------------------------------------------------------------------------------------------------------
------------------------------------------------------------------------------------------------------------------------------------------------------
------------------------------------------------------------------------------------------------------------------------------------------------------
------------------------------------------------------------------------%-----------------------------------------------------------------------------
------------------------------------------------------------------------|-----------------------------------------------------------------------------
-----------------------------------------------------------------%------|--2-----------------------------------F--------------------------------------
-----------------------------------------%%%---------------------|-%----|-------%-%%------------------%%%%---%-%-%------------------------------------
---------%%%%%-%%%%------%------%%%%%---%|||--%---%%-%%%%%-------|-%%---|---%%--|-||-------%%------%%%||||---|-|-|-----%%------%---%-------------%---%
%%%%%%%%%|||||-||||------|------|||||---||||-%|---||%|||||-------|-||%--|%--||-%|-||-------||------|||||||%--|-|-|-----||------|%--|---%%-%------|---|
||||||||||||||-||||XXXXXX|XXXXXX|||||XXX||||X||---X|||||||--XXXXX|XX||XX||XX||X||-||XX-XXXX||XXXXXX||||||||XX|XXX|XXXXX||XXXXXX||XX|XXX||X|XXXXXX|XXX|