------------------------------------------------------------------------------------------------------------------------------------------------------
------------------------------------------------------------------------------------------------------------------------------------------------------
------------------------------------------------------------------------------------------------------------------------------------------------------
------------------------------------------------------------------------------------------------------------------------------------------------------
------------------------------------------------------------------------------------------------------------------------------------------------------
------------------------------------------------------------------------------------------------------------------------------------------------------
------------------------------------------------------------------------------------------------------------------------------------------------------
------------------------------------------------------------------------------------------------------------------------------------------------------
------------------------------------------------------------------------------------------------------------------------------------------------------
------------------------------------------------------------------------------------------------------------------------------------------------------
-------------------------------------------------%----------------------------------------------------------------------------------------------------
----------------------------------------------%--|----------------------------------------------------------------------------------------------------
---------------------%--%%%%%-------%----%%%%-|--|---%---%---------------%-------------------------------------------------%-%-%%-----------------%%%-
---------------------|--|||||----%--|----||||-|--|---|-%%|--%-%%%%--%%%%-|F%%%%%%%%%--%%%%-%%%%%%%%%%%%%%---%---%---------%|%|-||-------%%%%%%%%%%|||%
%%%%%%%%%--%---------|--|||||----|--|----||||-|--|---|-|||--|-||||--||||-|%|||||||||--||||-||||||||||||||---|---|---------||||-||-----%%||||||||||||||
|||||||||XX|XXXXXXXXXX--|||||XXXX|XX|XX--||||-XXX|XX-XX||X--|-||||X-||||-|||||||||||X-||||X||||||||||||||--X|---|---XX-XXX||X|X||XXXXX||||||||||||||||