------------------------------------------------------------------------------------------------------------------------------------------------------
------------------------------------------------------------------------------------------------------------------------------------------------------
------------------------------------------------------------------------------------------------------------------------------------------------------
------------------------------------------------------------------------------------------------------------------------------------------------------
------------------------------------------------------------------------------------------------------------------------------------------------------
------------------------------------------------------------------------------------------------------------------------------------------------------
--------------------------------%---------------------------------------------------------------------------------------------------------------------
--------------------------------|---------------%-----------------------------------------------------------------------------------------------------
--------------------------------|---------------|-----------------------------------------------------------------------------------------------------
--------------------------------|------%--------|----------------------------------------------------------------------------------%------------------
--------------------------------|------|--------|---------------------------------------------%------------------------------------|------------------
--------------------------------|------|-----%--|---------------------------------------------|------------------------------------|------------------
--------------------%-----------%---%%%|-----|%-|%%%%%---------%-%%%--------------------------|------------------------%-----------|----------%%%-%%--
----------------%%-%|-%%--%%%-%-|%--||||-----||-%|||||---------|%|||--------------------------|------------------------|---------%-%----------|||-||--
%%%%%%%%--------||-||-||-%|||-|-||--||||-----||-||||||------%--|||||-------------%------------|%-----------------------|---------|-|----------|||-||--
||||||||X---XXXX||X||X||-||||X|X||XXXX||-XXX-X|X|XXXXXXXXXXX|XX|||||XXXXXXXXXXXXX|XXXXXXXXXXXX||XXXXXXXXXXXXXXXXXXXXXXX|XXXXXXXXX|-|X-XXXXXXXX|||X||--