------------------------------------------------------------------------------------------------------------------------------------------------------
------------------------------------------------------------------------------------------------------------------------------------------------------
------------------------------------------------------------------------------------------------------------------------------------------------------
------------------------------------------------------------------------------------------------------------------------------------------------------
------------------------------------------------------------------------------------------------------------------------------------------------------
------------------------------------------------------------------------------------------------------------------------------------------------------
-----------------------------------------------------%-------------------------------%----------------------------------------------------------------
-----------------------------------------------------|-------------------------------|----------------------------------------------------------------
-----------------------------------------------------|-------------------------------|----------------------------------------------------------------
-----------------------------------------------------|-------------------------------|----------------------------------------------------------------
-----------------------------------------------------|---------------------------%---|----------------%----------------------%%-----------------------
-------------------------------------%---------------|---------------------------|---|----------------|----------%%%---------||---U-------------------
----------------------%%-%%----------|---------------|-----------%-%%------------|---|----K-----------|----------|||---------||-%%--%%%----%--%-------
------------%%%-------||-||----------|---------------|-----%-----|-||-----------%|-%%|%%%%%---%------%|-%--%%%---|||-%%%%%%--||-||--|||%%%%|--|-------
%%%%%%%%%---|||-----%-||-||----------|---------------|-----|%%--%|%||%%-%-%%%%--||-||||||||---|-----%||-|-%|||---|||-||||||%-||-||-%||||||||%%|-------
|||||||||---|||XXXXX|X||-||XX-XXXX-XXXXXXXXXXXXX-XXXX|XXXXX|||--|||||||X|X||||XX||X||||||||XXX|XXXXX|X|X|-||||XXXXXXX|||||||X||X||X||||||||||||XX-XXXX