------------------------------------------------------------------------------------------------------------------------------------------------------
------------------------------------------------------------------------------------------------------------------------------------------------------
------------------------------------------------------------------------------------------------------------------------------------------------------
------------------------------------------------------------------------------------------------------------------------------------------------------
------------------------------------------------------------------------------------------------------------------------------------------------------
------------------------------------------------------------------------------------------------------------------------------------------------------
------------------------------------------------------------------------------------------------------------------------------------------------------
------------------------------------------------------------------------------------------------------------------------------------------------------
------------------------------------------------------------------------------------------------------------------------------------------------------
--------------------------------------------------------%---------------------------------------------------------------------------------------------
--------------------------------------------------------|------------------t-------------------------------------------------------%%-----------------
-------------------------------g---------T--------------|------------------t-------------------------------------------------------||-----------------
--------%---------------------%----------t---%---%%-%%%%|%%%%--%---------%-t-----------------%%%%----%-%--%%-%%%%%%%--%%--%--------||-----------------
--------|---------------------|-------%--t--%|---||-|||||||||--|-------%-|-%--%--------------||||----|-|--||-|||||||--||--|--------||---------%-------
%%%%%%%%|%%%%%%%%%%%%---------|----%%%|%%%--||---||-|||||||||--|-------|-|-|--|-------%------||||----|-|--||%|||||||--||--|-----%%%||%%---%---|------%
|||||||||||||||||||||XXXXXXXXX|XXXX|||||||XX||XXX||X|||||||||--|XXXXXXX|X|X|X-|XXXXXXX|XXXXXX||||XXX-|X|XX||||||||||--||XX|XX---|||||||XXX|XXX|XXXXXX|