------------------------------------------------------------------------------------------------------------------------------------------------------
------------------------------------------------------------------------------------------------------------------------------------------------------
------------------------------------------------------------------------------------------------------------------------------------------------------
------------------------------------------------------------------------------------------------------------------------------------------------------
------------------------------------------------------------------------------------------------------------------------------------------------------
------------------------------------------------------------------------------------------------------------------------------------------------------
------------------------------------------------------------------------------------------------------------------------------------------------------
------------------------------------------------------------------------------------------------------------------------------------------------------
------------------------------------------------------------------------------------------------------------------------------------------------------
-----------------------------------------------------------------------------------------%-------S----------------------------%-----------------------
-----------------------------------------------------------------------------------------|------------------------------------|-----------------------
----------------------------------------------------2S-----------------------------------|------------------------------------|-----------------------
-------------%-%%--------------------------------------%-%%%%--------------------%%---%--|-------%-----%%%%-------------------|---------%--%%%%----%--
-------------|-||%%%%-%----------------------------%---|-||||--------------------||---|--|%-%---%|%-%%%||||%%%%-%---%-%%%-----|g--------|--||||----|--
%%%%%%%%--%--|-||||||-|----------%-----------------|---|-||||------%%%%%%%%%---%-||---|--||-|---|||-|||||||||||%|%--|-|||-----|---------|--||||----|--
||||||||--|XX|X||||||X|XXXXXXXXXX|XXXXXXXXXXXXXXXXX|XXX|-||||------|||||||||XXX|-||XXX|--||X|XXX|||X||||||||||||||-X|-|||XXXXX|XXXXXXXXX|XX||||----|XX