------------------------------------------------------------------------------------------------------------------------------------------------------
------------------------------------------------------------------------------------------------------------------------------------------------------
------------------------------------------------------------------------------------------------------------------------------------------------------
------------------------------------------------------------------------------------------------------------------------------------------------------
------------------------------------------------------------------------------------------------------------------------------------------------------
------------------------------------------------------------------------------------------------------------------------------------------------------
------------------------------------------------------------------------------------------------------------------------------------------------------
------------------------------------------------------------------------------------------------------------------------------------------------------
----------------------------------------------------------------------------------------------------------------------------------------------%-------
----------------------------------------------------------------------------------------------------------------------------------------------|-------
-------------------------------------------------------------------------------------------------------------%------S-------------------------|-------
------------------------------------------------S------------------------------------------------------------|------g-------------------------|-------
---------------------%-------%-----------%%------------------------------------------------------------------|--%----%------------%-----------|---%---
----------------%-g%-|-%%%%--|-----------||----------------------%%------------------------------------------|--|----|------------|---%%%%--%-|---|---
%%%%%%%%%%-%%%%-|--|-|-||||--|--%%%------||----------------------||-------------------%-----------------%----|-%|----|--------%%-%|---||||%%|-|%%%|%%-
||||||||||-||||XXXX|-|X||||XXXXX|||XXXXXX||-XXXXXXXXXX--XX--XXXXX||XXXXXXXXXXXXXXXXXXX|XXXXXXXXXX-XXXXXX|X--X|X||-XXX|X-XXXXX-||X||XXX|||||||-|||||||X