------------------------------------------------------------------------------------------------------------------------------------------------------
------------------------------------------------------------------------------------------------------------------------------------------------------
------------------------------------------------------------------------------------------------------------------------------------------------------
----------------------------------------------------------------------------------------------------------------------------#-------------------------
----------------------------------------------------------------------------------------------------------------------------#-------------------------
----------------------------------------------------------------------------------------------------------------------------#-------------------------
-----------------------------------------------------------------------%----------------------------------------------------#-------------------------
-----------------------------------------------------------------------|----------------------------------------------------%-------------------------
-------------------------------------------------%---------------------|----------------------------------------------------|-------------------------
-------------------------------------------------|---------------------|--------------------------------------------t-------|-------------------------
---------------------%---------------------------|---------------------|--------------------------------------------t-------D-------------------------
---------------------|---------------------------|---------------------|--------------------------------------------t-------D-------------------------
-------------%-------|----------------------%%---|---------------------|---------%%%%%%%---------------------%%-%%%%%%%%----------%%%-%%%%%-%%%%-%%---
-------------|-------|-------------------%--||---|%-%------------------|---------|||||||%%%%%-----%%---------||-||||||||%%-%%%%---|||-|||||-||||%||---
%%%%%%%%%%%-%|%-%----|------%------------|--||--%||%|%%%%-----%%-------|---------||||||||||||-----||---------||-||||||||||%||||---|||-|||||-|||||||-%-
|||||||||||X|||X|XXXX|XXXXXX|XXXXXXXXXXXX|--||XX|||||||||XXXX-||XXXXXXX|XXXXXXXXX||||||||||||XXXXX||XX-XXXXXX||-||||||X||||||||XXX|||-|||||X|||||||-|X