------------------------------------------------------------------------------------------------------------------------------------------------------
------------------------------------------------------------------------------------------------------------------------------------------------------
------------------------------------------------------------------------------------------------------------------------------------------------------
------------------------------------------------------------------------------------------------------------------------------------------------------
------------------------------------------------------------------------------------------------------------------------------------------------------
------------------------------------------------------------------------------------------------------------------------------------------------------
------------------------------------------------------------------------------------------------------------------------------------------------------
------------------------------------------------------------------------------------------------------------------------------------------------------
------------------------------------------------------------------------------------------------------------------------------------------------------
---------------------------------------%--------------------------------------------------------------------------------------------------------------
---------------------------------------|--------------------------------------------------------------------------------------------------------------
--------------%%%---%------------------|--------------------------------------------------------------------------------------------------------------
--------------|||---|-%%----%%%%%%%%%%-|-%------------------%--------%--------------------------------------------------%-----------------------------
---------%%---|||---|-||---%||||||||||-|-|-%%%%%%-%%%%-%-%--|%-------|--------------------%--------------------%%-------|----%%%%%%%%%----%%%%%%%%%%%%
%%%%%%%%%||---|||---|-||---|||||||||||-|-|-||||||-||||-|%|--||-------|--------------------|--------------------||%%%%%%%|----|||||||||----||||||||||||
|||||||||||XXXXXX--XXX||XX-|||||||||||X|-|X||||||X||||X|||XX|XX--XXXX|XXXXXXXXXXXXXXXXXXXX|XXXXXXXXXXXXXXXXXXXX||||||||||-XXX|||||||||----||||||||||||