------------------------------------------------------------------------------------------------------------------------------------------------------
------------------------------------------------------------------------------------------------------------------------------------------------------
------------------------------------------------------------------------------------------------------------------------------------------------------
------------------------------------------------------------------------------------------------------------------------------------------------------
------------------------------------------------------------------------------------------------------------------------------------------------------
------------------------------------------------------------------------------------------------------------------------------------------------------
------------------------------------------------------------------------------------------------------------------------------------------------------
------------------------------------------------------------------------------------------------------------------------------------------------------
------------------------------------------------------------------------------------------------------------------------------------------------------
------------------------------------------------------------------------------------------------------------------------------------------------------
------------------------------------------------------------------------------------------------------------------------------------------------------
------------------------------------------------------#---------------------------------------------------------------g------%------------------------
------------%-----%-------%------------------------%-%%---%%%%%%-%----------------%%%%%--%-%%%------------t----%--%%%%%%%----|------%------------%----
---------%--|-----|--%----|------------------------|-||---||||||-|----------------|||||--|-|||%%%%--------t----|--|||||||----|------|------------|---%
%%%%%%%%%|--|-----|--|----|------------------------|-||---||||||-|--------%%%%%%%%|||||--|-|||||||--------t%%-%|%%|||||||----|------|------------|---|
||||||||||X-|-XXXX|XXXXXXX|-XXXXXXXXXXXXXXXXXXXXXXX|X||XXX||||||-|XXXXXXX-|||||||||||||--|-|||||||XX-XXXXXX||X||||||||X||XXXX|XXXXXX|X--X-XXXXX-X|-XX|