------------------------------------------------------------------------------------------------------------------------------------------------------
------------------------------------------------------------------------------------------------------------------------------------------------------
------------------------------------------------------------------------------------------------------------------------------------------------------
------------------------------------------------------------------------------------------------------------------------------------------------------
------------------------------------------------------------------------------------------------------------------------------------------------------
-----------------------------------------------------------------S------------------------------------------------------------------------------------
------------------------------------------------------------------------------------------------------------------------------------------------------
------------------------------------------------------------------------------------------------------------------------------------------------------
------------------------------------------------------------------------------------------------------------------------------------------------------
-----------------------------------------------------------------%------------------------------------------------------------------------------------
-----------------------------------------------------------------|------------------------------------------------------------------------------------
-----------------------------------------%-----------------------|------------------------------------------------------------------------------------
------------%%----%%%%%%%%%%---%%----%%%-|%%--------%%----------%|---%%--%---%%-%------------------------------------%%%------------------------------
------------||----||||||||||%%%||-%--|||-|||--------||----------||---||--|---||-|--%%%%%-------%%-----%%%%%----------|||------%----------------%---%--
%%%%%%%%--%-||----|||||||||||||||-|--|||-|||--------||----%%--%-||---||--|---||-|--|||||-------||-----|||||%%--------|||%-----|------------%---|-%%|%%
||||||||--|X||X-XX|||||||||||||||X|XX|||-X||XX--XXX-||XX--||XX|X||XXX||XX|--X||-|XX|||||XXXXXXX||XXXXX|||||||XXXXXXXX||||XXXXX|XXXXXXXXXX-X|XXX|X|||||