------------------------------------------------------------------------------------------------------------------------------------------------------
------------------------------------------------------------------------------------------------------------------------------------------------------
------------------------------------------------------------------------------------------------------------------------------------------------------
------------------------------------------------------------------------------------------------------------------------------------------------------
------------------------------------------------------------------------------------------------------------------------------------------------------
------------------------------------------------------------------------------------------------------------------------------------------------------
----------------------------------------------------C-----------------------------%-------------------------------------------------------------------
----------------------------------------------------------------------------------|------------%------------------------------------------------------
---------------------------------------------------------C------------------------|------------|------------------------------------------------------
----------------------------------------------------------------------------------|------------|---------------------------------%--------------------
---------------------------------------%------------%-----------------------------|---T--------|---------------------------------|--------------------
---------------------------------------|t-----------|-----------------------------|---t------%-|---%-----------------------------|--------------------
---------------------------------------|t-----------|----%-%%%-%-%----------------|---%-S----|-|-%%|--%---------------%----------|-%-------%----------
-----------------------------------%%%%|%%----------|-%%%|-|||-|-|-%%--%%---%%%%%%|%--|------|-|-|||-%|%-----%%%%%%%%%|%%--------|-|-------|----------
%%%%%%%%-%%-------%----------------|||||||-%%%%%--%%|-||||%|||-|-|%||%%||---||||||||--|--%---|-|%|||-|||--%--||||||||||||--------|-|-------|----------
||||||||X||XXXXXXX|XXXXXXXXXXXXXXXX|||||||X|||||X-|||X||||||||-|-||||||||-XX||||||||X-|XX|XXXXX||||X-|||XX|XX|||||||||X||XX--XXXX|X|XXX-XXX|XXXXXXXXXX