------------------------------------------------------------------------------------------------------------------------------------------------------
------------------------------------------------------------------------------------------------------------------------------------------------------
------------------------------------------------------------------------------------------------------------------------------------------------------
------------------------------------------------------------------------------------------------------------------------------------------------------
------------------------------------------------------------------------------------------------------------------------------------------------------
------------------------------------------------------------------------------------------------------------------------------------------------------
------------------------------------------------------------------------------------------------------------------------------------------------------
------------------------------------------------------------------------------------------------------------------------------------------------------
------------------------------------------------------------------------------------------------------------------------------------------------------
---------------------------------------------------------------------------------------%--------------------------------------------------------------
-----------------------------------------------------------------------------------%%--|---------------------------------------------------------%----
----------------------------------------------------------------------------------S||--|--------%------------------------------S-----------------|----
------------------------%%-%%%%%---%----------%----------------------------%-------||--|-----%%%|--------------------%%-----------%----%-%%%%----|---%
------------------------||-|||||---|--------%-|----%-----------------------|----%%-||--|-----||||--------------------||-------%-%-|----|-||||-%-%|---|
%%%%%%%%-%%%%%----------||%|||||%-%|%%-%----|-|----|-----------%%%%%%%%----|----||-||--|-----||||%%%%%%%----%%%%-%%%-||-------|-|-|----|-||||%|-||---|
||||||||X|||||XXXXXXXXXX|||||||||X||||-|XXXX|X|XXXXXXXXXXXXXXXX||||||||XXXX|XXXX||X||-X|--X--|||||||||||X---||||-|||X||XXXXXXX|X|-|X--X|-||||||-||X-X|