------------------------------------------------------------------------------------------------------------------------------------------------------
------------------------------------------------------------------------------------------------------------------------------------------------------
------------------------------------------------------------------------------------------------------------------------------------------------------
------------------------------------------------------------------------------------------------------------------------------------------------------
-------------------------%----------------------------------------------------------------------------------------------------------------------------
-------------------------|----------------------------------------------------------------------------------------------------------------------------
-------------------------|----------------------------------------------------------------------------------------------------------------------------
-------------------------|----------------------------------------------------------------------------------------------------------------------------
---------------%---------|----------------------------------------------------------------------------------------------------------------------------
---------------|---------|----------------------------------------------------------------------------------------------------------------------------
--------------%|---------|----------------------------------------------------------------------------------------------------------------------------
-------------%||---------|-----%----------------------------------------------------------------------------------------------------------------------
---------%%--|||-------%-|-----|%----------------------%-----%%%---------------------------------------------------%%%%-------------------------------
--------%||%-|||---%--%|-|-----||--%-------------%%%--%|-----|||---------------------------%%----------%-----------||||----------------%%--%%%----%%%-
%%%%%%%%||||-|||---|--||-|-----||--|%%%----------|||--||----%|||-------------------%-------||----------|%----------||||----------------||--|||%---|||-
||||||||||||-X||XXX|XX|XX|XXXXXXXXXX|||XXXXXXXXXX|||XX||---X||||X-XXXXXXXX-XXXXXXXX|XXXXXXX||XXX-XXXXXX||XXXXXXXXX-||||XXXXXXXXXXXXXXXX||XX||||--X|||X