------------------------------------------------------------------------------------------------------------------------------------------------------
------------------------------------------------------------------------------------------------------------------------------------------------------
------------------------------------------------------------------------------------------------------------------------------------------------------
------------------------------------------------------------------------------------------------------------------------------------------------------
------------------------------------------------------------------------------------------------------------------------------------------------------
------------------------------------------------------------------------------------------------------------------------------------------------------
------------------------------------------------------------------------------------------------------------------------------------------------------
---------------------------------------------------------------------------------------------------------%--------------------------------------------
---------------------------------------------------------------------------------------------------------|--------------------------------------------
---------------------------%--------------------------------------------------------------%--------------|--------------------------------------------
---------------------------|---------------------------------------------------%----------|--------------|--------------------------------------------
---------------------------|-----------------------------%---------------------|---------2|--------------|--------------------------------------------
---------------------------|-----%%%%%%-%%%%%%-%%---%%%%%|--%%%%%%-%%--%%%%%%%%|%%%%------|---------%----|---%----------------------------------------
---------------------------|-----||||||-||||||-||---||||||--||||||-||%-|||||||||||||----%-|------%--|-%%-|%%%|-%-%%---%%-%%%--------------------%%---%
%%%%%%%%%%%%%%-%-----------|-----||||||-||||||-||---||||||%%||||||-|||-|||||||||||||----|-|------|--%-||%|||||-|%||---||-|||--%%%-----%--%----%-||---|
||||||||||||||X|XXXXXXXXXXX|XXXXX||||||-||||||-||XX-||||||||||||||-|||-|||||||||||||XXXX|X|XX-XX-|XX|-||||||||-X|||--X||-|||-X|||XXXXX|XX|XXXX|X||XXX|