------------------------------------------------------------------------------------------------------------------------------------------------------
------------------------------------------------------------------------------------------------------------------------------------------------------
------------------------------------------------------------------------------------------------------------------------------------------------------
------------------------------------------------------------------------------------------------------------------------------------------------------
------------------------------------------------------------------------------------------------------------------------------------------------------
------------------------------------------------------------------------------------------------------------------------------------------------------
------------------------------------------------%-----------------------------------------------------------------------------------------------------
------------------------------------------------|-----------------------------------------------------------------------------------------------------
------------------------------------------------|-----------------------------------------------------------------------------------------------------
------------------------------------------------|-----------------------------------------------------------------------------------------------------
------------------------------------------------|----------------------t------------------------------------------------------------------------------
------------------CCCSU2------------------------|--------%-----------%-t------------------------------------------------------------------------------
-----------------%------%----------%%%----------|--------|-%%%%------|-t--------------------%-------------------------%-------%-----------------------
-----------------|------|----------|||--------%-%%%%-----|-||||--%%%%|-%%-------------%%%%%%|%%%-%%%%--%-------%-%---%|-%%%%%%|%%%%%%%%-%%%%---%-%----
%%%%%%%%%%%%-----|------|----------|||--------|-||||-----|-||||%%|||||-||--%%--%%%%--%||||||||||-||||%%|-----%%|-|%%%||-|||||||||||||||-||||%--|-|%%%%
||||||||||||XXX-X|XXXXXX|XXXXXXXXXX|||XXXXXXXX|X||||XX--XX-||||||||||XX||XX||XX||||XX|||||||||||-|||||||XXXXX|||X||||||X|||||||||||||||-|||||X-|-|||||