------------------------------------------------------------------------------------------------------------------------------------------------------
------------------------------------------------------------------------------------------------------------------------------------------------------
------------------------------------------------------------------------------------------------------------------------------------------------------
------------------------------------------------------------------------------------------------------------------------------------------------------
------------------------------------------------------------------------------------------------------------------------------------------------------
------------------------------------------------------------------------------------------------------------------------------------------------------
------------------------------------------------------------------------------------------------------------------------------------------------------
------------------------------------------------------------------------------------------------------------------------------------------------------
---------------------------------------%--------------------------------------------------------------------------------------------------------------
---------------------------------------|--------------------------------------------------------------------------------------------------------------
---------------------------------------|-%------------------------------------------------------------------------------------------------------------
-----------------------------------%%%%|%|-%%---------%%%%---------------------------------------------------------------------------%%---------------
-------------------------------%%-%|||||||-||---------||||-----------------------------------------%%%%%%%%-%%---%--------%------%%%%||---------------
---------%---%----%--%---------||%||||||||-||---%%%---||||----------%%%%%%--%%%--%%%-------%%%%%%--||||||||-||---|--------|------||||||--%------------
%%%%%%%%%|%%-|----|--|---------%||||||||||-||---|||---||||----------||||||--|||--|||-------||||||%#||||||||-||---|--------|------||||||-%|%%----------
|||||||||X||X|X---|XX|XXXXXXXXX|XX|XXXXXX|-XXXXXXXXX-X||||XXXXXXXXXX||||||--|||XX|||XXXXX--|||||||X||||||||X||XXX|XXXXXXXX|XXXXXX||||||X||||XX-XXXXXXX