------------------------------------------------------------------------------------------------------------------------------------------------------
------------------------------------------------------------------------------------------------------------------------------------------------------
------------------------------------------------------------------------------------------------------------------------------------------------------
------------------------------------------------------------------------------------------------------------------------------------------------------
------------------------------------------------------------------------------------------------------------------------------------------------------
------------------------------------------------------------------------------------------------------------------------------------------------------
------------------------------------------------------------------------------------------------------------------------------------------------------
------------------------------------------------------------------------------------------------------------------------------------------------------
------------------------------------------------------------------------------------------------------------------------------------------------------
--------S---------------------------------------------------------------------------------------------------------------------------------------------
------------%%----------------------------------------------------------------------------------------------------------------------------------------
------------||----------------------------------------------------------------------------------------------------------------------------------------
------------||------%%------%%%---------------------------------------------------%--------------------------------------%%---------------------------
--------%%%-||%---%-||------|||------------------C---%--%-------------------------|------------%%----%---%-------%%-%%---||----------------------%%%%-
%%%%%%%%|||%|||---|-||------|||----------------------|--|%%------------------%----|--%-%--%----||%---|%--|-------||-||---||-------------------%--||||-
|||||||||||||||X-X|X||XXXXXX|||XXXXXXXXXXXXXXXXXXXXXX|XX|||XXXXXXXXXXXXXXXXXX|XXXX|XX|-|XX|XXXX|||-XX||XX|XXXXXXX||X||X--||-XXX-XXX-XXXXXXXXXX|XX||||-