------------------------------------------------------------------------------------------------------------------------------------------------------
------------------------------------------------------------------------------------------------------------------------------------------------------
------------------------------------------------------------------------------------------------------------------------------------------------------
------------------------------------------------------------------------------------------------------------------------------------------------------
------------------------------------------------------------------------------------------------------------------------------------------------------
------------------------------------------------------------------------------------------------------------------------------------------------------
---------------------------------------------------S------------------%-------------------------%-----------------------------------------------------
----------------------------------------------------------------------|-------------------------|-----------------------------------------------------
----------------------------------------------------------------------|-------------------------|-----------------------------------------------------
----------------------------------------------------------------------|-------------------------|-----------------------------------------------------
---------------------------------------------------%------------------|-------------------------|------------------------------------------------%----
---------------------------------------------%-----|------------------|-------------------------|---------------------%--------------------------|----
----------------%-----%-----%------%%--------|-----|--------%---------|%-------------%%%%-%%%%--|%%--------------%%%%-|-----%%%%%%%%%%%%%----%%--|----
--------------%%|-%%%%|%%%-%|-%%%--||--------|-----|t-------|---------||--%%%--------||||-||||--|||--------------||||-|-----|||||||||||||----||--|--%-
%%%%%%%%%%%%%%|||-||||||||%||-|||--||--------|%----|t--%----|----%%%%%||--|||--------||||-||||%%|||--------------||||-|-----|||||||||||||----||--|--|-
|||||||||||||||||X|||||||||||X|||XX||XXXXXXXXX|X---|XXX|XX--|XXXX||||||XXX|||XX-XXXXX||||-|||||||||XXXXXXXXXXXXXX||||-|-----|||||||||||||--XX||XX|XX|X