------------------------------------------------------------------------------------------------------------------------------------------------------
------------------------------------------------------------------------------------------------------------------------------------------------------
------------------------------------------------------------------------------------------------------------------------------------------------------
------------------------------------------------------------------------------------------------------------------------------------------------------
------------------------------------------------------------------------------------------------------------------------------------------------------
------------------------------------------------------------------------------------------------------------------------------------------------------
------------------------------------------------------------------------------------------------------------------------------------------------------
---------------------------------------------------------------------------------------%-------------------------------------------%------------------
---------------------------------------------------------------------------------------|-------------------------------------------|------------------
---------------------------------------------------------------------------------------|-------------------------------------------|------------------
---------------------------------------------------------------------------------------|-------------------------------------S-----|------------------
---------------------------------------------------------------%-----------------------|t-----------------------------------------%|----------------G-
-------------------------%--%%%%---------------------%%--------|------%%-%%%%%---------|t--------------------------------%--------||----------%%--%%%-
-------------------------|--||||---------------------||--------|-%----||-|||||---------|t--------------------------------|---%----||%%%%%-----||--|||-
%%%%%%%%%%%%%%-----------|%-||||---------------------||--------|-|%%--||%|||||----%---%|%%%%%----------------------%-----|---|---%|||||||-----||--|||-
||||||||||||||XXXXXXXXXXX||-||||XXXXXXXXXXXXXXXXXXXXX||XXXXXXXXXX|||XX||||||||XX--|--X|||||||XXXXXXXXXXXXXXXXXX-XXX|XXXXX|-XX|XXX||||||||XXXXX||X-|||X