------------------------------------------------------------------------------------------------------------------------------------------------------
------------------------------------------------------------------------------------------------------------------------------------------------------
------------------------------------------------------------------------------------------------------------------------------------------------------
------------------------------------------------------------------------------------------------------------------------------------------------------
------------------------------------------------------------------------------------------------------------------------------------------------------
------------------------------------------------------------------------------------------------------------------------------------------------------
----------------------------------------------------------------------------------------------------------------------------------U-------------------
------------------------------------------------------------------------------------------------------------------------------------------------------
------------------------------------------------------------------------------------------------------------------------------%-----------------------
------------------------------S-----------------------------------------------------------------------------------------------|-----------------------
-------------------------------------------------------------------------------------------------------------------C------%%--|--%%--%%---------------
-------------------------%---------------------------------------------------------------------------------------------%%-||--|--||--||---------------
--------------%-%--------|%%%%-----------------------------------------%----%%%%%%%%%-------------------%--------------||-||--|--||--||---------------
------------%%|-|--------|||||%-----%----------------------------------|----|||||||||%---------%--%-%%--|%%%----%%%----||-||--|--||--||----%%---------
%%%%%%%%%%-%|||-|--%%%%-%||||||%-%--|-----------------------%%%--------|----||||||||||--%%%---%|--|-||--||||--%%|||%---|%-||--|--||--||----||----%%%%-
||||||||||X||||X|X-||||X||||||||X|XX|XXXXXXXXXXXXXXXXXXXXXXX|||XXXXXX--|XXXX||||||||||--|||XXX||XX|X||XXX|||XX||||||XXX||X||--|X-||X-||XXXXXXX--X||||-