------------------------------------------------------------------------------------------------------------------------------------------------------
------------------------------------------------------------------------------------------------------------------------------------------------------
------------------------------------------------------------------------------------------------------------------------------------------------------
------------------------------------------------------------------------------------------------------------------------------------------------------
--------------C---------------------------------------------------------------------------------------------------------------------------------------
------------------------------------------------------------------------------------------------------------------------------------------------------
------------------------------------------------------------------------------------------------------------------------------------------------------
--------------S---------------------------------------------------------------------------------------------------------------------------------------
------------------------------------------------------------------------------------------------------------------------------------------------------
------------------------%--------------------------------------------------------%--------------------------------------------------------------------
------------------------|--------------------------------------------------------|--------------------------------------------------------------------
------------------------|--%--%--%%%%%-------------------------------------------|--------------------------------------------------k-----------------
------------------------|--|--|--|||||---------------%%-%%-%%--------------------|--%---%%%%-%%%%---------------------%-------------------------------
--------------%---------|--|--|--|||||---------------||-||-||--------------------|%-|---||||-||||-%--%%%%%%%%-%-------|%-----%%%%%%%-%%---------------
%%%%%%%%%-----|---------|--|--|--|||||%-------%%%----||-||-||--------------------||-|---||||-||||-|--||||||||-|%%%--%-||-----|||||||-||---------------
|||||||||-XXX-|XXXXXXXXX|XX|XX|-X||||||XXXXXXX|||XXXX||X||X||XXXXXXXXXXXXXXXXXX--||X|-X-||||-||||-|XX||||||||X||||XX|-||----X|||||||X||XXXXXXXXXXXXXXX