------------------------------------------------------------------------------------------------------------------------------------------------------
------------------------------------------------------------------------------------------------------------------------------------------------------
------------------------------------------------------------------------------------------------------------------------------------------------------
------------------------------------------------------------------------------------------------------------------------------------------------------
------------------------------------------------------------------------------------------------------------------------------------------------------
------------------------------------------------------------------------------------------------------------------------------------------------------
---------------------------------------------------------------------------------------------------------------------------------------------%--------
---------------------------------------------------------------------------------------------------------------------------------------------|--------
---------------------------------------------------------------------------------------------------------------------------------------------|--------
---------------------------------------------------------------------------------------------------------------------------------------------|--------
-------------------------------------------%-------------------------------------------------------------------------------------------------|--------
------------------------%%%----------------|------------------------------------T------------------------------------%%---%------------------|--------
----------%---%----S--%-|||---------%-----%|------%-----------------------------t---------------------%%%%%----------||---|------------------|--------
---------%|---|-------|-|||---------|-----||------|--------------------------%--%%--------------------|||||---------%||---|------------------|--------
%%%%%%%%%||---|-------|-|||---------|-----||------|--------------------------|--||--------------------|||||---------|||---|------------------|%--%%%%%
|||||||||||-XX|-XXXXX-|XXXXXXXXXX-XX|XXXXX||XXXXXX|XX---XXXXXXXX-XXXXXXXXXXXX|XXX|XXX---XXXXXXXXXXXXXX|||||XXXXXXXXX|XXXXXXXXXXXXXXXXXXXXXXXX||--|||||