------------------------------------------------------------------------------------------------------------------------------------------------------
------------------------------------------------------------------------------------------------------------------------------------------------------
------------------------------------------------------------------------------------------------------------------------------------------------------
------------------------------------------------------------------------------------------------------------------------------------------------------
------------------------------------------------------------------------------------------------------------------------------------------------------
------------------------------------------------------------------------------------------------------------------------------------------------------
-----------------------------------------------------------------------------------------------------------------------------------------%%-----------
-----------------------------------------------------------------------------------------------------------------------------------------||-----------
------------------------------------------%----------------------------------------------------------------------------------------------||-----------
------------------------------------------|%---------------------------------------------------------------------------------------------||-----------
------------------------------------------||--------------------------------------------------------------%%-----------------------------||-----------
----------------%-------------------------||---------------%----------------------------------------------||-----------------------------||-----------
----------------|---------------------%-%%||%--------------|----------------------------------------------||----------------%%%%%--%%%%--||-----%%----
----------%-%%%%|-----%%-------%------|-|||||------%%%-----%---%---%%--%---%---%%--%-------------%-%--%%%-||----------------|||||--||||--||-----||----
%%%%%%%%%%|-|||||-----||%------|%%%%%%|-|||||------|||-----|--%|---||-%|---|---||--|-------------|-|--|||%||-%%%%%%%%-------|||||--||||%%||-----||----
|||||||||||X||||XXXXXX|||XXXXXX||||||||-|||||XXXXXX|||XXXXXXX-||XXX||X||XXX|XX-||XX|XXXXXXXXXXXXXXX|XX||||||-||||||||XXXXXXX|||||X-||||||||XXXXX||XXXX