------------------------------------------------------------------------------------------------------------------------------------------------------
------------------------------------------------------------------------------------------------------------------------------------------------------
------------------------------------------------------------------------------------------------------------------------------------------------------
------------------------------------------------------------------------------------------------------------------------------------------------------
------------------------------------------------------------------------------------------------------------------------------------------------------
------------------------------------------------------------------------------------------------------------------------------------------------------
------------------------------------------------------------------------------------------------------------------------------------------------------
----------------C-------------------------------------------------------------------------------------------------------------------------------------
------------------------------------------------------------------------------------------------------------------------------------------------------
----------------------------------------------------------------------------------------------------------------------------------%-------------------
----------------------------------------------------------------------------------------------------------------------------------|-------------------
----------------%--------------------------------------C--------------------------------------------------------------------------|-------------------
----------------|----------------------------------------------t-------%--%--------------------------------%--%-----%%--------%%%-|----%------%-------
----------------|------------------------------%%%%------------t-------|--|%%----%%---%-------------------%|--|-----||---%%%%-|||%%----|%-----|-------
%%%%%%%%%%%%%%--|--------------%---%%%%%%%--%%-||||-------%%---t-------|--|||-%--||---|-------------------||--|-----||%%%||||-|||||%---||----%|-%-----
||||||||||||||XX|XX-XXXXXXXXXXX|XXX|||||||XX||X||||XXXXXXX||X--XXXXXXXX|XX|||-|XX||X--|XXXXXXXXX-XXXXXXXXX||--|XX---|||||||||XX|||||X-X||XXXX||X|XXXXX