------------------------------------------------------------------------------------------------------------------------------------------------------
------------------------------------------------------------------------------------------------------------------------------------------------------
------------------------------------------------------------------------------------------------------------------------------------------------------
------------------------------------------------------------------------------------------------------------------------------------------------------
------------------------------------------------------------------------------------------------------------------------------------------------------
------------------------------------------------------------------------------------------------------------------------------------------------------
------------------------------------------------------------------------------------------------------------------------------------------------------
------------------------------------------------------------------------------------------------------------------------------------------------------
------------------------------------------------------------------------------------------------------------------------------------------------------
-------------------------------------------------------------------------------%---%------------------------------------------------------------------
------------------------------------------------------------%------------------|---|------------------%%%%-------------------%------------------------
---------------S--------------------------------------------|------------------|---|------------------||||-------------------|------------------------
----------------------%%%------%%-%%%-%--%------------------|------------------|---|--%%%%%%%%%%%%%%%-||||----------------%%%|%---%-----%-%%%-%%------
-----------------%%---|||------||-|||-|--|------------------|-%%---%%---%%-%---|---|--|||||||||||||||-||||----------------|||||---|-----|-|||-||--%---
%%%%%%%%%%%-%%%--||---|||-----%||-|||-|%%|%%%---------------|-||---||---||-|---|---|--|||||||||||||||-||||%%%%--%%-%------|||||---|%-%%%|-|||-||--|---
|||||||||||X|||XX||XXXX|X-X--X|||X|||X|||||||XXXX--XXX-XXXXX|X||XXX||XXX||X|XXX|XXX|XX|||||||||||||||X||||||||X-||X|------|||||XXX||-||||X|||-||XX|--X