------------------------------------------------------------------------------------------------------------------------------------------------------
------------------------------------------------------------------------------------------------------------------------------------------------------
------------------------------------------------------------------------------------------------------------------------------------------------------
------------------------------------------------------------------------------------------------------------------------------------------------------
------------------------------------------------------------------------------------------------------------------------------------------------------
------------------------------------------------------------------------------------------------------------------------------------------------------
------------------------------------------------------------------------------------------------------------------------------------------------------
----------------------------------------------%-------------------------------------------------------------------------------------------------------
----------------------------------------------|-------------------------------------------------------------------------------------------------------
----------------------------------------------|--------%----------------------------------------------------------------------------------------------
----------------------------------------------|--------|---%------------------------------------------------------------------------------------------
---------K------------------------------------|--------|---|------------------------------------------------------------------------------------------
---------%--------------------------%%--------|--------|---|------%%%%--------------%--%---------------------%%%------%-------------------------------
---------|-----%%-%%-%---%----------||-------%|-%%-%%%-|-%-%%-%---||||%%%%%%%%------|--|%%----%%%%%%%%%%%%%%%|||--%%--|-------------------------%%----
%%%%%%%%%|--#--||-||-|%--|----------||-------||-||-|||%|%|-||-|---||||||||||||------|--|||----||||||||||||||||||--||-%|---------%----%%%%------%||----
|||||||||X--XXX||-||X||XXXXXXXXXXXXX||X----XX||X||X|||||||X||X|XXX||||||||||||XXXXXX|XX|||----||||||||||||||||||X-||X||XXXXXX---|XXXX||||-XX-XX|||XXXX