------------------------------------------------------------------------------------------------------------------------------------------------------
------------------------------------------------------------------------------------------------------------------------------------------------------
------------------------------------------------------------------------------------------------------------------------------------------------------
------------------------------------------------------------------------------------------------------------------------------------------------------
------------------------------------------------------------------------------------------------------------------------------------------------------
---------------------------------------------------------------------------------------------------------D--------------------------------------------
------------------------------------------------------------------------------------------------------------------------------------------------------
------------------------------------------------------------------------------------------------------------------------------------------------------
------------------------------------------------------------------------------------------------------------------------------------------------------
------------------------------------------------------------------------------------------------------------------------------------------------------
----------------------S----------------------------------------------------------------------------------------------------%------------------------%-
-------------------------------------------------------------------%-%%----------------------------------%-------------g---|------------------------|-
---------------%-%-----------------------------%-------------------|-||--------------------------------%%|--%%%--%---------|-------------------%%%%%|-
---------------|-|-----------------------%-%%--|-------%%%---%%%%%%|-||--------------------------------|||%-|||--|---------|-------------------||||||-
%%%%%%%%%%--%--|%|---%%%%%%%%%%---------%|-||-%|-%%----|||---|||||||-||-----%-----------------%--------||||-|||--|---------|----------%--------||||||-
||||||||||X-|-X|||XXX||||||||||XXXXXXXX-||X||X||X||XX-XXXXXXX|||||||-||XXXXX|---XXXXXXXXXXXXXX|XXXXXXXX||||-XXXXX|XXXXX-XXX|XXXXXXXXXX|XXXXXXXX||||||X