------------------------------------------------------------------------------------------------------------------------------------------------------
------------------------------------------------------------------------------------------------------------------------------------------------------
------------------------------------------------------------------------------------------------------------------------------------------------------
------------------------------------------------------------------------------------------------------------------------------------------------------
------------------------------------------------------------------------------------------------------------------------------------------------------
------------------------------------------------------------------------------------------------------------------------------------------------------
------------------------------------------------------------------------------------------------------------------------------------------------------
------------------------------------------------------------------------------------------------------------------------------------------------------
------------------------------------------------------------------------------------------------------------------------------------------------------
------------------------------------%-----------------------------------------------------------------------------------------------------------------
------------------------------------|--------------------------------------------------------------------------------------T--------------------------
------------------------------------|--------------------------------------------------------------------------------------t--------------------------
--------%---------------------------|------------------------%%---%-------------%-%%%%%%-------------------%---------------t-----%-%--%%%%%%%%--------
--------|---------------------------|--------%---%----%%%%-%-||%-%|------------%|-||||||---------%%%%%-%%%%|%--%%--%---%%%%%%%---|-|-%||||||||--------
%%%%%%%%|----%---%------------------|------%-|-%%|%-%%||||-|-|||-||--%---------||-||||||-------%-|||||-||||||-%||%-|%%%|||||||---|%|%|||||||||%-------
|||||||||----|XXX|XXXXXXXXXXXXXXXXXX|XXXXXX|-|X||||X||||||-|XXX|X|XXX|XXXXXXXXXX|X||||||XXXXXXX|X|||X|-||||||X||||-|||||||||||XXX||||X|||||||||----XXX