------------------------------------------------------------------------------------------------------------------------------------------------------
------------------------------------------------------------------------------------------------------------------------------------------------------
------------------------------------------------------------------------------------------------------------------------------------------------------
------------------------------------------------------------------------------------------------------------------------------------------------------
------------------------------------------------------------------------------------------------------------------------------------------------------
------------------------------------------------------------------------------------------------------------------------------------------------------
--------------------------------------------------------------------------%---------------------------------------------------------------------------
--------------------------------------------------------------------------|---------------------------------------------------------------------------
--------------------------------------------------------------------------|---------------------------------------------------------------------------
--------------------------------------------------------------------------|-----------------------------------------------------------------------%---
--------------------------------------------------------------------------|-----------------------------------------------------------------------|---
--------------------------------------------------------------------------|-----------------------------------------------------------------------|---
------------%--------------------%----------------------------------------|-----%----------%-----%%--%%%%%---%-%%%------%%----%%%%%-%%%---%%------|---
------------|--------%%%%%%%%%%--K--%-----------------------------------%%%-----|%%%%%%%---|-----||--|||||---|-|||------||%---|||||-|||---||---%--|---
%%%%%%%%----|--------||||||||||%-%--|-------------------------------%%%%|||-----||||||||---|-----||--|||||---|-|||------|||---|||||-|||---||---|%-|--%
||||||||----|XXXXXXXX|||||||||||X|XX|XXXXXXXXXXXXXXXXXXXXXXXXXXXXXXX|||||||--XX-||||||||XXX|XXXXX||XX|||||X--|-|||--XXXX|||---|||||X|||---||---||X|XX|