------------------------------------------------------------------------------------------------------------------------------------------------------
------------------------------------------------------------------------------------------------------------------------------------------------------
------------------------------------------------------------------------------------------------------------------------------------------------------
------------------------------------------------------------------------------------------------------------------------------------------------------
------------------------------------------------------------------------------------------------------------------------------------------------------
------------------------------------------------------------------------------------------------------------------------------------------------------
------------------------------------------------------------------------------------------------------------------------------------------------------
------------------------------------------------------------------------------------------------------------------------------------------------------
------------------------------------------------------------------------------------------------------------------------------------------------------
------------------------------------------------------------------------------------------------------------------------------------------------------
-----------------------------------------------------------------------------------------------------t------%%----------------------------------------
-----------------------------------------------------------------------------------------------------t------||----------------------------------------
---------------------------------------%-%-----%%---------------------------------------------------%t------||---------------%%%--------%%%%%%-%--%---
-------------%------------------%%%%---|%|-----||-------%#---------%%%%---%%%%%%-%%-----------------|%------||---------%%%%%-|||-----%--||||||-|%-|---
%%%%%%%%%-%%-|-%-------%%-------||||---|||-----||------%|%---------||||%%%||||||-||-%------%%--%%---||------||--------%|||||-|||-----|--||||||-||-|---
|||||||||X||XX-|XXXXXXX||-XX-XXX|XXXXXX|||XXXXX||XXXXXX|||XXXXXXXXX||||||||X||||X||X|XXXXXX||X-||XXX||XX-XXX||XXXXXXXX||||||-||XXXXXX|-X||||||X||X|XXX