------------------------------------------------------------------------------------------------------------------------------------------------------
------------------------------------------------------------------------------------------------------------------------------------------------------
------------------------------------------------------------------------------------------------------------------------------------------------------
------------------------------------------------------------------------------------------------------------------------------------------------------
------------------------------------------------------------------------------------------------------------------------------------------------------
------------------------------------------------------------------------------------------------------------------------------------------------------
------------------------------------------------------------------------------------------------------------------------------------------------------
-----------------------------------------------------------------------------------------------------------------------------C------------------------
------------------------------------------------------------------------------------------------------------------------------------------------------
-------------------------------------------------------------------------CS---------------------------------------------------------------------------
------------------------------------------------------------------------------------------------------------------------------------------------------
----------------------------------------------%------------------------------------------------------------------------------%-----%------------------
--------------------%%------------------------|-------------------------%-----------%------------------------------%-----%%%-|-----|----------------%-
--------------------||----%-%%----------%-----%----------------%---%--%%|%-----%%---|-----------------------------%|---g-|||-|--%%%|--%%--%%%%%%%%%-|%
%%%%%%%%------------||%%%%|%||%%%-----%%|---%%|-------%--------|---|--||||-----||%--|-----------------------------||-----|||-|--||||--||--|||||||||-||
||||||||XXXXXXXXXX-X|||||||||||||XXXXX|||--X|||XXXXXXX|XXXXXXXX|XXX|-X||||-----|||XX|XXXXX-XXXXXXXXXXXXXXXXXXXXXXX||-XX-X|||X|XX|||X-X||-X|||||||||X||