------------------------------------------------------------------------------------------------------------------------------------------------------
------------------------------------------------------------------------------------------------------------------------------------------------------
------------------------------------------------------------------------------------------------------------------------------------------------------
------------------------------------------------------------------------------------------------------------------------------------------------------
------------------------------------------------------------------------------------------------------------------------------------------------------
-----------------------------------------------------------------------------------------------------------------------------------t------------------
-----------------------------------------------------------------------------------------------------------------------------------t------------------
-----------------------------------------------------------------------------------------------------------------------------------%------------------
-----------------------------------------------------------------------------------------------------------------------------------|------------------
-------------------------S---------------------------------------------------------------------------------------------------------|------------------
----------------------------------------------------------------------------%------%-----------------------------------------------|------------------
----------------------------------------------------------------------------|--S---|-----------------------------------------------|------------------
-----------------%-%%%%%%%--------------------------------------------%---%-|%%-%%%|----------------------------%---%%-------------|---------------%--
-----------------|-|||||||-%--%------------%--------------------------|---|-|||-||||----------------------------|%--||----%%---%%%%|%%%%%%%%-%%-%--|--
%%%%%%%%%%%%%%-%-|-|||||||-|--|------------|-------------%------------|---|%|||-||||--%-------------------------||--||----||---|||||||||||||%||-|--|%%
||||||||||||||-|X|X|||||||X|XX|XXXXXXXXXXXX|XXXXXXXXXXXXX|XXXXXXXXXXXX|XXX|||||XX|X|XX|XX-XXXXXX--XXXXXXXXXXXXXX||-X||XX--||XX-||||||||||||||||-|XXX||