------------------------------------------------------------------------------------------------------------------------------------------------------
------------------------------------------------------------------------------------------------------------------------------------------------------
------------------------------------------------------------------------------------------------------------------------------------------------------
------------------------------------------------------------------------------------------------------------------------------------------------------
------------------------------------------------------------------------------------------------------------------------------------------------------
------------------------------------------------------------------------------------------------------------------------------------------------------
------------------------------------------------------------------------------------------------------------------------------------------------------
------------------------------------------------------------------------------------------------------------------------------------------------------
----------------------%-------------------------------------------------------------------------------------------------------------------------------
----------------------|----------------------------------------------------------------------------------------------%--------------------------------
----------------------|----------------------------------------------------------------------------------------------|--------------------------%-----
----------------------|---------------------------------------------------------------------------------------%%-----|--------------------------|--%--
---------------------%|----------%%-%%%%--%%%%-------%%--------%--------------------------------------%%------||-----|--------------------------|%-|--
---------------------||----------||-||||--||||-------||--------|------------------------%-%%%%%-------||------||---%%|--------------------------||-|--
%%%%%%%%%%%%%%%--%%%%||%%%%%%%---||-||||-%||||-------||-----%%%|%-----------------------|-|||||-------||------||---|||--------------------------||-|--
|||||||||||||||X-|||||X|||||||-XX||X||||X|||||XXXXXXXXXXXXXX|||||XXX-XXXXXXXXXX-XXX-XXX-|X|||||XXXXXXX||XXXXXXX|XXX|||XXXXXXXXXXX-XXXXXXXXXXXXXX||XXXX