------------------------------------------------------------------------------------------------------------------------------------------------------
------------------------------------------------------------------------------------------------------------------------------------------------------
------------------------------------------------------------------------------------------------------------------------------------------------------
------------------------------------------------------------------------------------------------------------------------------------------------------
------------------------------------------------------------------------------------------------------------------------------------------------------
------------------------------------------------------------------------------------------------------------------------------------------------------
------------------------------------------------------------------------------------------------------------------------------------------------------
------------------------------------------------------------------------------------------------------------------------------------------------------
------------------------------------------------------------------------------------------------------------------------------------------------------
------------------------------------------------------------------------------------------------------------------------------------------------------
------------------------------------------------------------------------------------------------------------------------------------------------------
--------------------------------------------------------------------U----------%----------------------------------------------------------------------
------------------------------%%-------%%-%%-%---------------------------------|-----------------%------------------%---------------------------------
---------%%%%%----------------||--%%---||-||%|--%%%---------%%%%-----%-%-------|-------%%--------|-%--------------%-|-------%-----%%------------------
%%%%%%%%%|||||%%--%%----------||--||%%%||-||||--|||---------||||-----|-|-------|-------||--------|%|%%%%%---------|-|%------|-----||----%%%-------%---
||||||||||||||||XX||XXXXXXXXXX||XX|||||||X||||--|||XXXXXXXXX||||XXXXX|-|XXXXXXX|-XXXXXX||XXXXXXXX||||||||XXXXXXXXX|X||XXXXXXXXXXXX||-XXX|||XXXXXXX|XXX