------------------------------------------------------------------------------------------------------------------------------------------------------
------------------------------------------------------------------------------------------------------------------------------------------------------
------------------------------------------------------------------------------------------------------------------------------------------------------
------------------------------------------------------------------------------------------------------------------------------------------------------
------------------------------------------------------------------------------------------------------------------------------------------------------
------------------------------------------------------------------------------------------------------------------------------------------------------
------------------------------------------------------------------------------------------------------------------------------------------------------
------------------------------------------------------------------------------------------------------------------------------------------------------
------------------------------------------------------------------------------------------------------------------------------------------------------
------------------------------------------------------------%-------------------%---------------------------------------------------------------------
------------------------------------------------------------|-------------------|------------------------------------------------------%-%%-----------
------------------------------------------------------------|-------------------|------------------------------------------------------|-||-----------
----------------------------%-------------------------------|-------------------|-%----------------G------%%---------------------%%%--%|%||---------%-
----------------------------|----------------------%%%%%%%%%|%%---%------%%%----|-|------%--------%%%--%%-||%%%%%--%----%%-------|||--|||||-%-------|-
%%%%%%%%%-------------------|----------------------||||||||||||-%%|%%%%%%|||%%-%|%|-%%-%%|%%%%%%%%|||--||%|||||||-%|----||-%%----|||--|||||-|%------|-
|||||||||X----XXXXXX-XXXXXXX|XXXXXXXXXXXXXXXXXXXXXX||||||||||||-||||||||||||||-||||-||X||||||||||||||XX||||||||||-||XXXX||X||XX--|||XX|||||X||-XXXXX|X