------------------------------------------------------------------------------------------------------------------------------------------------------
------------------------------------------------------------------------------------------------------------------------------------------------------
------------------------------------------------------------------------------------------------------------------------------------------------------
------------------------------------------------------------------------------------------------------------------------------------------------------
-------------------------------------------------------------------------------------------------------------------------------------------------t----
---------D---------------------------------------------------------------------------------------------------------------------------------------t----
-------------------------------------------------------------------------------------------------------------------------------------------------%----
------------------------------------------------------------------------------D--------------------------------------%---------------------------|----
---------------------------------------------------------------------------------------------------------------------|-----------------------%---|----
------------------------------------------------------------------------------------------------------------%%-------|-----------------------|---|----
-----------------------------------------------------------%------------------------------------------------||-------|-------------%------%%%|---|----
---------%------------------------------2------------------|------------------------------------------------||-----%-|--%----------|------||||--%|----
---------|----------------------------------------%--------|------------------------------------------------||-----|-|--|--------%-|------|||t--||----
---------|----------------------------------------|--------|------------------%-----------------------------||-%%%%|%|%%|--------|%|%%%%--|||t--||--%%
%%%%%%%%-|%%%---------------------%%----------%%--|-------%|--%-------------%-|-----------------%%%---%-----||%||||||||||--------|||||||--|||%%%||%%||
||||||||X||||XXXXXXXXXXXXXXXXX-XX-||XXXXX-XXXX||XX|XXXXXXX||XX|XXXXXXXXXXXXX|X|XXXXXXXXXXXXXXXXX|||XXX|XXXXX||||||||||||XX--XXXXX|||||||XX||||||||||||