------------------------------------------------------------------------------------------------------------------------------------------------------
------------------------------------------------------------------------------------------------------------------------------------------------------
------------------------------------------------------------------------------------------------------------------------------------------------------
------------------------------------------------------------------------------------------------------------------------------------------------------
------------------------------------------------------------------------------------------------------------------------------------------------------
------------------------------------------------------------------------------------------------------------------------------------------------------
------------------------------------------------------------------------------------------------------------------------------------------------------
---------------------------------------------------------------------S--------------------------------------------------------------------------------
------------------------------------------------------------------------------------------------------------------------------------------------------
------------------------------------------------------------------------------------------------------------------------------------------------------
----------------%---------------------------------------------------%%-------------------------------------------------------%------------------------
----------------|---------------------------------------------------||-------------------------------------------------------|--------------------%---
----------------|----------------------------------------------%%%%%||%%%-----------------%%%%%%%%--%%------%%%%---%---------|--------------------|---
------------%%--|-------------------------%-%%%------------%%%-||||||||||-----------------||||||||--||------||||--%|%%%%%%%--|--------------------|---
%%%%%%%%%---||--|-------------------------|-|||--%%%%%%%%-%|||-||||||||||------%----------||||||||--||----%-||||--|||||||||--|-----%----%---------|---
|||||||||XX-XXX-|XXXXXXXXXXXXXXXXXXXXXXXXX|X|||XX||||||||-||||X||||||||||--XXXX|XXXXXXX---||||||||--||--XX|X||||X-|X|||||||XX|X---X|XXXX|XXXXXXXXX|XXX