------------------------------------------------------------------------------------------------------------------------------------------------------
------------------------------------------------------------------------------------------------------------------------------------------------------
------------------------------------------------------------------------------------------------------------------------------------------------------
------------------------------------------------------------------------------------------------------------------------------------------------------
------------------------------------------------------------------------------------------------------------------------------------------------------
------------------------------------------------------------------------------------------------------------------------------------------------------
------------------------------------------------------------------------------------------------------------------------------------------------------
------------------------------------------------------------------------------------------------------------------------------------------------------
------------------------------------------------------------------------------------------------------------------------------------------------------
------------------------------------------------------------------------------------------------------------------------------------------------------
-----------------------------------------------D---------------------------------------------------------------------------------------------------%--
------------------------------------------------------------------------------------------------------------%%%%%%%%%------------------------------|--
---------------------------------------------------------------%-------%%------------------C----------------|||||||||%%---%%%-------------%%-------|--
---------------------%-%%%%--%%%%%%%%-%%%%%%%%%%%%%------------|-------||------%----------------------------|||||||||||---|||-------------||-------|--
%%%%%%%%%%%-%%----%--|%||||--||||||||%%||||||||||||------------|----%--||---%--|%---------------------------|||||||||||---|||-------------||-------|--
|||||||||||X||XXXX|XX||||||XX||||||||||||||||||||||XXX--XXXXXXX|XX--|XX||XXX|XX||XXXXXXXXXXXXXXXXXXXXXXXXXXXXXXXXXXXX||XXX|||XX-XX--XXXXXX||XXXXXXX|--