------------------------------------------------------------------------------------------------------------------------------------------------------
------------------------------------------------------------------------------------------------------------------------------------------------------
------------------------------------------------------------------------------------------------------------------------------------------------------
------------------------------------------------------------------------------------------------------------------------------------------------------
------------------------------------------------------------------------------------------------------------------------------------------------------
------------------------------------------------------------------------------------------------------------------------------------------------------
------------------------------------------S-----------------------------------------------------------------------------------------------------------
------------------------------------------------------------------------------------------------------------------------------------------------------
------------------------------------------------------------------------------------------------------------------------------------------------------
------------------------------------------------------------------------------------------------------------------------------------------------------
-------------------------------------%%%--%-----------------------------------------------------------------------------------------------------------
--------------------g----------------|||--|---%-------------------------------------------------------------S-----------------------------------------
------------%--%-%%%-%---------------|||--|---|----%%%%%%%%%%%%%%-%%---------%--------%------------%%-%-%----------%---------------------------%------
------------|--|-|||-|---------------|||--|---|----||||||||||||||-||---------|--------|------------||-|-|----------|--%%%%%%%%%%-%--%----%%%%%%|------
%%%%%%%%---%|--|-|||-|-%%%%%%%%%%%%%%|||--|---|----||||||||||||||%||---------|--------|------------||-%-|-%%-%-%--%|--||||||||||-|--|----|||||||------
||||||||-XX||--|X|||X|-|||||||||||||||||XX|---|XXXX|||||||||||||||||XXXXXXXXX|XXXXXXX-|XXXXXXXXXXXX||X|-|X||X|X|XX||XX||||||||||X|XX|----|||||||XXXXXX