------------------------------------------------------------------------------------------------------------------------------------------------------
------------------------------------------------------------------------------------------------------------------------------------------------------
------------------------------------------------------------------------------------------------------------------------------------------------------
------------------------------------------------------------------------------------------------------------------------------------------------------
------------------------------------------------------------------------------------------------------------------------------------------------------
---------------------------------------------------------%--------------------------------------------------------------------------------------------
---------------------------------------------------------|--------------------------------------------------------------------------------------------
---------------------------------------------------------|--------------------------------------------------------------------------------------------
---------------------------------------------------------|---------------------------------%----------------------------------------------------------
---------------------%-----------------------------------|---------------------------------|----------------------------------------------------------
---------------------|-----------------------------------|---------------------------------|----------------------------------------------------------
---------------------|-----------------------------------|--------------------------------%|----------------------------------------------------------
---------------------|--------------------------------%--|--------------------------------||------%-------------------------%-------------------%%%---
-------------------%-|--------------------------------|--|---g----------------------------||------|-%------------------%%%--|%%-----g%%----%%%%%|||---
%%%%%%%%-%%%-------|-|--------------%%%%%%%%%%%%-%%---|--|-%-------%----%-----------------||%-----|-|------------------|||%%|||--%%--||----||||||||%--
||||||||X|||XXXXXXX|X|--XXXXXXXXXXXX||||||||||||X||XXX|XX|X|---XXXX|XXXX|XXXXXX-XXXXXXXXXX|||XXXXX|X|XXXXXXXXXXXXXXXXXX||||||||XX||--||XXXX||||||XX|-X