------------------------------------------------------------------------------------------------------------------------------------------------------
------------------------------------------------------------------------------------------------------------------------------------------------------
------------------------------------------------------------------------------------------------------------------------------------------------------
------------------------------------------------------------------------------------------------------------------------------------------------------
------------------------------------------------------------------------------------------------------------------------------------------------------
------------------------------------------------------------------------------------------------------------------------------------------------------
------------------------------------------------------------------------------------------------------------------------------------------------------
---------------------------------------------------------------------------------------------------------------------------------%--------------------
---------------------------------------------------------------------------------------------------------------------------------|--------------------
---------------%-----------------------------------------------------------------------------------------------------------------|-%------------------
---------------|----------------------------------------------------------------------------------------------------------S------|-|------------------
-----------SS--|------------------------%%---------------------------------------------------------------------------------------|C|------------------
---------------|----------%%%%%%%-------||--------------%-%-------------%----%--------%%%%%%%------------------------------------|-|------------------
---------------|----------|||||||-%%----||--------------|-|---%---%-----|%---|--------|||||||---%%%%%%%%%-%%---------------------|-|-------%%%%-------
%%%%%%%%--%----|-%%%%--%%%|||||||-||----||--------------|-|---|---|----%||---|--------|||||||---|||||||||%||----%%%%%%%---%--%---|-|-------||||-%--%--
||||||||XX|XXX-|-||||XX||||||||||-||-XXX||X-XXXXXXXXXXXX|X|XX-|XXX|XXXX|||XXX|XXXXXXXX|||||||---||||||||||||XXXX|||||||XXX|XX|XXX|X|XXXXXXX||||-|XX|XX