------------------------------------------------------------------------------------------------------------------------------------------------------
------------------------------------------------------------------------------------------------------------------------------------------------------
------------------------------------------------------------------------------------------------------------------------------------------------------
------------------------------------------------------------------------------------------------------------------------------------------------------
------------------------------------------------------------------------------------------------------------------------------------------------------
-------------------------------------------------------------------------------------------------------------------%----------------------------------
-------------------------------------------------------------------------------------------------------------------|----------------------------------
------------------------------------------------------------------------------------------------------------------%|----------------------------------
------------------------------------------------------------------------------------------------------------------||----------------------------------
------------------------------------------------------------------------------------------------------------------||----------------------------------
-----------------------------------------------------%------------------------------------------------------------||----------------------------------
-----------------------------------------------------|------%--------------------------------------%--------------|%----------------------------------
----------%-%%%%%-%----------%%%%-%--------%-------%%|------|---------------------------------%%%-%|----------%%--||------------------%---------------
----------|-|||||-|----------||||-|--------|-------|||%-----|-------------%--%%%%%---%%%---%-%|||%||-----%----||-%||------------------|---%%-%%%---%%%
%%%%%%%%%%|-|||||-|----------||||-|------%%|%%%%%%%||||%----|--%%%--------|--|||||---|||---|-|||||||-----|----||-|||----%--%------%%--|-%-||-|||%%%|||
|||||||||||-|||||X|X-XXXXXXXX||||X|XX-XXX||||||||||X||||XXXXXXX|||XXXXXXXX|XX|||||XX-|||XXX|X|XXX|||XXXXX|XXXXXXX|||XXXX|XX|XXXXXX||X-|-|X||-|||||||||