------------------------------------------------------------------------------------------------------------------------------------------------------
------------------------------------------------------------------------------------------------------------------------------------------------------
------------------------------------------------------------------------------------------------------------------------------------------------------
------------------------------------------------------------------------------------------------------------------------------------------------------
------------------------------------------------------------------------------------------------------------------------------------------------------
--------------------------------------------------------------------------------------------D---------------------------------------------------------
------------------------------------------------------------------------------------------------------------------------------------------------------
------------------------------------------------------------------------------------------------------------------------------------------------------
------------------------------------------------------------------------------------------------------------------------------------------------------
------------------------------------------------------------------------------------------------------------------------------------------------------
-------------------------------------------------%----------------------------------------------------------------------------------------------------
-------------------------------------------------|--------%---------------------------------%-%%------------------------------------------------------
--------------------------%---%%%----%-%---------|--------|----------------------%----%----%|-||------------------------------------------------------
--------------------------|---|||----|-|--%%%%---|------%%|%%%-%%%%%%%-----------|----|----||-||------------------------------------------------------
%%%%%%%%%----------%%%%%%%|%--|||----|%%%%||||%%%|----%%||||||-|||||||%-%%%%%----|%-%%|----||-||--------%%-----------%----%%----%%------------------%%
|||||||||XXXXXXXXXX|||||||||-X|||----|||||||||||||----||||||||X||||||||X|||||X---||-|||--X-||XXXXXXXXXXX||XXXXX-XXXXX|XXXX||XXXX||XXXXXXXXXXXXXXXXXX||