------------------------------------------------------------------------------------------------------------------------------------------------------
------------------------------------------------------------------------------------------------------------------------------------------------------
------------------------------------------------------------------------------------------------------------------------------------------------------
------------------------------------------------------------------------------------------------------------------------------------------------------
------------------------------------------------------------------------------------------------------------------------------------------------------
------------------------------------------------------------------------------------------------------------------------------------------------------
----------------------------------------------------------2-------------------------------------------------------------------------------------------
------------------------------------------------------------------------------------------------------------------------------------------------------
------------------------------------------------------------------------------------------------------------------------------------------------------
-----------------------------------------------------------------------------------------------------------------------------------------------%------
------------------------r---------------------------------%------------------------------------------------------------------------------------|------
------------------------%%--------------------------------|------------------------------------------------------------------------------------|------
------------------%%----||--%%%---%%%%%-------------------|------------------%--------%----------------------------------%----------%%%------%%|------
-----------%%%----||----||--|||---|||||-%%%%-%%-%%%%%%%%%-|%--%-%%%----------|--------|------------------------%---------|----------|||------|||--%%%%
%%%%%%%%%%%|||%%%%||%%--||%%|||%%-|||||%||||-||-|||||||||-||--|-|||----------|--------|--------------%-----%---|---------|%%%%%%%%-%|||------|||--||||
||||||||||||||||||||||XX|||||||||X||||||||||X||-|||||||||X||X-|X|||XXXXXXXXXX|-XXXXXXX|XXXXXXXXXXXXXX|XXXXX|-XXXXXXXXXXXX|||||||||X||||----XX|||-X||||