------------------------------------------------------------------------------------------------------------------------------------------------------
------------------------------------------------------------------------------------------------------------------------------------------------------
------------------------------------------------------------------------------------------------------------------------------------------------------
------------------------------------------------------------------------------------------------------------------------------------------------------
------------------------------------------------------------------------------------------------------------------------------------------------------
------------------------------------------------------------S-----------------------------------------------------------------------------------------
----------------------------------------------------%-------------------------------------------------------------------------------------------------
----------------------------------------------------|-%-------------------------------------------------------------------------------------------%---
----------------------------------------------------|-|-----------%--------------------------------------%----------------------------------------|---
----------------------------------------------------|-|-----------|--------------------------------------|----------------------------------------|---
----------%-----------------------------------------|-|-----------|--------------------------------------|----------------------------------------|---
----------|-----------------------------------------|-|-----------|--------------------------------------|----------------------------------------|---
----------|----------%------------------------------|-|-----------|---------%----------------------------|----------------------------%-%---------|%%-
---------%|----------|--------%---------------------|-|-----%-----|---------|-K--------------------------|---------------------%------|-|-------%%|||-
%%%%%%%%%||%%--------|-------%|---------------------|-|-----|----%%%%%-%%%%-|-%------%----%%%------------|--%%%----------------|------|-|-------|||||-
|||||||||||||XX--XXXX|XXXXXXX||XXXXXXXXXXXXXXXXXXXXX|X|-X-XX|XX--|||||X||||X|X|XXXXXX|XXXX|||-XXXXXXXXXXX|XX|||XXXXXXXXXXXXXXXX|-XXXXX|X|XXXXXXX|||XXX