------------------------------------------------------------------------------------------------------------------------------------------------------
------------------------------------------------------------------------------------------------------------------------------------------------------
------------------------------------------------------------------------------------------------------------------------------------------------------
------------------------------------------------------------------------------------------------------------------------------------------------------
------------------------------------------------------------------------------------------------------------------------------------------------------
-----------------------------------------------------------------------------------------------------------------------------------S------------------
----------------------------------------------------------------------------------------------------------%---%---------------------------------------
----------------------------------------------------------------------------------------------------------|---|---------------------------------------
----------------------------------------------------------------------------------------------------------|---|---------------------------------------
-------------------------------------------------------------------------------------------------------%--|---|---------------------------------------
-------------------------------------------------------------------------------------------------------|--|---|---------------------------------------
--------------------------------------%%---------------------------------------------------------------|--|---|---------------------------------------
--------------------------%-----------||-%%--%-%-------------------------------------------------%%%%%-|%-|---%------K--------%---%%----%-%--2%-------
------------------%--%----|-----------||-||--|-|-------------------------------------------%-----|||||-||-|---|--%--%%%---%%--|%%%||---%|-|---|----%%-
%%%%%%%%%%---%%---|--|----|-----------||-||--|-|------------%%%%%--------------------------|-----|||||-||%|---|--|--|||%--||--||||||---||-|---|----||-
||||||||||XXX||XXX|--|XXXX|XXXXXXXXXXXXXX||XX|X|XXXXXXXXXXXX|||||XXXXXXXXXXXXXXX-XXXXXXXXXX|XXXXXXXXXXX||||XXX|XX|XX||||XX||XX||||||---||-|XXX|XXXX||X