------------------------------------------------------------------------------------------------------------------------------------------------------
------------------------------------------------------------------------------------------------------------------------------------------------------
------------------------------------------------------------------------------------------------------------------------------------------------------
------------------------------------------------------------------------------------------------------------------------------------------------------
------------------------------------------------------------------------------------------------------------------------------------------------------
------------------------------------------------------------------------------------------------------------------------------------------------------
------------------------------------------------------------------------------------------------------------------------------------------------------
----------------------------------------------------------------------------%-------------------------------------------------------------------------
----------------------------------------------------------------------------|-------------------------------------------------------------------------
----------------------------------------------------------------------------|-------------------------------------------------------------------------
----------------------------------------------------------------------------|----------------------------%--------------------------------------------
------------------------------------------%---------------------------------|----------------------------|-----------------------------%----------%---
-----------------------------------------%|-------%%%%----------------------|-------------%--------------|-------------------#---------|----------|---
-----------------------------------------||--%%---||||----------------------%-------------|--------------|-------------------#---------|---%----%%|---
%%%%%%%%%----------------%----------%%%%-||--||---||||-------------%%%------|--%%---------|---------%%-%-|-------------------%---------|%%%|----|||---
|||||||||XXXXXXXXXXXXXXXX|XXXXXXXXXX||||X||--||--X||X|XXX-XXXXXXXXX|||XXXXXX|XX||XXXXXXXXX|XXXXXXXXX||-|X|XXXXXXXXXXXXXXXXXXX|-XXXXX--X|||||XXXX|||-XX