------------------------------------------------------------------------------------------------------------------------------------------------------
------------------------------------------------------------------------------------------------------------------------------------------------------
------------------------------------------------------------------------------------------------------------------------------------------------------
------------------------------------------------------------------------------------------------------------------------------------------------------
------------------------------------------------------------------------------------------------------------------------------------------------------
----------------------------------------------------------------------------------------------------------------------------------------%%------------
----------------------------------------------------------------------------------------------------------------------------------------||------------
----------------------------------------------------------------------------------------------------------------------------------------||------------
----------------------------------------------------------------------------------------------------------------------------------------||------------
----------------------------------------------------------------------------------------------------------------------------------------||------------
----------------------------------------------------------------------------------------------------------------------------------------||------------
--------------%-------------------------------------------------------------------------------------------------------------------------||------------
----------%%%%|%%%%%%%--------%---r-------------------------------%---%%%%-------%%----%%%%%%-------------------------------------------||----%-----#-
----------||||%|||||||------%%|%--%---%%%%--%%%%------------------|---||||%%%%%%%||----||||||-------%-------------%-----------------%%--||----|%-%%-%%
%%%%%%%%--||||||||||||------||||--|---||||--||||----%%%%%%%---%%%%|---|||||||||||||----||||||-------|------%--%%%%|---%%%-%%%----%--||--||-%--||-||-||
||||||||XX||||X|||||||--XXXX||||X-|XXX||||-X||||XXXX|||||||XXX|||||XXX|||||||||||||X---||||||-XXXXXX|XXXXXX|--|||||XXX|||-|||----|XX||--||X|XX||X||X||