------------------------------------------------------------------------------------------------------------------------------------------------------
------------------------------------------------------------------------------------------------------------------------------------------------------
------------------------------------------------------------------------------------------------------------------------------------------------------
------------------------------------------------------------------------------------------------------------------------------------------------------
------------------------------------------------------------------------------------------------------------------------------------------------------
------------------------------------------------------------------------------------------------------------------------------------------------------
------------------------------------------------------------------------------------------------------------------------------------------------------
-----------------------------------------------------------------%------------------------------------------------------------------------------------
-----------------------------------------------------------------|------------------------------------------------------------------------------------
-----------------------------------------------------------------|------------------------------------------------------------------------------------
-----------------------------------------------------------------|------------------------------------------------------------------------------------
------------------------------------S----------------------------|----------------------------------------------------%-------------------------------
-----------K-------------------%-----------------------%---------|-------%---%------------------%---------------------|-----------%---%%---%-%--------
-----------%-------------------|-------------%%%%%%----|---------|-------|---|------------------|---------------------|--------%--|---||---|-|---%%%%%
%%%%%%%%---|-------------------|-------%-----||||||#---|---------|-------|---|------------------|---------------------|--------|--|---||---|-|--%|||||
||||||||XXXXXXXXXXXXXXXXXXXXXXX|XXXXXXX|XXXXXXXXXXXXXXX|XXXXXXXXX|XXXXXXX|---|--XXXXXXXXXXXXXXXX|XXXXXXXXXXXXXXXXXXXXXXXXXXXXXX|XX|XXX||---|-|XX||||||