------------------------------------------------------------------------------------------------------------------------------------------------------
------------------------------------------------------------------------------------------------------------------------------------------------------
------------------------------------------------------------------------------------------------------------------------------------------------------
------------------------------------------------------------------------------------------------------------------------------------------------------
------------------------------------------------------------------------------------------------------------------------------------------------------
------------------------------------------------------------------------------------------------------------------------------------------------------
------------------------------------------------------------------------------------------------------------------------------------------------------
------------------------------------------------------------------------------------------------------------------------------------------------------
------------------------------------------------------------------------------------------------------------------------------------------------------
----------------------------------------------------------------------------------------------------------------------------------%-------------------
----------------------------------------------------------------------------------------------------------------------------------|-------------------
---------------------%--------------------------------------------------------------------%---------------------------------------|-------------------
------------%--------|--%%%-----------------------------%%--------------------------------|%%%%%%%%%%%%%-%%-----------------------|-------------------
----------%-|%%%%%---|--|||--%-%%%%%%%%%%%%%%%%%%%%%%---||-------%%-----------------------||||||||||||||-||-----------------------|--------------%---%
%%%%%%%%%%|-||||||%%%|--|||--|%||||||||||||||||||||||--%||-------||-----------------------||||||||||||||%||-----------------------|-------------%|%--|
|||||||||||-|||||||||XXXXXXXX||||||||||||||||||||||||--|||XXXXXXX||XXXXXXXXXXXX-XXXXXXXXXX|||||||||||||||||XXXXXXXXXXXXXXXXXXXXXXX|XXXX-XXXXXXXX|||XX|