------------------------------------------------------------------------------------------------------------------------------------------------------
------------------------------------------------------------------------------------------------------------------------------------------------------
------------------------------------------------------------------------------------------------------------------------------------------------------
------------------------------------------------------------------------------------------------------------------------------------------------------
------------------------------------------------------------------------------------------------------------------------------------------------------
------------------------------------------------------------------------------------------------------------------------------------------------------
------------------------------------------------------------------------------------------------------------------------------------------------------
--------------------------------------------------------------------------------------------------------------------------------------------------%---
--------------------------------------------------------------------------------------------------------------------------------------------------|---
-------------%------------------------------------------------------------------------------------------------------------------------------------|---
-------------|------------------------------------------------------------------------------------------------------------------------------------|---
-------------|%%%%--------------------------------------------------------------------------------------%---C-------------------------------------|---
-------------|||||%%-------------%%---------------------------------------------------------------------|-----------------------------------%%%---|---
-------------|||||||-------------||-------------%-----%-----%---------------------------------------%--%|-----------------%%%%%-------------|||---%---
%%%%%%%%-----|||||||-------------||-------------|-----|-----|---%-----------------------------%%%%%%|-%||---------------%-|||||-------------|||--%|--%
||||||||XXXXX|XXXX||XXXXXXXXXXX--||X--XXXXXXXXXX|XXXXX|XXXXX|XXX|XXXXXXXXXXXXXXXXXXXXXXXXXXXXX|||||||-|||XXXXXXXXXXXXXX-|X|||||-------XXXXXX|||-X||X-|