------------------------------------------------------------------------------------------------------------------------------------------------------
------------------------------------------------------------------------------------------------------------------------------------------------------
------------------------------------------------------------------------------------------------------------------------------------------------------
------------------------------------------------------------------------------------------------------------------------------------------------------
------------------------------------------------------------------------------------------------------------------------------------------------------
------------------------------------------------------------------------------------------------------------------------------------------------------
-----------------%--------------------------------------------------%---------------------------------------------------------------------------------
-----------------|--------------------------------------------------|---------------------------------------------------------------------------------
-----------------|--------------------------------------------------|---------------------------------------------------------------------------------
-----------------|--------------------------------------------------|---------------------------------------------------------------------------------
-----------------|---------------------------t----------------------|-------------%-------------------------------------------------------------------
-----------------|---------------------------t---%---------------%--|-------------|-----------C------------------2U-----------------------------------
----------%%%-%%%|-------------%%-%----------t---|-%%%-%-%--%----|--|-------------|-----------------------------------%--%--%%------------------------
----------|||-||||----%%-----%-||-|%%%%%%-%%-%%%%|-|||-|-|--|----|--|-------------|-----------------------------------|--|%%||------------------------
%%%%%%%%--|||-||||----||-----|-||-|||||||-||-|||||%|||-|-|--|----|--|-%-----------|-----------------------------------|--|||||-----------%--%%---%%%%%
||||||||XX|||X||||XXXX||XXXXX|-||XX||||||-||-|||||||||-|-|-X|XXXX|XX|X|XXXXXXXXXXX|XXXXXXXXXXXXXXXXXXXXXXXXXXXXXXXX--X|-X|||||XXX-XX---XX|XX||XXX|||||