------------------------------------------------------------------------------------------------------------------------------------------------------
------------------------------------------------------------------------------------------------------------------------------------------------------
------------------------------------------------------------------------------------------------------------------------------------------------------
------------------------------------------------------------------------------------------------------------------------------------------------------
------------------------------------------------------------------------------------------------------------------------------------------------------
------------------------------------------------------------------------------------------------------------------------------------------------------
------------------------------------------------------------------------------------------------------------------------------------------------------
------------------------------------------------------------------------------------------------------------------------------------------------------
------------------------------------------------------------------------------------------------------------------------------------------------------
-----------------------------------------------------------------------------------------D---------------------------%-%%--------------------------%--
----------%-%----------------------%---------------------------------------------------------------------------------|%||--------------%-----------|--
----------|-|-%--------------------|--------------------------------------------------------------------------------%||||2%----%-------g----------%|--
----------|-|%|--------%-----%--%%%|--%-%-%%%------------------------------------------------%%%-%%%%------%%%-%----|||||-|--%%|%--%%%%|--%-%%----||--
----------|-|||-%%-%%--|-----|--||||--|-|%|||-----------%%%-%-%%%%%%%%-----%%-------%--------|||-||||%%----|||-|%%--|||||-%--||||-%|||||--|-||--%%||%%
%%%%%%%%%-|-|||-||%||--|----%|--||||%%|-|||||---------%%|||-|-||||||||----%||%%%----|--------|||-||||||----|||-|||--|||||-|%-||||-||||||-%|-||--||||||
|||||||||-|X|||-|||||X-XXXXX||-X|||||||X|||||--XXXXXXX|||||X|X||||||||X---||||||X-XX|XXXXXXXX|||-||||||XXX-|||-|X|--X||||X||X||X|-|||||X-||X||X-||||||