------------------------------------------------------------------------------------------------------------------------------------------------------
------------------------------------------------------------------------------------------------------------------------------------------------------
------------------------------------------------------------------------------------------------------------------------------------------------------
------------------------------------------------------------------------------------------------------------------------------------------------------
------------------------------------------------------------------------------------------------------------------------------------------------------
------------------------------------------------------------------------------------------------------------------------------------------------------
------------------------------------------------------------------------------------------------------------------------------------------------------
------------------------------------------------------------------------------------------------------------------------------------------------------
------------------------------------------------------------------------------------------------------------------------------------------------------
------------------------------------------------------------------------------------------------------------------------------------------------------
------------------------------------------------------------------------------------------------------------------------------------------------------
------------------------------------------------------------------------------------------------------------------------------------------------------
--------------------------------------------------------------------------%---------------------------------------------%---------------%%%%-----%--%-
-----------------%---%%%%-------------------------------------------------|--------------%---%--------------------------%--------%------||||-----|--|-
%%%%%%%%---------|---||||-------%------------%%---%-----------------%-----|--------------|%%-|----%%------------------%%|-------%|-%----||||-----|--|-
||||||||XXXXXXXXX|XXX||||XXXXXXX|XXXXXXXXXXXX||-XX|XXXXXXXXXXXX---XX|XXXXX|XXXXXXXXXXXXXX|||X|X--X||XXXXXXX----XXXXXXX|||XXXXXXX||X|XXXX||||XXXXXXXXXX