------------------------------------------------------------------------------------------------------------------------------------------------------
------------------------------------------------------------------------------------------------------------------------------------------------------
------------------------------------------------------------------------------------------------------------------------------------------------------
------------------------------------------------------------------------------------------------------------------------------------------------------
------------------------------------------------------------------------------------------------------------------------------------------------------
----------------------%------------------------------------------------------%-----------------------------------------------------D------------------
----------------------|----------------------%-------------------------------|------------------------------------------------------------------------
----------------------|----------------------|-------------------------------|------------------------------------------------------------------------
----------------------|----------------------|-------------------------------|-------------------------------------------------%----------------------
----------------------|----------------------|------------------------%%-----|-------------------------------------------------|----------------------
----------------------|----------------------|------------------------||-----|--------------------------------------------%----|----------------------
-----------------%----|----------------------|------------------------||-----%--------------------------------------------|----|---D------------------
-----------------|----|------%----%%%----%-%-|---%-%%%%---------------||---%-|-------%--------------%-----------------%%--|-%%-|----------------------
-------------%%--|----%------|----|||%-%%|-|%|---|-||||---------------||---|-|-----%-|-------------%|----------------%||--|-||%|%%--%-%%-%--%---------
%%%%%%%%%%%--||%-|----|------|----||||%|||-|||---|%||||--%%%%%%-------||---|%|-----|%|-------------||----------------|||--|-||||||--|-||-|%-|-----%%%-
|||||||||||--|||X|XXXX|XXXXXX|XXXX||||||||X|||XX-||||||XX||||||XXXXXXX||XXX|||XX---|||XXXXX--XXXXXX||XXXXXXXXXXXXXXXXX||-X|X||||||-X|X||X||-|XX---|||X