------------------------------------------------------------------------------------------------------------------------------------------------------
------------------------------------------------------------------------------------------------------------------------------------------------------
------------------------------------------------------------------------------------------------------------------------------------------------------
------------------------------------------------------------------------------------------------------------------------------------------------------
------------------------------------------------------------------------------------------------------------------------------------------------------
------------------------------------------------------------------------------------------------------------------------------------------------------
------------------------------------------------------------------------------------------------------------------------------------------------------
------------------------------------------------------------------------------------------------------------------------------------------------------
---------------------------------------------------------------------------------------------t--------------------------------------------------------
------------------------------%%-------------------------------------------------------------t--------------------------------------------------------
-----------------------%------||-------------------------------------------------------------t-----------------------%--------------------------------
-----------------------|------||-----------------------------------%-------------------------%-----------------------|--------------------------------
-----------------------|-%%---||--------------------------%--------|-------------------------|-----------------------|--------------t-----------------
-----------------------|-||---||-----%--------%-----------|---%----|-------------------%%-%%%|%%%-------------%%----%|-----------%--t-----------------
%%%%%%%%%%-------------|-||---||----%|----%--%|-----------|---|----|--%%--%------------||-|||||||-%%%%%%%%%---||%---||--%--------|--t--%%%%%%%%%%-%%--
||||||||||XXXXXXXXXXXXX|X||XXX||XXXX||XXXX|X-||XXXXXXXXXXXXXXXXXXXXX-X||--|XXXXXX--XXXX||X|||X|||X|||||||||XXX|||XXX||XX|XXX-XXXX|XXXXX||||||||||X||XX