------------------------------------------------------------------------------------------------------------------------------------------------------
------------------------------------------------------------------------------------------------------------------------------------------------------
------------------------------------------------------------------------------------------------------------------------------------------------------
------------------------------------------------------------------------------------------------------------------------------------------------------
------------------------------------------------------------------------------------------------------------------------------------------------------
------------------------------------------------------------------------------------------------------------------------------------------------------
------------------------------------------------------------------------------------------------------------------------------------------------------
------------------------------------------------------------------------------------------------------------------------------------------------------
--------------------------------------------------------------------S---------------------------------------------------------------------------------
------------------------------------------------------------------------------------------------------------------------------------------------------
------------------------------------------------------------------------------------------------------------------------------------------------------
----------------T-------------------------t-----------------------------------------------------------------------------%-----------------------------
----------------t--%---%------------------t----%%-------------------%-----------------------------------%--------%------|%-----------------------%----
---------------%t--|---|---------%--------t----||-------------------|----------------------------%%%%%--|%%-%---%|-----%||-------%---%%%%%-%%--%%|%%%%
%%%%%%%%%%%%%%%|%%-|%%%|%%%------|--------%----||-------------------|-------------%%%------------|||||%%|||-|---||-----|||-------|---|||||-||--|||||||
||||||||||||||||||X||||||||XXXXXXXXXX-X-XX|X---||XXXXXXXXXXXXXXXXXXX|XXXXXXXFXXXXX|||XXXXXXXXXXXX||||||||||X|---||-----|X|XXXXXXX|XXX|||||-||--|||||||