------------------------------------------------------------------------------------------------------------------------------------------------------
------------------------------------------------------------------------------------------------------------------------------------------------------
------------------------------------------------------------------------------------------------------------------------------------------------------
------------------------------------------------------------------------------------------------------------------------------------------------------
------------------------------------------------------------------------------------------------------------------------------------------------------
-------------------------------------------------------------------------------------------------------------------------------------------------%----
-------------------------------------------------------------------------------------------------------------------------------------------------|----
-------------------------------------------------------------------------------------------------------------------------------------------------|----
-------------------------------------------------------------------------------------------------------------------------------------------------|----
-------------------------------------------------------------------------------------------------------------------------------------------------|----
-------------------------------------------------------------------------------------------------------------------------------------------------|----
------------%%%--------------------------%-------------------------------------------------------------------------------------------------------|----
------------|||--------------------------|--------------------------------------%%--------------------------------%%---%%%%-----------------%%%%%|----
---------%--|||%%-%------g------------%%-|--%%%%%--------------%----------------||----%%-%-------------%----------||---||||----%------------||||||-%--
%%%%%%%%-|-%|||||-|%------------------||-|--|||||---%%%%%%%%%%%|-%%%--%---------||----||-|--------%%%-%|--------%-||---||||----|------------||||||-|--
||||||||-|X|XXX||X||--XXXXX-XXXXXXXXXX||XXXX|||||XXX||||||||||||-|||XX|-X-XXXXX-||XXXX||X|XXXXXXXX|||X|XXXX----X|X||---||||XXXX|XXXXX-XXXXXX||||||X|XX