------------------------------------------------------------------------------------------------------------------------------------------------------
------------------------------------------------------------------------------------------------------------------------------------------------------
------------------------------------------------------------------------------------------------------------------------------------------------------
------------------------------------------------------------------------------------------------------------------------------------------------------
------------------------------------------------------------------------------------------------------------------------------------------------------
------------------------------------------------------------------------------------------------------------------------------------------------------
------------------------------------------------------------------------------------------------------------------------------------------------------
------------------------------------------------------------------------------------------------------------------------------------------------------
------------------------------------------------------------------------------------------------------------------------------------------------------
------------------------------------------------------------------------------------------------------------------------------------------------------
---------------------------------------------------------------------------------------------------------------------------------------%--------------
-----------------------------------------------------------------------%%--------------------------------------------------------------|--------------
-----------%%%-%----%%%%----%-----------------------------%------------||----%%%---%------------------------------%%%%%%%--%%--%%%-----|--------------
-----------|||-|----||||----|-----------%--%--------------|-%%%%--%%%--||---%|||---|------------%%-%%%%-----------|||||||--||-%|||-----|--------------
%%%%%%%%%%%|||%|-%%%||||%---|--------%%%|--|--------------|-||||--|||--||---||||---|--------X---||-||||-%-----%--%|||||||--||-||||-----|--------------
||||||||||||||||X||||||||X--|XXXXXXXX||||-XXXXXXX-XXXXXXX-|-||||--|||XX||-XX||||XXX|XXXXXXXXXXXX||X||||X|XXX-X|XX||||||||XX||X||||-XXXX|XXXXXXXXXXXXXX