------------------------------------------------------------------------------------------------------------------------------------------------------
------------------------------------------------------------------------------------------------------------------------------------------------------
------------------------------------------------------------------------------------------------------------------------------------------------------
------------------------------------------------------------------------------------------------------------------------------------------------------
------------------------------------------------------------------------------------------------------------------------------------------------------
------------------------------------------------------------------------------------------------------------------------------------------------------
------------------------------------------------------------------------------------------------------------------------------------------------------
----------D-------------------------------------------------------------------------------------------------------------------------------------------
------------------------------------------------------------------------------------------------------------------------------------------------------
------------------------------------------------------------------------------------------------------------------------------------------------------
-----------------------------------%------------------------------------------------------------------------------------------------------------------
------------------------------%----|--------%------%%%---------%%------------------------------------------%------------------------------------------
------------------------------|----|--------|------|||--------%||%%---------------------%------------------|----------------------------%-------------
----------%-------------------|----|------%-|---%--|||--------|||||---------------------|------------------|----------------------------|-------------
%%%%%%%%--|---------------%---|----|------|-|-%-|--|||--------|||||---------------------|-------------%%---|%%-----------------%--------|----------%%%
||||||||XX|XXXXXXXXXXXXXXX|XXX|XXXX|XXXXXX|-|-|X|--XXXX---XXXX|XX||XXXXXXXXXXXXXX-XXXXXX|XXXXXXXXXXXXX||XXXX||XXXXXXXXXXXXXXXX-|XXXXXXXX|XXXXXXXXXX|||