------------------------------------------------------------------------------------------------------------------------------------------------------
------------------------------------------------------------------------------------------------------------------------------------------------------
------------------------------------------------------------------------------------------------------------------------------------------------------
------------------------------------------------------------------------------------------------------------------------------------------------------
------------------------------------------------------------------------------------------------------------------------------------------------------
------------------------------------------------------------------------------------------------------------------------------------------------------
------------------------------------------------------------------------------------------------------------------------------------------------------
-----------------------------D--------------------------------------------%---------------------------------------------------------------------------
------------------------------------S-------------------------------------|----------------%----------------------------------------------------------
--------------------------------------------------------------------------|----------------|----------------------------------------------------------
-----------------------------%--------------------------------------------|%------%%%%%%%%-|----------------------------------------------------------
-----------------------------|----%%%--%---------------------------------%||------||||||||%|----------------------------------K-----------------------
-------------------%%--------|----%||%-|-----------------------------%---|||%%----||||||||||%%----------------------%%%%--%%%-%-----------------------
--------G----------||----%-%-|---%||||%|--------%--------------%-----|--%||%||%%%-||||||||||||--%%%%%%%-%%%%%--%----||||--|||%|---%------%--%--%%-----
%%%%%%%%%%%-%%%%%%%||--%%|%|-|---|||||||-------%|-%------------|--%--|--|||||||||-||||||||||||--|||||||-|||||%%|%%%-||||--|||||---|-%----|--|--||-----
|||||||||||-|||||||||XX|||||X|-XXX||||XXXXXXXXX||X|XXXXXXXXXXXX|XX|X-|--|X|||||||X||||||||||||--|||||||X|||||||X|||X||||XX||||XXXX|-|XXXX|XX|XX||XXXXX