------------------------------------------------------------------------------------------------------------------------------------------------------
------------------------------------------------------------------------------------------------------------------------------------------------------
------------------------------------------------------------------------------------------------------------------------------------------------------
------------------------------------------------------------------------------------------------------------------------------------------------------
------------------------------------------------------------------------------------------------------------------------------------------------------
------------------------------------------------------------------------------------------------------------------------------------------------------
----------------------------------------------------------------------------------------#-------------------------------------------------------------
----------------------------------------------------------------------------------------#-------------------------------------------------------------
----------------------------------------------------------------------------------------#-------------------------------------------------------------
--------------------------------------------------------------------------%-------------%-----------D-------------------------------------------------
--------------------------------------------------------------------------|-------------|-------------------%-----------------------------------------
---------------%----------------------------------------------------------|-------------|-------------------|----------------------------------------%
---------------|----------------------------------------------------------|-------------D------------------%|----------------------------------------|
---------------|--%-------%-%%-%%---%----------%------------------2%------|-------------D--------%%%-%%%%%-||------------%%%%--%---------------------|
%%%%%%%%%%%%%%-|--|-------|-||-||---|-------%%%|-------------------|%%%--%|-------------------%%-|||-|||||-||--%%%%%%%%%%||||--|---------------------|
||||||||||||||-|XX|XXXXXXX|X||X||XXX|XXXXXXX||||XXXXXXXXXXXX-XXXXXX||||XX||XXXXXXXXXX-XXXXXXXX||X|||X||||XX||--||||||||||||||XX|XXXXXXXX-XXXXXXXXXXXXX