------------------------------------------------------------------------------------------------------------------------------------------------------
------------------------------------------------------------------------------------------------------------------------------------------------------
------------------------------------------------------------------------------------------------------------------------------------------------------
------------------------------------------------------------------------------------------------------------------------------------------------------
------------------------------------------------------------------------------------------------------------------------------------------------------
------------------------------------------------------------------------------------------------------------------------------------------------------
------------------------------------------------------------------------------------------------------------------------------------------------------
----------------------------------------------------------%-------------------------------------------------------------------------------------------
----------------------------------------------------------|-------------------------------------------------------------------------------------------
----------------------------------------------------------|-------------------------------------------------------------------------------------------
----------------------------------------------------------|-----------------------------%-------------------------------------------------------------
-------------------t--------------------------------------|-----------------------------|-------------------------------------------------------------
-------------------T%---%---------------------------------|----%%--------------%%%%%--%%|----------------------------------%--------%----------%t----%
--------------%%%%-%|--%|%--------------------------------|---%||---------%----|||||%%|||%%---%-----%%---------------------|%-------|----------|t%%--|
%%%%%%%%%%%%%%||||%||--|||---%-------------%---%%--------%|%%%|||---------|%%%-||||||||||||---|-----||------------------%%%||%%%%%%%|%-------%-|t||--|
|||||||||||||||||||||--|||XXX|XXXXXXXXXXXXX|--X||XXXXXXXX||||||||XXXXXXXX-||||X||||||||||||XXX|XXXXX||XXXXX-XXXXXXX--XXX||||||||||||||XXXXXXX|X|X||XX|