------------------------------------------------------------------------------------------------------------------------------------------------------
------------------------------------------------------------------------------------------------------------------------------------------------------
------------------------------------------------------------------------------------------------------------------------------------------------------
------------------------------------------------------------------------------------------------------------------------------------------------------
------------------------------------------------------------------------------------------------------------------------------------------------------
------------------------------------------------------------------------------------------------------------------------------------------------------
------------------------------------------------------------------------------------------------------------------------------------------------------
------------------------------------------------------------------------------------------------------C-----------------------------------------------
--------------------------------------------------------------------------------------------------------------D---------------------------------------
------------------------------------------------------------------------------------------------------------------------------------------------------
----------------------------------------------------------------------------------------------------------SS-------------------------t---------------%
-------------------------------------------------------------------------------------------------------------------------------------t---------------|
--------%------------------------------------------------%%-%-------------------%%-----------------%--------%---%------------%-------t---------------|
--------|-----------%%%%%%----%%%%----%%-----------------||-%---------%%-%%%----||-------%%-%%%%%--|--%-%%--|--%|%%%%%%%%%%%%|%%%%%--%%--------------|
%%%%%%%%|-----------||||||----||||----||-------%%%-------||-|---------||%|||-%--||-------||-|||||%-|%%|-||%%|-%||||||||||||||||||||-%||--------------%
|||||||||XXXXXXX--XX||||||XXXX||||XXXX||XXXXXXX|||XX--XXX||XXXXXXXXXXX||||||-|XX||X-XXXXX||X||||||-||||X|||||X|||||||||||||||||||||-|||XX--XXXXXXXXXX|