------------------------------------------------------------------------------------------------------------------------------------------------------
------------------------------------------------------------------------------------------------------------------------------------------------------
------------------------------------------------------------------------------------------------------------------------------------------------------
------------------------------------------------------------------------------------------------------------------------------------------------------
------------------------------------------------------------------------------------------------------------------------------------------------------
------------------------------------------------------------------------------------------------------------------------------------------------------
------------------------------------------------------------------------------------------------------------------------------------------------------
------------------------------------------------------------------------------------------------------------------------------------------------------
---------------------------------------------------------------------%--------------------------------------------------------------------------------
---------------------------------------------------------------------|--------------------------------------------------------------------------------
---------------------------------------------------------------------|--------------------------------%%----------------------------------------------
---------------------------------------------------------------------|--------------------------------||----------------------------------------------
--------------%%-%---------------------------%%--%%-%%%-%%%%%-%%%%%%%|--------------%--------------%--||----%---------------------%-------------------
--------------||-|---------------------------||%-||-|||-|||||-||||||||---%--------%-|%%%%%%-%%%----|-%||%%--|--%%%%%%%%%%%%%------|-------------------
%%%%%%%%------||-|-%-------------------------|||%||-|||-|||||-||||||||---|------%%|-|||||||%|||-%%%|-|||||%-|%-|||||||||||||------|-------------------
||||||||XXXXXX||X|X|XX-XXXXXX--XXXXXXXXXXXXXX||||||X|||X|||||-||||||||XXX|XXXXXX|||X|||||||||||X||||-||||||X||X|||||||||||||XXXXXX|XXXXXXXXXXXXXXXXXXX