------------------------------------------------------------------------------------------------------------------------------------------------------
------------------------------------------------------------------------------------------------------------------------------------------------------
------------------------------------------------------------------------------------------------------------------------------------------------------
------------------------------------------------------------------------------------------------------------------------------------------------------
------------------------------------------------------------------------------------------------------------------------------------------------------
------------------------------------------------------------------------------------------------------------------------------------------------------
------------------------------------------------------------------------------------------------------------------------------------------------------
------------------------------------------------------------------------------------------------------------------------------------------------------
------------------------------------------------------------------------------------------------------------------------------------------------------
------------------------------------------------------------------------------------------------------------------------------------------------------
------------------------------------------------------------------------------------------------------------------------------------------------------
----------------------------------------------------------------------------------------------------------------------------------%%%--------%--------
--------------------%%------------------------------------------------------------------------------------------------------------|||%%-----%|--%%%---
--------------------||----------------------------------------------------------------------%---%%%%%%%%%%%%%%%----------------%%-|||||%----||--|||---
%%%%%%%%%%%%%-%%%%%-||-------------------------%%%%-%%%%%--%%--------------%----------------|%--|||||||||||||||----------------||-||||||----||--|||---
|||||||||||||X|||||X||XXXXX--XXXXXXXX-XXX------||||-|||||XX||XXXXXX-XX-XXXX|XXXX-X--XXXXXXXX||-X||||||||||||||XXXXXXXXXXXXXXXXXX|XXXXXX|XXXX|XXX|||XXX