------------------------------------------------------------------------------------------------------------------------------------------------------
------------------------------------------------------------------------------------------------------------------------------------------------------
------------------------------------------------------------------------------------------------------------------------------------------------------
------------------------------------------------------------------------------------------------------------------------------------------------------
------------------------------------------------------------------------------------------------------------------------------------------------------
------------------------------------------------------------------------------------------------------------------------------------------------------
------------------------------------------------------------------------------------------------------------------------------------------------------
------------------------------------------------------------------------------------------------------------------------------------------------------
------------------------------------------------------------------------------------------------------------------------------------------------------
------------------------------------------------------------------------------------------------------------------------------------------------------
----------------------------------------------------------------------%------------------r----------------------------------------------------------%-
----------------------------------------------------------------------|------------------%%---------------------------------------------------------|-
---------%%%---------------%---%------%----%%%------------------------|---%%%----%%%--%%%||---------------%%-%%%%%%%--------------------------------|-
---------|||---------------|---|------|----|||%%%%---%%-%%%%%%%-------|---|||----|||--|||||---------------||-|||||||-----%%%-%%%%%%-----------------|-
%%%%%%%%%|||-%%%%%%%%%%----|%%%|-%%---|%%%-|||||||%--||-|||||||%%%%%%%|%%-|||----|||%%|||||---------------||-|||||||-----|||-||||||---%-------------|-
||||||||||||-||||||||||XXXX|||||-||-XX||||-||||||||XX||X|||||||||||||||||X|||XXXX||||||||||XXXXXXXXXX--XXX||X|||||||XX---|||X||||||--X|XXX-X-XXXXXXX|X