------------------------------------------------------------------------------------------------------------------------------------------------------
------------------------------------------------------------------------------------------------------------------------------------------------------
------------------------------------------------------------------------------------------------------------------------------------------------------
------------------------------------------------------------------------------------------------------------------------------------------------------
------------------------------------------------------------------------------------------------------------------------------------------------------
------------------------------------------------------------------------------------------------------------------------------------------------------
------------------------------------------------------------------------------------------------------------------------------------------------------
------------------------------------------------------------------------------------------------------------------------D-----------------------------
--------------------------------------------------------------------------------------------------------------------------------------------------D---
------------------------------------------------------------------------------------------------------------------------------------------------------
------------------------------------------------------------------%-------------%---------------------------------------------------------------------
------------------------------------------------------------------|-------------|---------------------------------------------------------------------
-------------------------------------------2--------------%-------|-------------|-----------------------------------------------------%%-%%%%%%%%%-%%%
-----------------C---------------------------------%%-----|-------|---%%%%-%%%%-|%%%%%%-%-------%-%---------------------%-------------||-|||||||||-|||
%%%%%%%%%-------------------%-%%%%------------%%%%-||----%|-------|---||||-||||-|||||||-|-------|-|---------------------|-----%---%--%||-|||||||||%|||
|||||||||-----XXXXXXXXXXXXXX|-||||XXXXXXXXXXXX||||X||XXXX||XXXXXXX|XXX||||-||||X|||||||X|-XXX-XX|-|XXXXXXXXXXXXXXX-XXXX-|XXXXX|XXX|XX|XX-|||||||||||||