------------------------------------------------------------------------------------------------------------------------------------------------------
------------------------------------------------------------------------------------------------------------------------------------------------------
------------------------------------------------------------------------------------------------------------------------------------------------------
------------------------------------------------------------------------------------------------------------------------------------------------------
------------------------------------------------------------------------------------------------------------------------------------------------------
------------------------------------------------------------------------------------------------------------------------------------------------------
------------------------------------------------------------------------------------------------------------------------------------------------------
------------------------------------------------------------------------------------------------------------------------------------------------------
------------------------------------------------------------------------------------------------------------------------------------------------------
----------------------------------------------------------------%-------------------------------------------------------------------------------------
----------------------------------------------------------------|-------------------------------------------------------------------------------------
----------------------------------------------------------------|---------------------------------------------------%-----------------------------S---
------------%---------------------------------t-----------------|-----%%--------------------%---------------------%-|---------%----------------%------
----------%%|-%%%%%-%-------%---------------g-t-----------------|-----||----------------%---|%%%%%----------------|-|---------|----------------|------
%%%%%%%%%-|||-|||||-|-------|--%--------------t-----------------|----%||----------------|-%-||||||%%%%----%-------|-|---------|------%---------|------
|||||||||-|||-|||||-|XXXXXXXXXX|XXXXXX-XXXXXXXXXXXXXX-XXXX-XXXXX|XXXX|||XXXXXXXXXXXXXXXX|-|X|X||||||||XXXX|XXXXXX-|X|XXXXXXXXX|XXXXXX|XXXXXXXXX|XXXXXX