------------------------------------------------------------------------------------------------------------------------------------------------------
------------------------------------------------------------------------------------------------------------------------------------------------------
------------------------------------------------------------------------------------------------------------------------------------------------------
------------------------------------------------------------------------------------------------------------------------------------------------------
------------------------------------------------------------------------------------------------------------------------------------------------------
------------------------------------------------------------------------------------------------------------------------------------------------------
------------------------------------------------------------------------------------------------------------------------------------------------------
------------------------------------------------------------------------------------------------------------------------------------------------------
------------------------------------------------------------------------------------------------------------------------------------------------------
------------------------------------------------------------------------------------------------------------------------------------------------------
-------------------------------------------------------%------------------------------------------%------------------------------------------------%--
--------------------%----------------------------------|------------------------------------------|------------------------------------------%%----|--
--------------------|------------%---%--------%--------|------------------------%%----%-----------|%%--%%--------%---------------------%%%---||----|--
-----------------%-%|--%--------g|---|--------|-g------|-------------%%%-%%%%%%-||---%|-----------|||%-||%-------|---%%%---------------|||%--||----|--
%%%%%%%%%---%----|-||--|----%----|---|----%-%-|--------|-------------|||-||||||-||%--||--%%%%%%---||||-|||-%%%%%%|%%F|||--------%------||||--||---%|--
|||||||||XX-|XXXX|X||--|----|XX--|XXX|XXXX|X|X|-X----XX|XXXXXXXXXXXXX|||X||||||X|||-X||--||||||XXX||||-|||-|||||||||X|||XXXXXXXX|XXXX--|||X--||---||--