------------------------------------------------------------------------------------------------------------------------------------------------------
------------------------------------------------------------------------------------------------------------------------------------------------------
------------------------------------------------------------------------------------------------------------------------------------------------------
------------------------------------------------------------------------------------------------------------------------------------------------------
------------------------------------------------------------------------------------------------------------------------------------------------------
------------------------------------------------------------------------------------------------------------------------------------------------------
------------------------------------------------------------------------------------------------------------------------------------------------------
------------------------------------------------------------------------------------------------------------------------------------------------------
-----------------------------------------------------------------------------------------------------------------------------------------D------------
---------------------------S--------------------------------------------------------------------------------------------------------------------------
---------------------------------------------------------%--------------------------------------------------------------------------------------------
-----------%---------------------------------------------|----%----%--------------------------------------------------%---------------%%%-------%-----
-----------|----------------------%----%------%%---------|----|----|------------------%%--%--%------------------------|---------------|||-%--%%%|%%---
-----------|-------------%%%------|%---|------||--%%%----|----|----|----%-------------||--|--|---------------------%%-|%------%%------|||-|--||||||---
%%%%%%%%---|-------------|||------||---|------||-%|||---%|%%--|----%----|%--%---------||--|--|----------------%----||-||------||------|||%|--||||||---
||||||||XXX|X--XXX--XXXXX|||--XXXX||XXX|XXXXXX||X|XXXXXX||||XX|XXXX|XX--||XX|XXXXXXXXX||XX|XX|XXXXX--XXXXXXXXX|XXXX||X||XX--XX||------XXX||--||||||XXX