------------------------------------------------------------------------------------------------------------------------------------------------------
------------------------------------------------------------------------------------------------------------------------------------------------------
------------------------------------------------------------------------------------------------------------------------------------------------------
------------------------------------------------------------------------------------------------------------------------------------------------------
-----------------------------------------------------------------------------------------------------------------------------------------------------%
-----------------------------------------------------------------------------------------------------------------------------------------------------|
-----------------------------------------------------------------------------------------------------------------------------------------------------|
-----------------------------------------------------------------------------------------------------------------------------------------------------D
------------------------------------------------------------------------------------------------------------------------------------------------------
--------------------------------------------------------------------------------------%---------------------------------------------------------------
--------------------------------------------------------------------------------------|------------------------------------------------------%--------
-------------------------------------------------%------------------------------------|------------------------------------------------------|--------
------------%%--------%%%%---%-------------------|---%--%---------------------%%%-%%-%|%%----%%%%-%%-%%%%-%-------------------------%--------|---%----
-----------%||--------||||---|-----%%%%----%%%%%-|%%%|%%|%%%%%--%%%-%%%--%%%%-|||-||-||||----||||-||%||||-|-------------------%%----|%%----%%|-%-|%%%%
%%%%%%%%%--|||--------||||---|-%%-%||||----|||||-|||||||||||||%%|||-|||--||||-|||%||-||||----||||-|||||||%|--%--%%%%%------%--||----|||----||%-|-|||||
|||||||||--|||-XXXXXX-||||X-X|X||X|||||----|||||X||||||||||||||||||X|||X-X|||X||||||X||||XXX-||||X|||||||||XX|XX|||||XXXX--|XXXXX-XX|||--XX|||-|-|||||