------------------------------------------------------------------------------------------------------------------------------------------------------
------------------------------------------------------------------------------------------------------------------------------------------------------
------------------------------------------------------------------------------------------------------------------------------------------------------
------------------------------------------------------------------------------------------------------------------------------------------------------
------------------------------------------------------------------------------------------------------------------------------------------------------
------------------------------------------------------------------------------------------------------------------------------------------------------
------------------------------------------------------------------------------------------------------------------------------------------------------
------------------------------------------------------------------------------------------------------------------------------------------------------
------------------------------------------------------------------------------------------------------------------------------------------------------
------------------------------------------------------------------------------------------------------------------------------------------------------
------------------------------------------------------------------------------------------------------------------------------------%-----------------
------------------------------------------------------------------------------S----------------%------------------------------------|------------%%---
----------------%%%-%%%%%%%%%%%------------------------------------------------%---------%%%%--|--%---%-------------------%%---%----|--------%-%-||%%%
----------------|||-|||||||||||----------#-------------------------------------|---------||||%%|--|---|-------------------||---|%%%-|--------|-|-|||||
%%%%%%%%%%%%%%%%|||%|||||||||||--------%%%%------------------------------------|---------|||||||--|---|---------%------%--||---||||-|--------|-|-|||||
|||||||||||||||||||||||||||||||X-XXXXXX||||X---XXXXXXXXXXXXXXXXXXXXXXXXXXXXXXXX|XXX-XXXXX||||XX|XX|XXX|XXXXXXXXX|-XXXXX|--||-XX|XXXX|XXXXXXXX|X|X|||||