------------------------------------------------------------------------------------------------------------------------------------------------------
------------------------------------------------------------------------------------------------------------------------------------------------------
------------------------------------------------------------------------------------------------------------------------------------------------------
------------------------------------------------------------------------------------------------------------------------------------------------------
------------------------------------------------------------------------------------------------------------------------------------------------------
------------------------------------------------------------------------------------------------------------------------------------------------------
------------------------------------------------------------------------------------------------------------------------------------------------------
------------------------------------------------------------------------------------------------------------------------------------------------------
------------------------------------------------------------------------------------------------------------------------------------------------------
------------------------------------------------------------------------------------------------------------------------------------------------------
------------------------------------------------------------------------------------------------------------------------------------------------------
----------------%-------------------------------------------------------------------------------------------------------------------------------------
----------------|%%-----------------%%--%-%--------%------------------%-%----%-%%%%%-%%%-%----------------%%------------------------------------------
----------------|||-----------------||-%|-|--------|------%%%%%-------|-|%%%-|%|||||-|||-|------%------%%-||%%%%%%%%%%-----------------------%%%------
%%%%%%%%--------|||----------%--%%--||-||-|----%---|------|||||-%%%%%%|%||||-|||||||-|||-|--%---|%%%%%%||-||||||||||||--%%%%-----------------|||------
||||||||XXXXXXXX|||XXX-X-XX--|XX||XX||XX|-|XXXX|XXX|XXXXXX|||||X||||||||||||X|||||||X|||X|-X|XXX|||||||||X||||||||||||XX||||XXXXXXXXXXXXXXXXXXXXXXXXXX