------------------------------------------------------------------------------------------------------------------------------------------------------
------------------------------------------------------------------------------------------------------------------------------------------------------
------------------------------------------------------------------------------------------------------------------------------------------------------
------------------------------------------------------------------------------------------------------------------------------------------------------
------------------------------------------------------------------------------------------------------------------------------------------------------
------------------------------------S-----------------------------------------------------------------------------------------------------------------
------------------------------------------------------------------------------------------------------------------------------------------------------
------------------------------------------------------------------------------------------------------------------------------------------------------
------------------------------------%-----------------------------------------------------------------------------------------------------------------
------------------------------------|-----------------------------------------------------------------------------------------------------------------
------------------------------------|--------------------------------------------------%-------------------------------------------------------------%
---------------------------C--------|--------------------------------------------------|----------------------------%--------------------------------|
--------%----------%----------------t-------------%---------%%%%%%%%%%%%%%%%%%%%%------|----------------------------|--------------------%---%%%---%-|
--------|----------|------%---%--%%%t%----%%----%-|%%%%-----|||||||||||||||||||||------|------------------------%%--|--------------------|%%%|||---|%|
%%%%%%%%|%%%%%%%%%%|------|---|-%|||%|----||----|%|||||-----|||||||||||||||||||||%-%%--|------------------------||--|%%%--------%--------|||||||-%%|||
||||||||||||||||||||XXXXXX|XXX|X|||X||XXXXXXXX--X||X|||XXXXX||||||||||||||||||||||X||XX|XXXXXXXXXXXXXXXXXXXXXXXX||XXX|||XXXXXXXX|XXXXXXXX|XX||||-|||||