------------------------------------------------------------------------------------------------------------------------------------------------------
------------------------------------------------------------------------------------------------------------------------------------------------------
------------------------------------------------------------------------------------------------------------------------------------------------------
------------------------------------------------------------------------------------------------------------------------------------------------------
------------------------------------------------------------------------------------------------------------------------------------------------------
---------------------------------------------------%---------------------------------%----------------------------------------------------------------
---------------------------------------------------|---------------------------------|----------------------------------------------------------------
---------------------------------------------------|---------------------------------|----------------------------------------------------------------
---------------------------------------------------|---------------------------------|----------------------------------------------------------------
---------------------------------------------------|---------------------------------|-------------------------------------------------------------%--
---------------------------------------------------|---------------------------------|------------------------------------------------------------%|--
---------------------------------------U-----------|---------------------------------|-----------------------------------------------------%------||--
------------------%-----%-----------------------%--|---------------------------%%%%%%|---%-------------------------------------------%%%---|------||--
------------------|-----|--------%%%-----%%%%%--|%-|%%%%%-%%-%-----%%---%-%----|||||||---|--------------------------G----------------|||%--|-%----||--
%%%%%%%%----------|-----|--------|||-----|||||%%||-||||||-||-|-----||--%|-|%%%%|||||||---|--------------------------%--------------%%||||--|-|----||--
||||||||XXXXXXXXXX|-XXXX|XXXXXX-X|||XX-XX|||||||||X||||||-||X|XXXXX||XX||X||||||||||||X-X|--XXXXXXXXXXXXXXXXXXXXXXXX|XXXXXXXXXXXXXX||||X|XXXX|XXXX||XX