------------------------------------------------------------------------------------------------------------------------------------------------------
------------------------------------------------------------------------------------------------------------------------------------------------------
------------------------------------------------------------------------------------------------------------------------------------------------------
------------------------------------------------------------------------------------------------------------------------------------------------------
------------------------------------------------------------------------------------------------------------------------------------------------------
------------------------------------------------------------------------------------------------------------------------------------------------------
------------------------------------------------------------------------------------------------------------------------------------------------------
------------------------------------------------------------------------------------------------------------------------------------------------------
-----------------------------------------------------------------------------------%------------------------------------------------------------------
-----------------------------------------------------------------------------------|------------------------------------------------------------------
-----------------------------------------------------------------------------------|------------------------------------------------------------------
-------------------------G---------------------------------------------------------|-------------------------------%----------------------------------
-------------------%%%%%%%--------%----------------%%--%%%%%-----%%----------------|---------%--%%--------------%--|---------%-%----------------------
---------%---------|||||||---%%---|--------------%-||--|||||-----||----------------|---------|--||--------------|--|---------|-|%-%%%%%%%%%%----------
%%%%%%%%%|%%%%%%%--|||||||-%%||-%-|--------------|%||%-|||||---%-||----------------|%-------%|--||--------------|%%|---------|-|%%||||||||||----------
|||||||||||||||||X-XXXXXXXX||||-|-|---XXXXXXXXXXX|||||-|||||---|-||XXXXXXXXXXXXXXXX||XXXXXXX||--||XXXXXXXXXXXXXX||||--XXXXXXX|X|||||||||||||XXXXXXXXXX