------------------------------------------------------------------------------------------------------------------------------------------------------
------------------------------------------------------------------------------------------------------------------------------------------------------
------------------------------------------------------------------------------------------------------------------------------------------------------
------------------------------------------------------------------------------------------------------------------------------------------------------
------------------------------------------------------------------------------------------------------------------------------------------------------
-----------------------------------------------------------------------------------------------------------------------------------%------------------
-----------------------------------------------------------------------------------------------------------------------------------|------------------
-----------------------------------------------------------------------------------------------------------------------------------|------------------
-------------------------S---------------------------------------------------------------------------------------------%-----------|------------------
-----------------------------------------------------------------------------------------------------------------------|-----------|------------------
-----------------------------------------------------------------------------------------------------------------------|-----------|------------------
-----------------------------------------------------------------------------------------------------------------------|--G--------|------------------
----------%%----------%%%%---------------------------------------------------------------------------------------------|--%%%%%%%--|----%-%---%---%%%%
----------||----------||||---%%%%%%%------------------------------------%-----------------------------------------%%---|--|||||||--|----|-|---|---||||
%%%%%%%%--||%%-%%%%%%%||||%--|||||||-%%-------------------------%-------|-%--------------------------------%%%%%%%||%%%|--|||||||--|----|-|---|---||||
||||||||XX||||-||||||||||||X-|||||||X||XX--XXXXXXXXXXXX-XXXXXXXX|XXX----|X|XXXXXXXXXXXXXXXXXXXXXXXXXXXX----|||||||||||||XXXXXXXXXXX|-XXX|X|XXX|---||||