------------------------------------------------------------------------------------------------------------------------------------------------------
------------------------------------------------------------------------------------------------------------------------------------------------------
------------------------------------------------------------------------------------------------------------------------------------------------------
------------------------------------------------------------------------------------------------------------------------------------------------------
------------------------------------------------------------------------------------------------------------------------------------------------------
------------------------------------------------------------------------------------------------------------------------------------------------------
------------------------------------------------------------------------------------------------------------------------------------------------------
------------------------------------------------------------------------------------------------------------------------------------------------------
--------------------------------------------------%---------------------------------------------------------------------------------------------------
--------------------------------------------------|---------------------------------------------------------------------------------------------------
--------------------------------------------------|------------------------------------------------%--------------------------------------------------
--------------------------------------------------|-----------------%%%-%%%%--------%--------------|--------------------------------------------------
-----------------%%---------------------%---------|-----------------|||-||%|----%%%-|%-------------|-------%--%--------------------------------------%
-----------------||----------------%----|%%%---%%%|%%---------------|||-||||----|||%||%--%%%%%%%%%%|%%-%%%%|--|----------------------------%%%%%-----|
%%%%%%%%%%%-%---%||----------%-%%%%|----||||---||||||-%---------%%--|||-||||----|||||||--|||||||||||||-|||||%%%------------------------%-%-|||||-%%%-|
|||||||||||-|XX-|||XXXXXXXXXX|-|||||----||||--X||||||-|XXXXXXXXX||XXXXXXXX|XXXXX||||X||XX|||||||||||||-||||||||XXXXXXXXXXXXXXXXXX-XXXXX|X|-|||||-|||X|