------------------------------------------------------------------------------------------------------------------------------------------------------
------------------------------------------------------------------------------------------------------------------------------------------------------
------------------------------------------------------------------------------------------------------------------------------------------------------
------------------------------------------------------------------------------------------------------------------------------------------------------
------------------------------------------------------------------------------------------------------------------------------------------------------
------------------------------------------------------------------------------------------------------------------------------------------------------
------------------------------------------------------------------------------------------------------------------------------------------------------
------------------------------------------------------------------------------------------------------------------------------------------------------
------------------------------------------------------------------------------------------------------------------------------------------------------
---------------%-------------------------------------------------%------------------------------------------------------------------------------------
---------------|-------------------------------------------------|------------------------%-----------------------------------------------------------
----------%----|-------------------------------------------------|-------%----------------|-----------------------------------------------------------
----------|----|----------%--------------%-%%--%----------%%%----|----%--|----------------|-----------%%%-%%%---%%%----%------------------------------
----------|----%-----S----|--------------|-||--|----------|||----|----|--|----------------|-%%--------|||%|||%%-|||--%-|%-%-------------%%------------
%%%%%%%%%%|----|-%-----%%-|--------------|-||--|----%-%%--|||----|----|--|-%%-------%%----|-||--------|||||||||-|||-%|-||-|------------%||---%--------
|||||||||||XXXX|X|XX-X-||XXX--XXXXXXXXX--|X||XX|----|X||XX|||----|--XX|--|X||--XXXXX||XXXX|XX|XXXXXXX-|||||||||-|||X||X||X|XXXX--XXXXXX|||XXX|X--XXXXX