------------------------------------------------------------------------------------------------------------------------------------------------------
------------------------------------------------------------------------------------------------------------------------------------------------------
------------------------------------------------------------------------------------------------------------------------------------------------------
------------------------------------------------------------------------------------------------------------------------------------------------------
------------------------------------------------------------------------------------------------------------------------------------------------------
------------------------------------------------------------------------------------------------------------------------------------------------------
------------------------------------------------------------------------------------------------------------------------------------------------------
------------------------------------------------------------------------------------------------------------------------------------------------------
------------------------------------------------------------------------------------------------------------------------------------------------------
---------------------------------------------------------------%--------------------------------------------------------------------------------------
---------------------------------------------------------------|--------------------------------------------------------------------%-----------------
-------------------%-------------------------------------------|--------------------------%-------------------%%--------------------|------C----------
-------------------|-%%%%%%%%%%%--%%%-%%%%--%%-----------------|--%%%%-%%%%%%----%--%-----|%--------------%%%-||--------------------|-----------------
---------------%%--|-|||||||||||--|||-||||--||%--------%-------|--||||%||||||%%--|--|-----||----%---%-----|||-||%---------%---------|-----%-----------
%%%%%%%%%%%----||--|-|||||||||||--|||%||||--|||--------|-------|--|||||||||||||--|--|%%---||----|---|-----|||%|||---------|---------|-----|%-------%--
|||||||||||-XXX||-XX-|||||||||||-X||||||||X-|||X-XXXXXXXXXXXXXX|XX||||X||||||||XX|--|||XX-X|XXXX|XXXXX--XX||||XX|XXXXXXXXX|XXXXXXXXX|XXXXX||-XX----|XX