------------------------------------------------------------------------------------------------------------------------------------------------------
------------------------------------------------------------------------------------------------------------------------------------------------------
------------------------------------------------------------------------------------------------------------------------------------------------------
------------------------------------------------------------------------------------------------------------------------------------------------------
------------------------------------------------------------------------------------------------------------------------------------------------------
----------------------------------------------------------------------------------------%-------------------------------------------------------------
--------------------------------------------------------------------------%-------------|-------------------------------------------------------------
--------------------------------------------------------------------------|-------------|-------------------------------------------------------------
--------------------------------------------------------------------------|-------------|-------------------------------------------------------------
---------------------------------------------------------------------%----|-------------|-------------------------------------------------------------
----------------------------%------------%-----------------------%%--|----|-------------|-------------------------------------------------------------
------------%---------------|------------|-----------------------||-%|----#-------------%-------------------------------------------------------------
------------|------%%-------|------------|%%%%-----%%-------%----||-||----%------------%|-------------------------------------------------------------
-----------%|-%%---||-------|---%%%%%%%%-|||||-----||------%|---%||%||%%--|-%----------||-------------%---------%%%--%--%%%-----%---------------------
%%%%%%%%%%-||%||%%%||%-%%%--|%%-||||||||%|||||-%%%-||%%%---||---||||||||--|-|%---------||-------------|%--%%%%%-|||-%|%%|||%%%%%|-%-------------------
||||||||||-|||||||||||-|||X-|||X||||||||||||||-|||X|||||XXX||X--||||X|||XX|-||XXXXXXXXX||XXXXXXXXXXXXX||X-|||||X|||-|||||||||||||X|XXXXXXXXXXXXXXXXXXX