------------------------------------------------------------------------------------------------------------------------------------------------------
------------------------------------------------------------------------------------------------------------------------------------------------------
------------------------------------------------------------------------------------------------------------------------------------------------------
------------------------------------------------------------------------------------------------------------------------------------------------------
------------------------------------------------------------------------------------------------------------------------------------------------------
------------------------------------------------------------------------------------------------------------------------------------------------------
------------------------------------------------------------------------------------------------------------------------------------------------------
-------------------------------------------------------------------------------------------------------------------------------------------%----------
-------------------------------------------------------------------------------------------------------------------------------------------|----------
-----------------------------%%--------------------------------------------------------------%---------------------------------------------|----------
---------------%-------------||----------------------------%%--------------------------------|---------------------------------------------|----------
---------------|-------------||----------------------------||--------------------%-----------|---------------------------------------------|----------
---------------|%--------%%-%||%---------------------------||--------------%-----|-----------|---------------%------------------------%%%%%|%---------
---------%%%%--%|--------||%||||---------------------------||--------------|-----|%%----%%%%%|---%%%%%-----%%|---%-%-----%%-----------|||||||%%%--%%%%
%%%%%%%%%||||--||---%%%%%|||||||---------------------------||------------%%|%----|||%---||||||---|||||%%%%%|||---|-|-----||-----------||||||||||--||||
|||||||||||||XX|XXXX||||||||||||XXXXX-X--XXXXXXXXXXXXXXXXXX||X-XXXXXXXXXX||||-XXX||||--X||||||---|||||||||||||XXX|X|XXXXX||XXXXXXXXXXX||||||||||-X||||