------------------------------------------------------------------------------------------------------------------------------------------------------
------------------------------------------------------------------------------------------------------------------------------------------------------
------------------------------------------------------------------------------------------------------------------------------------------------------
------------------------------------------------------------------------------------------------------------------------------------------------------
------------------------------------------------------------------------------------------------------------------------------------------------------
------------------------------------------------------------------------------------------------------------------------------------------------------
------------------------------------------------------------------------------------------------------------------------------------------------------
--------------D---------------------------------------------------------------------------------------------------------------------------------------
----------------------------------------------%-------------------------------------------------------------------------------------------------------
----------------------------------------------|-------------------------------------------------------------------------------------------------------
----------------------------------------------|-----------------------%-------------------------------------------------------------------------------
-----------------------%----------------------|-----------------------|-----------------G------------------------------------SSS----------------------
-----------------------|---%---------%%-%%----|-----------------------|---%----------%%-%----%-----------------------------------%------------%---%%--
-----------%%-%--------|---|---------||-||--%%|%%%--------------------|---|%%%%%%%%%%||-|-%%%|-----%-----------------------------|--%---------|---||--
%%%%%%%%%%%||-|%-------|---|---------||-||%%||||||---%%%--------%%%%--|%%-|||||||||||||-|%||||-----|-----------------------------|--|-%-------|---||--
|||||||||||||X||X-XXXXXXXXX|X-XXXXXXX|XX||||||||||XXX|||XXXXXXXX||||--|||X|||||||||||||-||||||XXXXX|XXXXXXXXXXXXXXXXXXXXXX---XXXXXXX|X|XXXXXXX|XXX||XX