------------------------------------------------------------------------------------------------------------------------------------------------------
------------------------------------------------------------------------------------------------------------------------------------------------------
------------------------------------------------------------------------------------------------------------------------------------------------------
------------------------------------------------------------------------------------------------------------------------------------------------------
------------------------------------------------------------------------------------------------------------------------------------------------------
------------------------------------------------------------------------------------------------------------------------------------------------------
------------------------------------------------------------------------------------------------------------------------------------------------------
------------------------------------------------------------------------------------------------------------------------------------------------------
------------------------------------------------------------------------------------------------------------------------------------------------------
------------------------------------------------------------------------------------------------------------------------------------------------------
------------------------------------------------------------------------------------------------------------------------------------------------------
-------------------------------------------------------------C------------------------------------------%--------------%%-----------------------------
---------%%------------%------------%--%--%--%%%%%%-----------------------------------------------------|--------------||------------%--------%-------
---------||------------|--%---------|#-|--|--||||||---%%%%%%%-%%-%%%-----%%---%---%%----------%%%%%-----%--------------||------------|%%------|-----%-
%%%%%%%%%||----%%%%-%%%|--|%%%%%----|%-|--|--||||||---|||||||-||-|||-----||---|---||----------|||||---%%|--------------||------------|||------|----%|-
|||||||||XXXXXX||||-||||XX||||||-XXX||X|XX|-X||||||XXX|||||||X||X|||-X---||XXXX-XXXXXXXXXXXXXX|||||X-X||X-XXXXXXXXXXXXX||XXXXXXXXXXXX|||XXXXXX|XXXX||X