------------------------------------------------------------------------------------------------------------------------------------------------------
------------------------------------------------------------------------------------------------------------------------------------------------------
------------------------------------------------------------------------------------------------------------------------------------------------------
------------------------------------------------------------------------------------------------------------------------------------------------------
------------------------------------------------------------------------------------------------------------------------------------------------------
------------------------------------------------------------------------------------------------------------------------------------------------------
------------------------------------------------------------------------------------------------------------------------------------------------------
------------------------------------------------------------------------------------------------------------------------------------------------------
------------------------------------------------------------------------------------------------------------------------------------------------------
------------------------------------------------------------------------------------------------------------------------------------------------------
---------%%-------------------------------------------------------------------------------------------------------------------------------------------
---------||---------------------------------------------------------------%%--------------------------------------------------------------------------
---------||-----%--%--------%-------------------------------%-------------||-------------------------%---------------------%%%%------------------%----
---------||-----|%-|--------|-------------%------------%----|-------------||-----------------------%%|---------------%%----||||---gg-----%-----%%|--%-
%%%%%%%%%||-----||-|-------%|---%---------|%%----------|----|------%------||--%--------------------|||-%%------------||----||||----------|---%-|||--|-
|||||||||||XXXXX||X|XXXXXXX||--X|XXXXXXXXX|||XXXXXXXXXX|X-X-|X-XXXX|-XXXXXXXXX|XXXXXXXXXXXXXXXXXXXX|||-||XXXXXXXXXXXXXXXXXX||||XXXXXXXXXX|XXX|-||X--|X