------------------------------------------------------------------------------------------------------------------------------------------------------
------------------------------------------------------------------------------------------------------------------------------------------------------
------------------------------------------------------------------------------------------------------------------------------------------------------
------------------------------------------------------------------------------------------------------------------------------------------------------
------------------------------------------------------------------------------------------------------------------------------------------------------
------------------------------------------------------------------------------------------------------------------------------------------------------
-------------------------------------------------------------------------------------------------------------------%----------------------------------
-----------------------------------------------------------------------------------------%-------------------------|----------------------------------
--------------------------------------------------------------------------U--------------|-------------------------|----------------------------------
-----------------------------------------------------------------------------------------|--------C----------------|----------------------------------
---------------------------------------------%-------------------------------------------|--------------%------%---%----------------------------------
---------------%--------%----%---------------|-------------------------------------------|--------------|------|---|----------------------------------
---------------|---%----|----|---------------|%%-----------------%------%%%--------------|------%--%%---|%%%---|---|----------------------------------
---------------|---|%---|%%--|---------------|||-----------%%%%%%|%%%%--|||--------------|------|--||---||||---|%--|----------------------------------
%%%%%%%%%%%%%%%|---||--%|||--|---------------|||----------%|||||||||||--|||%%%%%---------|------|--||---||||---||--|------%%----%%-----%%%%----------%
||||||||||||||||XXXX|XX|X||-XXXXXXXXXXXXXXXXX|||-XXXXXXXXX||||||X|XXX|X-||||||||XXXXXXXXX|XXX-XX|XX||XXX||||XXX||XX|XXXXXX||---X||XXXXX||||-XXXXXXXXX|