------------------------------------------------------------------------------------------------------------------------------------------------------
------------------------------------------------------------------------------------------------------------------------------------------------------
------------------------------------------------------------------------------------------------------------------------------------------------------
-------------------------------------------------------------------------------------------------------------C----------------------------------------
------------------------------------------------------------------------------------------------------------------------------------------------------
------------------------------------------------------------------------------------------------------------------------------------------------------
------------------------------------------------------------------------------------------------------------------------------------------------------
------------------------%----%---------------------------------------------------------D---------------------%----------------------------------------
------------------------|----|-------------------------------------------------------------------------------|----------------------------------------
------------------------|----|-------------------------------------------------------------------------------|-----------------------%%---------------
------------------------|----|---------------------------------------------------------g---------------------|-----------------------||---------------
------------------------|----|-------------------------------------------------------%%%---------------------|------%----%%%%-----%--|%---------------
--------------%%%%%%%%%-|%%%%|-%-%---%------%-%%%%%%%-------------------------------%|||-%-------------------|------|%%%-||||%%--%|--||-----%%%%%--%--
--------------|||||||||-||||||-|-|%%-|------|-|||||||----%%---%%%%-%%%%-%-----------||||-|-------------------|------||||-||||||--||%-%%-----|||||--|--
%%%%%%%%%%-%-%|||||||||-||||||-|-|||-|%-----|-|||||||----||--%||||-||||%|%%%%%%----%||||-|-------%-----------|--%---||||-||||||-%|||-||--%--|||||--|--
||||||||||-|X||||||||||X||||||-|-|||XX|XXXXX|-|||||||XXXX||--|||||-||||||||||||XXXX|||||X|XXXXXXX|XXXXXXXXXXX|-X|X--X|||-XXXX||X||X|X||XX|--|||||XX|XX