------------------------------------------------------------------------------------------------------------------------------------------------------
------------------------------------------------------------------------------------------------------------------------------------------------------
------------------------------------------------------------------------------------------------------------------------------------------------------
------------------------------------------------------------------------------------------------------------------------------------------------------
------------------------------------------------------------------------------------------------------------------------------------------------------
------------------------------------------------------------------------------------------------------------------------------------------------------
------------------------------------------------------------------------------------------------------------------------------------------------------
------------------------------------------------------------------------------------------------------------------------------------------------------
------------------------------------------------------------------------------------------------------------------------------------------------------
---------------------%-------------------------------------%%-%---------------------------------------------------------------------------------------
---------------------|-------------------------------------||-|----------------%----------------------------------------------------------------------
---------------------|-------------------------------------||-|----------------|-------------------------------------------%--------------------------
------------%%%%%%%%-|%%%%%%%%%--%%--%%--------------------||-%%-%%%%----------|------%%%%----------%%----------%%--%------|--------------------%-----
---------%%-||||||||-||||||||||--||--||%-------------------||-||-||||-%--------|------||||--------%-||----------||--|%-----|--------------------|-----
%%%%%%%%%||%||||||||-||||||||||--||--|||---------------%%%-||-||-||||-|--%%%%%%|%%----||||--------|-||----------||%%||%%---|-------------%---%--|-----
||||||||||||||||||||-||||||||||XX||XX|||XXXXXXXXXXXX-XX|||X|X-||X||||X|X-|||||||||XXXXXXXXXXXXXXXX|X||----XXXXXX||||||||XXXXXXXXXXXXXXXXX|--X|XX|XXXXX