------------------------------------------------------------------------------------------------------------------------------------------------------
------------------------------------------------------------------------------------------------------------------------------------------------------
------------------------------------------------------------------------------------------------------------------------------------------------------
------------------------------------------------------------------------------------------------------------------------------------------------------
------------------------------------------------------------------------------------------------------------------------------------------------------
------------------------------------------------------------------------------------------------------------------------------------------------------
------------------------------------------------------------------------------------------------------------------------------------------------------
------------------------------------------------------------------------------------------------------D-----------------------------------------------
------------------------------------------------------------------------------------------------------------------------------------------------------
-------------------------------------------------------------S----------------------------------------------------------------------------------------
-------------------------------------------------------2----------------------------------------%-----------------------------------------------------
------------------------------------------------------------------------------------------------|-------------------------%---------------------------
---------%%%---------------------------------------------------------------%%-----------%-------|--------G----%-----------|------------------%%%%-----
---------|||%--------------------%-------------%%%%%---%--%%%%-------------||-----------|-------|-----%-%%%%%-|-%%%%%%%%%%|------------------||||-----
%%%%%%%%%||||--------------------|-------------|||||---|--||||------%------||%----%-----|-------|-----|-|||||-|-|||||||||||------------------||||-----
|||||||||||||XXXXXXXXXXXXXXXXXXXX|XXXXXXXX--XXX|||||XXX|XX|XX|XXXXX-|XXXXXX|||XXXX|XXXXX|XXXXXXX|XX-XX|X|||||-|-|||||||||||XXXXXXXXXXXXXXXXX-||||XXXXX