------------------------------------------------------------------------------------------------------------------------------------------------------
------------------------------------------------------------------------------------------------------------------------------------------------------
------------------------------------------------------------------------------------------------------------------------------------------------------
------------------------------------------------------------------------------------------------------------------------------------------------------
------------------------------------------------------------------------------------------------------------------------------------------------------
------------------------------------------------------------------------------------------------------------------------------------------------------
------------------------------------------------------------------------------------------------------------------------------------------------------
-------------------------------------%----------------------------------------------------------------------------------------------------------------
-------------------------------------|----------------------------------------------------------------------------------------------------------------
-------------------------------------|----------------------------------------------------------------------------------------------------------------
-------------------------------------|----------------------------------------------------------------------------------------------------------------
-------------------------------------|-----%--------------------------%-------------------------------------------------------------------------------
----------------%--------------------|-----|---%%---%%%---%%%%%------%|-------%--------------------%---%-----------%---%-------------%%%%%---%%-%----%
----------G-%%--|--%---%%%%%%--%%%-%%%---%-|r--||--%|||---|||||-----%||--%----|---%%%-%%-----------|---|%%%%%%%-%%-|-%-|---%%--%%----|||||---||-|----|
%%%%%%%%%-%-||%-|--|--%||||||--|||-|||%--|-|---||--||||---|||||%----|||--|----|---|||-||-%--%------|---||||||||-||-|-|-|---||--||---%|||||---||-|----|
|||||||||X|X|||XXXX|XX|||||||XX|||X||||--|X|XXX||XX||||XXX||||||XXXXX|X--|XXXX|XXX|||X||X|XX|XXXXXX|XXX||||||||X||-|-|X|XX-||XX||XXX||||||XXX||X|----|