------------------------------------------------------------------------------------------------------------------------------------------------------
------------------------------------------------------------------------------------------------------------------------------------------------------
------------------------------------------------------------------------------------------------------------------------------------------------------
------------------------------------------------------------------------------------------------------------------------------------------------------
------------------------------------------------------------------------------------------------------------------------------------------------------
--------------------------------------------------------------------------S---------------------------------------------------------------------------
------------------------------------------------------------------------------------------------------------------------------------------------------
------------------------------------------------------------------------------------------------------------------------------------------------------
--------------------------------------------------------------------%%--------------------------------------------------------------------------------
--------------------------------------------------------------------||----%-----------------------------------------------------%---------------------
-------------------------------2------%-----------------------------||-%--|-------------------------------------------------%%%%|-%-%%%%%-------------
--------------------------------------|-----------------------------||-|--|--------------------------------------%%--%%%----|||||-|-|||||-------------
----------------%----------------%%-%%|%%%----------%%%%%-%-------%-||-|-%|-----------------------------------%--||--|||----|||||-|%|||||-------------
------------%---|--%-%%%%%%%%----||-||||||----------|||||-|---%---|-||-|-||-%%-%%-----------------------------|--||--|||%%%%|||||-|||||||%%%%--%------
%%%%%%%%%-%%|---|-%|-||||||||--%-||-||||||---%------|||||-|---|---|-||%|-||-||-||-------------%---%%----------|--||--||||||||||||-|||||||||||--|%%----
|||||||||X|||XXX|X||-||||||||XX|X||-||||||XXX|XXXXXX|||||X|XXX|XXX|X||||X||-||-||XXXXXXX-XXXXX|XXX||XXXXXXXXXX|XX||XX||||||||||||-|||||||||||--|||--XX