------------------------------------------------------------------------------------------------------------------------------------------------------
------------------------------------------------------------------------------------------------------------------------------------------------------
------------------------------------------------------------------------------------------------------------------------------------------------------
------------------------------------------------------------------------------------------------------------------------------------------------------
------------------------------------------------------------------------------------------------------------------------------------------------------
----------------------------------------------------------------------------------D-------------------------------------------------------------------
------------------------------------------------------------------------------------------------------------------------------------------------------
--------------------------------%---------------------------------------------------------------------------------------------------------------------
--------------------------------|---------------------------------------------------------------------------------------------------------------------
----------------------%---------|---------------------------------------------------------------------------------------------------------------------
----------------------|---------|---------------------------------------------------------------------------------------------------------%-%%--------
----------------------|---------|-----------------%%--------------------------------------------------------------------------------------|-||--------
----------------------|%--------|%%-------------%-||-------------------------------------------%-%--------------%%-%%--------------%%%----%-||%%------
----------------------||%--%%%-%|||------%%%%%%-|%||------------------------------%------------|-%---%%%-%%%----||-||--------------|||----|-||||------
%%%%%%%%%%%-----------|||%%|||-||||------||||||-||||--------------------%-----%%--|-%%%%%%%%%--|-|---|||-|||----||-||--%%----------|||---%|%||||------
|||||||||||XX-XXXXXXXX||||||||X||||X-----||||||-||XXXXXXXXXXXXXXXXXXXXXX|X----||XX|X|||||||||XX|X|-X-|||-|||XXXX||X||X-||XXXXXXXXXX|||--X|||||||XX--XX