------------------------------------------------------------------------------------------------------------------------------------------------------
------------------------------------------------------------------------------------------------------------------------------------------------------
------------------------------------------------------------------------------------------------------------------------------------------------------
------------------------------------------------------------------------------------------------------------------------------------------------------
------------------------------------------------------------------------------------------------------------------------------------------------------
--------------------------------------------------------------------------------------------------%---------------------------------------------------
--------------------------------------------------------------------------------------------------|---------------------------------------------------
--------------------------------------------------------------------------------------------------|---------------------------------------------------
--------------------------------------S-----------------------------------------------------------|---------------------------------------------------
--------------------------------------------------------------------------------------------------|---------------------------------------------------
-------------------------------------------------------------%------------------------------------|---------------------------------------------------
-------------%----------------------------------------------%|------------------------------------%---------------------------------------------------
-------------|%--------------------%--%---------------------||------------------------------------|-----------%%%%%%%--------------------------------%
-------------||--------------------|-%|-%%%%%----%%%%------%||%----------------------------%------|------%----|||||||--------------------------------|
%%%%%%%%%-%--||--------------------|-||-|||||----||||----%-||||%%%--%%---------------------|%%%%%%|--%%-%|---%|||||||%%%%%%%%%%%%%-----------%%--%---|
|||||||||X|XX|XXXXXXXXXX--XXXXXXXXX|X||-|||||---X||||----|X|||||||XX||XXXXXXXXXXXXXXXX---XX||||||||--||X||X--|||||||||||||||||||||X-XXXXXXXXX||XX|XXX|