------------------------------------------------------------------------------------------------------------------------------------------------------
------------------------------------------------------------------------------------------------------------------------------------------------------
------------------------------------------------------------------------------------------------------------------------------------------------------
------------------------------------------------------------------------------------------------------------------------------------------------------
------------------------------------------------------------------------------------------------------------------------------------------------------
------------------------------------------------------------------------------------------------------------------------------------------------------
------------------------------------------------------------------------------------------------------------------------------------------------------
------------------------------------------------------------------------------------------------------------------------------------------------------
------------------------------------------------------------------------------------------------------------------------------------------------------
------------------------------------------------------------------------------------------------------------------------------------------------------
---------------------%--------------------------------------------------------------------------------------------------------------------------------
---------------------|--------------------------------------------------------------------------------------------------------------------------------
---------------------|----------%%-%-%%%%%%%%%%---%--%%%%%%%%-%%%%%-----#--------%---%--------------------------------------%-----------------------%-
----------------%%-%%|----------||-|%||||||||||---|--||||||||-|||||-----#---%----|---|--------------------%----------%------|%----%-%%%%%%%---%--%%%|-
%%%%%%%%%-%-----||%|||%---------||-||||||||||||---|--||||||||-|||||-----%%--|----|---|%----------------%--|---------%|------||-%%%|%|||||||%--|--||||-
|||||||||X|X---X|||||||X-XXXXXXX||-|X||||||||||---|-X||||||||-|||||XXX-X||XX|XXXX|XX-||XXXXXXXX--XXXXXX|--|X-XXXX-XX||XXXXX-||-|||||||||||||XX|-X|XX|X