------------------------------------------------------------------------------------------------------------------------------------------------------
------------------------------------------------------------------------------------------------------------------------------------------------------
------------------------------------------------------------------------------------------------------------------------------------------------------
------------------------------------------------------------------------------------------------------------------------------------------------------
------------------------------------------------------------------------------------------------------------------------------------------------------
------------------------------------------------------------------------------------------------------------------------------------------------------
------------------------------------------------------------------------------------------------------------------------------------------------------
------------------------------------------------------------------------------------------------------------------------------------------------------
------------------------------------------------------------------------------------------------------------------------------------------------------
------------------------------------------------------------------------------------------------------------------------------------------------------
---------------------------------------------------%----------------------------------------------------------------------U----------------------%----
--------------%---%--------------------------------|---------------------------------------------------------------------------------------------|----
--------%-----|---|------%%%%-%%%%%%%-----%----%---|--------------------------%%%--------------------------------------------------%-------------|--%-
--------|-----|---|----%-||||-|||||||%-%%%|----|---|---------------%----------|||%-%%--%%%%%%%%%%---------%%-----%----%--%-%-r-----|-------------|--|-
%%%%%%%%|%-%%-|-%%|----|-||||-||||||||-||||----|%--|%----%------%-%|%-%%-%%---||||-||--||||||||||---------||-----|-%--|--|%|%%-%%--|--------%%---|--|-
||||||||||X||XXX||XXXXX|X||||-||||||||X||||XXX-||XX||----|XXX-X-|-|||X||-||XXX||||X||--||||||||||XXX---XXX||XX---|X|XXXXX|||||X||X-|XXX-X-X-||XXX|XX|X