------------------------------------------------------------------------------------------------------------------------------------------------------
------------------------------------------------------------------------------------------------------------------------------------------------------
------------------------------------------------------------------------------------------------------------------------------------------------------
------------------------------------------------------------------------------------------------------------------------------------------------------
------------------------------------------------------------------------------------------------------------------------------------------------------
--------------------------------------------------%---------------------------------------------------------%-----------------------------------------
--------------------------------------------------|---------------------------------------------------------|-----------------------------------------
--------------------------------------------------|---------------------------------------------------------|----------------%------------------------
------------------------------------------------S-|---------------------------------------------------------|----------------|------------------------
--------------------------------------------------|---------------------------------------------------------|----------------|------------------------
--------------%----------------t------------------|--------------------------------------------------%------|----------%---%-|-%%%%%------------%%--%-
--------------|----------------t------------------%----------------g---------------------------------|------|----------|---|-|-|||||------------||--|%
--------------|---------%------t-%----------%---%-|------------%%%----%-%----------------%--%--%%----|---%--|---%%%----|--%|-|-|||||------------||--||
--------------|--%----%%|----%%%%|%%%------%|---|-|------------|||----|-|-------------%--|--|--||----|--%|--|---|||---%|--||-|%|||||%%----%-----||--||
%%%%%%%%---%%%|--|---%|||----||||||||------||--%|-|---------%--|||----|-|----%-%------|--|--|--||----|%-||--|---|||%--||--||-%||||||||----|----%||--||
||||||||XXX||||XX|XXX||||XXXX||||||||X--XXX||XX||-|XXXXXX--X|XX|||-XXX|X|XXXX|-|---XXX|XX|--XXXX|-XX-||XX|XX|XX-||||XX||X-||X|||||||||---X|XXXX|||XX||