------------------------------------------------------------------------------------------------------------------------------------------------------
------------------------------------------------------------------------------------------------------------------------------------------------------
------------------------------------------------------------------------------------------------------------------------------------------------------
------------------------------------------------------------------------------------------------------------------------------------------------------
------------------------------------------------------------------------------------------------------------------------------------------------------
--------------------------------------------------------------------------------------------S---------------------------------------------------------
------------------------------------------------------------------------------------------------------------------------------------------------------
-------------------------------------------------------------------------------------------------------------------------------------%--------%-------
-------------------------------------------------------------------------------------------------------------------------------------|--------|-------
----------------------------------------%--------------------------------------------------------------------------------------------|--------|%------
----------------------------------------|---------------------------------------------------%----------------------------------------|--%-----||------
-----------------------%-%--------------|--------------------------------%------------------|----------------------------------------|--|---%%||------
-----------%-----%%----|%|---%------%---|-------%%--%--%-----%--%--------|-----%-------%---%|-%%%%-%-----------%----%----------------|%-|---||||------
--------%--|%----||%---|||---|---%--|-%-|-------||--|--|-%---|r-|--------|-----|--%%-%-|-%%||-||||%|----%%-----|----|--------%%----%%%|%|---||||-%----
%%%%%%%%|--||----|||---|||---|%%-|--|-|-|-------||%-|--|-|%--|%%|-----%%-|---%%|--||-|-|-||||-||||||--%-||----%|----|--------||--%-||||||---||||-|%---
|||||||||XX||X---|||-XXX||XX-|||X|XX|-|X|XXXX--X|||-XXX|X||XXX|||--XXX||-|X-X|||--X|X|X|X||||XX|||||XX|X||--XX||XXXXX-XXXX-XX||-X|X||||||XXXXX||X||-XX