------------------------------------------------------------------------------------------------------------------------------------------------------
------------------------------------------------------------------------------------------------------------------------------------------------------
------------------------------------------------------------------------------------------------------------------------------------------------------
------------------------------------------------------------------------------------------------------------------------------------------------------
------------------------------------------------------------------------------------------------------------------------------------------------------
------------------------------------------------------------------------------------------------------------------------------------------------------
------------------------------------------------------------------------D-----------------------------------------------------------------------------
------------------------------------------------------------------------------------------------------------------------------------------------------
----------------------------------%-------------------------------------------------------------------------------------------------------------------
----------------------------------|-------------------------------------------------------------------------------------------------------------------
-------------------------%--------|---%--------------------------------------------------------------%------------------------------------------------
--------------------S----|-------%|---|--%%%%-----%%--------------------%----------------------------|------------------------------------------------
--------------%-%--------|-%--%-%||#--|%-||||-----||%-------%--%--------|---%-------%%---------------|-%-------%%---------%-------------%-----%---%---
-----------%--|-|%%%-%---|-|-%|-|||#--||-||||----%|||-------|-%|---g%-%%|-%-|-----%-||---------------|-|%---%--||-%----%--|------%-%----|--%--|---|---
%%%%%%%%---|--|-||||-|---|-|-||-|||%-%||-||||----||||%%-----|-||----|-|||-|-|-----|%||%------%%------|-||%%-|--||-|----|--|--%--%|-|----|--|--|---|---
||||||||XXX|-X|X||||X|XXX|X|X||-|X||-|||-||||--XX||||||X--XX|X|X--XX|X|X|-|X|XXX-X||X||XXXXXX||XXXXXX|X||||X|XX||X|XX--|XX|--|XX|XX|XXXX|XX|XX|-XX|XXX