------------------------------------------------------------------------------------------------------------------------------------------------------
------------------------------------------------------------------------------------------------------------------------------------------------------
------------------------------------------------------------------------------------------------------------------------------------------------------
------------------------------------------------------------------------------------------------------------------------------------------------------
------------------------------------------------------------------------------------------------------------------------------------------------------
------------------------------------------------------------------------------------------------------------------------------------------------------
------------------------------------------------------------------------------------------------------------------------------------------------------
------------------------------------------------------------------------------------------------------------------------------------------------------
-----------------------------------------------------------------------------------------------------%-----------------------------------------%------
-----------------------------------------------------------------------------------------------------|--------%--------------------------------|------
-----------------------------------------------------------------------------------------------------|--------|------------------T-------------|------
------------------------------%---%------------------------%-------------#----------------S---%%-----|--------|------%%----------t-------------|------
-----------%------------------|---|--%--%---------%-----%%-|-%---%-------%----%%------%%%-----||-----|%-%---%%|%-----||-%-%%%---%t------%%-----|%-----
-----------|--%---------------|%%-|--|--|------%%%|-----||-|-|%--|-------|---%||-----%|||-----||----%||-|---||||-----||-|-|||---|t------||-----||-----
%%%%%%%%%%-|--|%%----%--------|||-|--|--|------||||-----||-|-||-%|-----%-|--%|||-----||||--%--||----|||-|---||||--%%-||-|-|||---|%------||-----||-----
||||||||||-|X-|||XXXX|XXX-XX-X|||XXXX|XX|XXXXXXXXX|XX---||X|-||X||XXX--|X|-X|X||XXXXX|||X-X|-X||XXXX|||X|XXX||||XX||X||X|-|||X-X||-X-XXX||XXXXXX|XXXXX