------------------------------------------------------------------------------------------------------------------------------------------------------
------------------------------------------------------------------------------------------------------------------------------------------------------
------------------------------------------------------------------------------------------------------------------------------------------------------
--------------------------------------#---------------------------------------------------------------------------------------------------------------
--------------------------------------%------------------------------%--------------------------------------------------------------------------------
--------------------------------------|------------------------------|--------------------------------------------------------------------------------
--------------------------------------|------------------------------|--------------------------%-----------------------------------------------------
--------------------------------------|------------------------------|--------------------------|-----------------------------------------------------
--------------------------------------|------------------------------|--------------------------|-----------------------------------------------------
----------------------------%---------|-----------------------%------|--------------------------|-----------------------------------------------------
----------------------------|---------%-----------------------|------|--------------------------|-----------------------------------------------------
----------------------------|---------|-------------------%---|---%--|---%----------------------|-----------------------------------------------------
----------%--%----%%--------|---%%--%%|---%----%------%%--|---|%--|-%|U-r|------%-----%%--%%----|---%----------------%-------------------------------%
----------|-C|----||----%---|---||--|||---|----|--%%--||-%|---%|--|-||-%%|---%-%|-----||--||-%--%---|----%-----------|-%-------%---------------------|
%%%%%%%%--|--|-%%%||----|---|---||--|||---|---%|-%||--||-||-%%||--|-||-|||---|-||-%%--||--||%|%%|%--|----|-----------|-|-------|-%-------------------|
||||||||XX|XX|X|||||--XX|---|-XX||-X|||XXX|XXX||-|||XX||X||-||||-XXX||X|||XX-|X||X||XX||X-||||||||XX|XX-X|XXXX-XXXX--|-|XXXXXX-|X|--XXXXXXXXX---XXXXX|