------------------------------------------------------------------------------------------------------------------------------------------------------
------------------------------------------------------------------------------------------------------------------------------------------------------
------------------------------------------------------------------------------------------------------------------------------------------------------
------------------------------------------------------------------------------------------------------------------------------------------------------
------------------------------------------------------------------------------------------------------------------------------------------------------
------------------------------------------------------------------------------------------------------------------------------------------------------
----------------------------------%-------------------------------------------------------------------------------------------------------------------
----------------------------------|-------------------------------------------------------------------------------------------------------------------
----------------------------------|-------------------------------------------------------------------------------------------------------------------
----------------------------------|--------------------------%----------------------------------------------------------------------------------------
----------------------------------|---S----------------------|----------------------------------------------------------------------------------------
-------------%--------------------|--------------------------|----------------------------------------S-----------------------------------------------
---------%---|--------------------%----------%---------------|---%%-%--%-------%----%%---%-----------------%%-------%---------%-%--%------%%%%-%------
--------%|---|--%----%--%---------|---%---%--|-----------%---|--%||-|--|%%-----|----||---|-------%------%--||-------|-----%---|-|--|%-----||||%|------
%%%%%%%%||---|%-|----|--|---------|-%%|-%%|--|--%--------|%--|-%|||-|--|||%-%--|--%-||%-%|%---%--|------|--||-------|-----|---|-|--||-----||||||------
|||||||||XXXXX|X|X---|XX|XXXXXXXXX|X|||X|||X-|XX|---XX---||-X|X||||X|XX||||X|XX|X-|-|||-|X|X-X|XX|XXXXX-X-X||X-X--XX|XXXXX|XXX|X|-X||XXX-XXX||||X--XXX