------------------------------------------------------------------------------------------------------------------------------------------------------
------------------------------------------------------------------------------------------------------------------------------------------------------
------------------------------------------------------------------------------------------------------------------------------------------------------
------------------------------------------------------------------------------------------------------------------------------------------------------
------------------------------------------------------------------------------------------------------------------------------------------------------
-------------------------------------------------------------%----------------------------------------------------------------------------------------
-------------------------------------------------------------|----------------------------------------------------------------------------------------
-------------------------------------------------------------|----------------------------------------------------------------------------------------
----------------------------%--------------------------------|----------------------------------------------------------------------------------------
----------------------------|---------------------%----------|----------------------------------------------------------------------------------------
----------------------------|---------------------|----------|---------------%--------%----------%----------------------------------------------------
----------------------------|---------------------|----------|---------------|--------|----------|-%------------------------------%%--%-%-------------
----------------------------|----------%---%------|----------|----------%----|--------|----------|%%%%-----%----------------------||--|-|------------%
----------%------%---%---F--|%---------|---|----%-|----%-----|%--------%|%-%%|-%%%%---|%%-%------|||||-----|%-----------%---------||--|-|---%--------|
%%%%%%%%-%|-%--%-|---|---%--||---%%%--%|--%|----|-|----|-----||-------%|||%|||-||||---|||-|------|||||--%--||-%--------%|-------%-||--|-|---|----%-%%|
||||||||X||X|XX|X|XXX|XXX|XX||XX-|||X-||XX||X-XX|X|XXXX|XXXXX||XXXX-XX||||||||X||||XX-|||X|X-XXXX||||XXX|XX||-|---XXXXX||XXXXX--|X||XX|X|---|---X|X|||