------------------------------------------------------------------------------------------------------------------------------------------------------
------------------------------------------------------------------------------------------------------------------------------------------------------
------------------------------------------------------------------------------------------------------------------------------------------------------
------------------------------------------------------------------------------------------------------------------------------------------------------
--------------------------------------------------------D---------------------------------------------------------------------------------------------
------------------------------------------------------------------------------------------------------------------------------------------------------
------------------------------------------------------------------------------------------------------------------------------------------------------
------------------------------------------------------------------------------------------------------------------------------------------------------
-----------------------g----%-------------------------------------------------------------------------------------------------------------------------
-------------------------%--|--%------------------------D----------------------------------------%----------------------------------------------------
-------------------------|--|--|-------------------------------%---------------------------------|-----------%----------------------------------------
-------------------------|--|--|----------------------------%--|--------------S------------------|-----------|----------------------------------%-----
-------------------%%-%--|--|--|----------------------%%--%%|--|----%%-%----------------%----%---|%----------|-------------%------------%------%|%---%
---------------%---||-|--|--|--|-------------%%%------||--|||--|---%||-|---%---%--------|----|---||----------|----%--------|------------|------|||--%|
%%%%%%%%--%%---|-%%||%|--|--|--|-------%-----|||------||%%|||--|---|||-|---|--%|--------|-%--|---||%----%----|%%--|%-------|--------%%%-|------|||--||
||||||||XX||XXXXX||||||-X|XX|XX|XXXX-X-|-XXXX|||X---X-|||||||XX|X--|||-|XX-|XX||XXXXXXXX|X|XX|XXX|||XXXX|XX-X|||XX||XX-XXXX|XXX-XXXX|||-|XXX--X|||XX||