------------------------------------------------------------------------------------------------------------------------------------------------------
------------------------------------------------------------------------------------------------------------------------------------------------------
------------------------------------------------------------------------------------------------------------------------------------------------------
------------------------------------------------------------------------------------------------------------------------------------------------------
------------------------------------------------------------------------------------------------------------------------------------------------------
----------------------------------------------------------------------------------------%-------------------------------------------------------------
-----------%----------------------------------------------------------------------------|-------------------------------------------------------------
-----------|-----------------------------------------------------------------------%----|------------------------------------------------------D------
-----------|------------------------------C----------------------------------------|----|----D%---%---------------------------------------------------
-----------|-----------------------------------------------------------------------|----|-----|---|---------------------------------------------------
-----------|----------%--------------------------------------------t------------D--|----|-%---|---|------%---------------------%-%-------------%------
-----------|----------|--------------------------------------------t---------------|--%-|-|--%|---|--%%--|---------------------|-|---%--------g|------
----------%|----------|------------%------%----%-%-%--%-%%%-----%%-t%-%------%-----|--|-|%|--||%--|--||--|-%%----------------%-|-|%--|--%%%----|------
----------||-----%%%%-|--%--%%-----|-----%|---%|-|-|--|-|||---%-||%%|-|%%%---|--%--%--|%|||--|||%-|--||--|-||---------------%|-|-||--|%-|||----|----%-
%%%%%%%%--|%%%---||||-|--|%%||%----|-%---||---||%|-|%-|%|||-%-|-|||||-||||---|--|-%|-%|||||--||||-|%-||--|-||%---%--%------%||%|-||%%||-|||----|----|-
||||||||XX||||XXX||||X|--||||||XX-X|X|XXX||XX-||||X||-|||||-|X|X|||||X||||XX-|XX|-||X|X||||-X||X|-||-||XX|X|||XXX|XX|XX-XXX|||||X||||X|X|||XX-X|XX--|X