------------------------------------------------------------------------------------------------------------------------------------------------------
------------------------------------------------------------------------------------------------------------------------------------------------------
------------------------------------------------------------------------------------------------------------------------------------------------------
------------------------------------------------------------------------------------------------------------------------------------------------------
------------------------------------------------------------------------------------------------------------------------------------------------------
------------------S-----------------------------------------------------------------------------------------------------------------------------------
------------------------------------------------------------------------------------------------------------------------------------------------------
------------------------------------------------------------------------------------------------------%---------------------------%-----------%-------
-----------------------------------------------------------------------------------%------------------|---------------------------|-----------|-------
-----------------------------------------------------------------%-----------------|------------------|---------------------------|-----------|-------
------------------%-------------------------S--------------------|-----------------|------------------|------------%--------------|-----------|-------
------------------|----------------------------------%-----------|-----------------|-------%----------|------------|--------------|-----------|-------
------------------|--------------%---------------%---|-----%-----|-----------------|-------|---%------|--------%--%|%%------------%-----------|------%
------------------|--------------|---%-%---%%-%%-|---|-----|-----|-----------------|-------|---|%-----|-%----%-|--||||------------|-%---------|------|
%%%%%%%%--%%------|----%----%%---|---|-|---||-||-|--%|-----|%----|-%%%---%----%-%--|-------|-%%||%--%%|-|%---|%|%-||||%%%%-%%--%--|-|-%------%|------|
||||||||-X||XXX---|XX--|XXXX||XXX|-XX|X|X--||X||X|X-||XXXXX||-XXX|X|||X--|XXXX|X|--|X-XXXXX|X|||||XX|||X||XXX||||-||||||||X||X-|X-|X|X|XXXXX-||-XXXXX|