------------------------------------------------------------------------------------------------------------------------------------------------------
------------------------------------------------------------------------------------------------------------------------------------------------------
------------------------------------------------------------------------------------------------------------------------------------------------------
------------------------------------------------------------------------------------------------------------------------------------------------------
------------------------------------------------------------------------------------------------------------------------------------------------------
------------------------------------------------------------------------------------------------------------------------------------------------------
------------------------------------------------------------------------------------------------------------------------------------------------------
------------------------------------------------------------------------------------------------------------------------------------------------------
------------------------------------------------------------------------------------------------------------------------------------------------------
---------------------------------------------------------------------------------------------------------------------%--------------------------------
---------------------------------------------------------------------------------------------------------------------|-%------------------------------
-------------------------------------------------------------------------%-------------------------------------%-----|-|-------------%------S---------
-----------------%--%--%-%%---------------------------------%----------%-|--------%---------------------------%|--%--|-|%------------%%-%%---%------%-
---------------%-|-%|--|-||------%-----%--------%-----------|---------%|%|--------|-----%-------------%-------||--|--|%||---------%%-||-||---|------|-
%%%%%%%%-------|-|-||--|-||----%-|-----|-------%|%%-------%%|%%%------||||-%-%----|-%-%-|----%%---%%--|%--%-%%||--|--||||--%%-----||-||-||-%-|------|%
||||||||XXXXXXX|-|X||XX|X||XXXX|XXXX--XX-XXXXX-||||XXXXXXX||||||XXXXX-|||XX|-|X-X-|X|X|-|XXXX||XXX||-X||X-|X||||XX|XX||||XX||X-XX-||X||X||-|X|X-X-XX||