------------------------------------------------------------------------------------------------------------------------------------------------------
------------------------------------------------------------------------------------------------------------------------------------------------------
------------------------------------------------------------------------------------------------------------------------------------------------------
------------------------------------------------------------------------------------------------------------------------------------------------------
------------------------------------------------------------------------------------------------------------------------------------------------------
----------------------------------------------------------------------------------------------------------------S-------------------------------------
-------------------------------------------------------------------------------------------------------------------------S----------------------------
------------------------------------------%-----------------------------------------------------------------------------------------------------------
------------------------------------------|-----------------------------------------------------------------------------------------------------------
------------------------------------------|-----------------------------------------------------S---------------%-------------------------------------
------------------------------------------|----%%%--------------------------------------------%%----------------|--------%---------------%------------
------------------------------------------|----|||-----%-----%--------------------#-----------||--%-------------|%-------|-----%---------|------------
----------%%--------%---------------------|----|||-----|-----|-%-----------%------%-----------||%-|-----%-------||-----%-|-----|------%%-|%----%------
----------||----%%--|%%-%-%%----------%---|%-%%|||-----|---%-|%|--%--------|--%---|-----------|||-|-%---|--%--%%||---%%|-|%%---%------||-||----|-%%---
%%%%%%%%--||--%-||--|||-|-||----------|---%|-|||||-----|--%|-|||--|---%----|--|---|----------%|||-|%|---|--|%-||||---|||-|||-%-|------||-||----|-||%--
||||||||XX||XX|X||X-|||-|X||-XX-XXXXXX|XXX||X|||||XXXXX|-X||X|||XX|X--|-X-X|XX|XXX|X-XXXXX-XX||||-X||--X|-X||-||||XX-|||X|X|X|XXXXXXXX||X||--XX|X|||XX