------------------------------------------------------------------------------------------------------------------------------------------------------
------------------------------------------------------------------------------------------------------------------------------------------------------
------------------------------------------------------------------------------------------------------------------------------------------------------
------------------------------------------------------------------------------------------------------------------------------------------------------
------------------------------------------------------------------------------------------------------------------------------------------------------
------------------------------------------------------------------------------------------------------------------------------------------------------
------------------------------------------------------------------------------------------------------------------------------------------------------
------------------------------------------------------------------------------------------------------------------------------------------------------
------------------------------------------------------------------------------------------------------------------------------------------------------
------------------------------------------------------------------------------%-----------------------------------------------------------------------
--------%---------------------------------------------------------------------|---------------------------------------------------------------%-------
--------|--------------------------------------%------------------------------|---------------------------------------------------------------|-------
--------|----------------------%---%%-----%---%|%--------------------%--------|--------%-%-%--------------------------------------------------|-------
--------|--%-%-----------------|%-%||-----|--%|||--------------------|------%-|%-------|-|-|--%%--------------%-----------------%-------------|-------
%%%%%%%%|--|-|---%-------%%%---||-|||-%---|-%||%|--------------------|------|-||-------|-|-|--||--------------|%--------%%%---%-|%------------|-------
|||||||||XX|X|XXX|XXXXX--|||-XX||X|X|X|XXX|X|||||XXXXXXXXXXXXXX-XX---|XXX-X-|X|XXXX-XXX|-|X|-X||XX-XXXXXXXXXXX||XXXXXXX-|||X-X|-X|XXXXXXX--X-X|XXXXXXX