------------------------------------------------------------------------------------------------------------------------------------------------------
------------------------------------------------------------------------------------------------------------------------------------------------------
------------------------------------------------------------------------------------------------------------------------------------------------------
------------------------------------------------------------------------------------------------------------------------------------------------------
------------------------------------------------------------------------------------------------------------------------------------------------------
------------------------------------------------------------------------------------------------------------------------------------------------------
-------------------------------------------------------------------%----------------------------------------------------------------------------------
-------------------------------------------------------------------|----------------------S-----------------------------------------------------------
-------------------------------------------------------------------|-----S---------------------%------------------------------------------------------
-------------------------------------------------------------------|---------------------------|------------------------------------------------------
----------------------------------------%--------------------------|---------------------------|------------------------------------------------------
-------------------------C--------------|--------------------------|---------------------------|St----------------------------------------------------
--------%--2%%-----------------%-----%--|%------------------------%|-----%-------%-------------|-t--------------%-%%---------%------%---F-------------
--------|---||-------------%---|-----|-%||----%-----%-%-----------||-----|---%%-%|%%%-%---%%---|-t--------------|-||--%---%--|------|---%--%%----%----
%%%%%%%%|-%-||----%----%---|%--|-----|-|||----|%%-%-|-|%----%%----||-----|---||-|||||-|--%||---|-%-%-%-%--------|-||--|---|%-|-----%|---|-%||%--%|----
|||||||||X|X||XXXX|XXX-|-XX||-X|XXX--|X|||-X--|||-|-|X||XX--||--XX||XXX-X|XXX||X|||||X|-X|||-XX|X|X|X|X|XXX-XXXX|X||XX|X--||X|XXXXX||XXX|X||||XX||XXXX