------------------------------------------------------------------------------------------------------------------------------------------------------
------------------------------------------------------------------------------------------------------------------------------------------------------
------------------------------------------------------------------------------------------------------------------------------------------------------
------------------------------------------------------------------------------------------------------------------------------------------------------
------------------------------------------------------------------------------------------------------------------------------------------------------
---------------------------------------------------------------%-------------------%------------------------------------------------------------------
---------------------------------------------------------------|-------------------|------------------------------------------------------------------
---------------------------------------------------------------|-------------------|------------------------------------------------------------------
---------------------------------------------------------------|-------------------|------------%-----------------------------------------------------
---------------------------------------------------------------|-------------------|------------|-----------%-----------------------------------------
----------%-------%--------------------------------------------|-------------g-----|------------|--%--------|t------%---------------------------------
----------|-------|K---------------------------------------%---|-------------------%-------%----|--|--------|t------|--------------%------------------
----------|-------|%-----------%%%%-------%--%--------%----|---|%-------%----------|--%----|----|--|-----%-%|t%%----|%-------------|-------%%-%-------
----------|-------||-%----%%---||||------%|--|----g%--|----|---||-------|----------|%-%----|----%--|-----|-||%||%---||%----%----%%-|-------||%|-------
%%%%%%%%%%%-------||-|----||---||||---%--||%-|-----|--|----|---||-%-----|------%---||-|--%-|%---|-%|---%-|-||||||%--|||-%-%|%---||-|-------||||----%%-
|||||||||||XXXXXX-||X|X---||--X||||XXX|XX|||-|XX--X|XX|-XXX|XXX||X|-XXXX|-XX--X|-XX||-|--|X||XXX|X||XXX|X|X|||||||XX|||X|-|||XXX||XX-XXXXXX||||XXXX||X