------------------------------------------------------------------------------------------------------------------------------------------------------
------------------------------------------------------------------------------------------------------------------------------------------------------
------------------------------------------------------------------------------------------------------------------------------------------------------
------------------------------------------------------------------------------------------------------------------------------------------------------
------------------------------------------------------------------------------------------------------------------------------------------------------
------------------------------------------------------------------------------------------------------------------------------------------------------
------------------------------------------------------------------------------------------------------------------------------------------------------
------------------------------------------------------------------------------------------------------------------------------------------------------
------------------------------------------------C-----------------------------------------------------------------------------------------------------
----------------------------------%---------------------------------------------------------------------------------------------------------------g---
----------------------------------|----------------------------%--------------------------%-----------------------------------------------------------
----------------------------------|----------------------------|--------------------------|---------------%-------------------------------------------
-------------%-----%%-------------|--------%-%--%---%%%--------|%---%-------%%--%------%--|--%--%--%------|%-----------------%-%----------------------
------------%|-----||-------------|--------|-|--|---|||--------||---|--%-%F-||--|%-%---|%-|--|--|--|-%----||------------%----|-|%%%--%%%-%-%%--------%
%%%%%%%%%%--||-----||--%-----%----|--------|-|--|---|||------%-||---|-%|-|%-||-%||-|---||-|--|--|--|-|%%X-||------------|----|-||||-%|||-|-||-%--%---|
||||||||||XX||XXX-X||-X|-XX-X|XXX-|XXX-XXXX|-|X-|-XX|||-XXXXX|-||-X-|X||X||-||-|||XXX--||X|X-|XX|X-|X|||XXX|-------XXXXX|XXX-|X||||X||||-|-||-|XX|--XX