------------------------------------------------------------------------------------------------------------------------------------------------------
------------------------------------------------------------------------------------------------------------------------------------------------------
------------------------------------------------------------------------------------------------------------------------------------------------------
------------------------------------------------------------------------------------------------------------------------------------------------------
------------------------------------------------------------------------------------------------------------------------------------------------------
------------------------------------------------------------------------------------------------------------------------------------------------------
------------------------------------------------------------------------------------------------------------------------------------------------------
--------------------------------------------------------------------------------------------------------------------------------------%---------------
--------------------------------------------------------------------------------------------------------------------------------------|---------------
--------------------------------------------------------------------------------------------------------------------------------------|---------------
--------------------------------------------------------------------------------------%#------------------------------------------C---|---------------
------------------------------------------%----------------------------------------g--|#----------------------------------------------|---------------
----------------%---%--%---------%--------|---------------------------------------%---|%-%%--------%----------------%--------------%--|-------%---%%--
----------------|---|--|---%-----|---%%%%-|-%--------%%-----%-----------%---------|---||-||--------|----------------|--------------|-%|-------|---||--
%%%%%%%%%%-----%%--%|--|---|-----|---||||-|-|%---%---||-----|----%------|---------|---||-||%%--%--%|%------%--------|%----------%%%|-||-------|---||--
||||||||||-XXXX||XX||XX|X--XXXXXX|XXX||||-|X||---|-XX||XXXXX|XXX-|XXX-XX|---XX--XX|XX-||-||||--|-X|||-XXX--|XXXXX-X-||XXXXXXX-XX||||-|XXXXX---|XXXX|XX