------------------------------------------------------------------------------------------------------------------------------------------------------
------------------------------------------------------------------------------------------------------------------------------------------------------
------------------------------------------------------------------------------------------------------------------------------------------------------
------------------------------------------------------------------------------------------------------------------------------------------------------
------------------------------------------------------------------------------------------------------------------------------------------------------
--------------------------------------------------------------------------S-------%-------------------------------------------------------------------
---------------------------------------------------%-------------------%----------|-------------------------------------------------------------------
---------------------------------------------------|-------------------|----------|-------------------------------------------------------------------
---------------------------------------------%-----|-------------------|----------|-------------------------------------------------------------------
---------------------------------------------|-----|-------------------|--%-------|-----------------------------------------------------------%-------
---------------------------------------------|---%%|-------------------|--|-------|-----------------------------------------------------------|-------
-----------------------------------%--------%|---|||-------------------|--|-------|------------------------S--------------------%-g-----------|-------
----------%%-----------------------|%---%--%||---|||-------------------|--|%%--%--|----------------------------%%%----%---------|--%-------%--|---%--%
----------||----------%---------%--||---|%%|||---|||-------------------|--|||%-|--|------%--%----------%-------|||----|%--------|--|------%|--%---|--|
%%%%%%%%--||----------|---------|--||---||||||--%|||-------%-%%--------|--||||-|--|------|--|%----%-%--|------%|||--%%||----%%%%|--|------||--|-%%|%%|
||||||||-X||XXXX-XXXXX|X-XXXXXXX|XXX|XXX||||||XX||||X--XXXX|X||-X-X--XX|XX||||X|XX|-XXXXX|XXX|XXX-|X|X-|-X-XX-||||-X||||XXX-|||||XX|XXXXXX||XX|X||||||