------------------------------------------------------------------------------------------------------------------------------------------------------
------------------------------------------------------------------------------------------------------------------------------------------------------
------------------------------------------------------------------------------------------------------------------------------------------------------
------------------------------------------------------------------------------------------------------------------------------------------------------
------------------------------------------------------------------------------------------------------------------------------------------------------
------------------------------------------------------------------------------------------------------------------------------------------------------
------------------------------------------------------------------------------------------------------------------------------------------------------
------------------------------------------------------------------------------------------------------------------------------------------------------
------------------------------------------------------------------------------------------------------------------------------------------------------
---------------------------------------------------------------------------------------------------------------------%---------------%----------------
------------%---------------t-------------------------------------------------------------------%--------------------|---------------|----------------
------------|---------------t-------------------------------------------------------------------|-----------%--------|---------------|----------------
-----------%|---------------t-------------------%%%%------------%----------%-%-%%--%%-%---%--%--|---%%%-%--%|---%----|---------------|--------%--%----
-----------||---------------%-%-------------%-%-||||------------|%%--------|-|-||--||-|-%-|--|--|---|||-|--||---|----|-----%---------|--%-----|--|----
%%%%%%%%%-%||---------------|-|%------%%----|-|%||||%%----%---%-|||--%%%%--|-|-||--||-|-|-|%-|%-|-%-|||-|--||---|----|-----|---------|--|-----|--|----
|||||||||X|||XXXXXXXXXXXX--X|X||X-XX--||XX-X|X||||||||-X--|XXX|X|||XX||||XX|X|X||XX||X|X|X||X||-|X|X|||-|X-||X-X|X--X|-XXXX|XXXXXXXXX|XXXXXXXX|XX|X-XX