------------------------------------------------------------------------------------------------------------------------------------------------------
------------------------------------------------------------------------------------------------------------------------------------------------------
------------------------------------------------------------------------------------------------------------------------------------------------------
------------------------------------------------------------------------------------------------------------------------------------------------------
------------------------------------------------------------------------------------------------------------------------------------------------------
--------------------------------------------------------------t---------------------------------------------------------------------------------------
--------------------------------------------------------------t---------------------------------------------------------------------------------------
--------------------------------------------------------------t----------------------------------------%----------------------------------------------
--------------------------------------------------------------%----------------------------------------|----------------------------------------------
---------t--------------------------------------------------%%|------------------------%---------------|----------------------------------------------
--------%t----------------%---------------------------------|||------------------------|------------%--|----------------------------------------------
--------|t----------------|---------------------------------|||------------------------|------------|-%|----------------------------------------------
--------|%%-----%---------|-------------%---------------%---|||------------------------|--%-%-------|-||-%----%%%%-%%--%%------------K-%%-%-----------
--------|||-----|---------|-------------|--------%------|---|||------------------------|--|-|-%-----|-||-|----||||-||--||------------%%||-|---%-------
%%%%%%%%|||%%%--|---%%%---|-------%-----|-------%|%--%--|---|||-%%-%%---%--------------|-%|-|%|%----|%|%-|----||||-||--||------------||||-|--%|----%--
||||||||||||||XX|X-X|||XXX|-XXXXX-|XXXXX|XXXXXXX|||XX|XX|XXX|||X||-||XXX|------X--X-XXX|X||-||||XXX-||||X|XXX-X|||X||X-||XX--X-XXX---||||-|-X||---X|XX