------------------------------------------------------------------------------------------------------------------------------------------------------
------------------------------------------------------------------------------------------------------------------------------------------------------
------------------------------------------------------------------------------------------------------------------------------------------------------
------------------------------------------------------------------------------------------------------------------------------------------------------
------------------------------------------------------------------------------------------------------------------------------------------------------
--------------------------------------------------------------------------------------------------------------------------%---------------------------
-------------------------------------D------------------------------------------------------------------------------------|---------------------------
--------------------------------------------------------------------------------------------------------------------------|---------------------------
--------------------------------------------------------------------------------------------------------------------------|---------------------------
--------------------------------------------------------------------------------------------------------------------------|---------------------------
------------t-------------------------------------------------------------------------------------------------------------|---------------------------
------------t-----------------%---------------------------%--------------------------------------------%----------C------#|---------------------------
------------t-----%-----------|%-------------%%---%-%%%---|-----------%-----------%-%%-----------------|------%----------%|--%-------%%%%-----%-------
------------%-----|---%--%---%||-%---%-------||%--|%|||---|-----------|-----------|-||----%---------%--|%%%---|%%----%---||--|-%-%-%%||||--%%-|-------
%%%%%%%%-%--|-----|-%-|--|---|||-|---|-%----%|||--|||||---|%------%%--|--------%--|%||----|---------|%-||||---|||---%|-%-||--|-|-|%||||||--||-|-------
||||||||X|XXXXXXXX|X|X|XX|XXX|||X|XX-|-|XXXX||||-X|||||-XXX|XX-XXX||XX|XX-XXXXX|--||||X--X|XXXXXXXXX||X||||XX-|||XXX||X|X||XX|X|X||||||||X-||X|---X--X