------------------------------------------------------------------------------------------------------------------------------------------------------
------------------------------------------------------------------------------------------------------------------------------------------------------
------------------------------------------------------------------------------------------------------------------------------------------------------
------------------------------------------------------------------------------------------------------------------------------------------------------
------------------------------------------------------------------------------------------------------------------------------------------------------
------------------------------------------------------------------------------------------------------------------------------------------------------
------------------------------------------------------------------------------------------------------------------------------------------------------
---------------------------------------------------------------------------------------------------------------%--------------------------------------
---------------------------------------------------------------------------------------------------------------|--------------------------------------
---------------------------------------------------------------------------------------------------------------|--------------------------%-----------
--------------------------------%------%%--%-----%%----%-------------------------------------------------------|--------------------S-----|-----------
--------------------------------|------||--|-----||%---|-------------------------------------------------------|--------------------------|-----------
---------------%----------------|----%%||--|--%%-|||--%|---------------%----------------%-%---------%----------|%-----%-%%---%%--%----%-%-|---------%-
--------%------%----------------|----||||%-|--||-|||--||%-%------------|-----------%----|-|---------|-%---%---%%|-----|-||---||--|----|-|-|%-r--r---|-
%%%%%%%%|-%----|--#------%%-%---|----|||||-|--||-|||--|||%|%--------%%-|------%%%%-|--%%|-|-%------%|-|--%|---|||-----|-||%--||-%|--%%|-|-||-%-%----|-
|||||||||-|XXXXX--XXX-XX-||X|---|-XX-|||||-|--||X|||--||||X|XX-XXXX-||XXXXXX--||||-|XX||X-|-|XXXXX-||X|XX||-XXX||XX---|X|||--||-||XX|||X|-||X|X|XX--XX