------------------------------------------------------------------------------------------------------------------------------------------------------
------------------------------------------------------------------------------------------------------------------------------------------------------
------------------------------------------------------------------------------------------------------------------------------------------------------
------------------------------------------------------------------------------------------------------------------------------------------------------
------------------------------------------------------------------------------------------------------------------------------------------------------
------------------------------------------------------------------------------------------------------------------------------------------------------
------------------------------------------------------------------------------------------------------------------------------------------------------
------------------------------------------------------------------------------------g-----------------------------------------------------------------
------------------------------------------------------------------------------------%----------------------------S------------------------------------
------------------------------------------------------------------------------------|-------------------------------------------------------------%---
------------------------------------------------------------------%-----------------|-----------------S-------------------------------------------|---
----------------%---------------------------------------%---------|-----------------|--%--------------g----------%--------------------------------|---
----------------|----%-%%-%%%%%----------%%-----%-------|-%%--%---|--%--------------|--|--%----------%----%------|--%---------------%---%-%-------|---
----------------%----|-||-|||||----------||---%-|--%-%%-|-||--|---|--|-----%--------|--|--|K-%----%-%|-%--|------|--|---------------|---|-|-%-----|---
%%%%%%%%%------%|----|-||-|||||%---------||%%%|-|--|%||-|%||%%|---|--|-----|-%------|--|--|%%|%%--|%||-|--|----%%|--|%%------------%|%%-|%|-|----%|---
|||||||||-XXXXX|XXXXX|X||X||||||X--X--XXX||||||X|--||||X|||||||X--|XX|XXXXX|-|XXXXXX|X-XXX||||||X-||||X|XX|XXX-|||X-|||X----XXXX-XX||||X|||X|XXXX||XXX