------------------------------------------------------------------------------------------------------------------------------------------------------
------------------------------------------------------------------------------------------------------------------------------------------------------
------------------------------------------------------------------------------------------------------------------------------------------------------
------------------------------------------------------------------------------------------------------------------------------------------------------
------------------------------------------------------------------------------------------------------------------------------------------------------
------------------------------------------------------------------------------------------------------------------------------------------------------
------------------------------------------------------------------------------------------------------------------------------------------------------
------------------------------------------------------------------------------------------------------------------------------------------------------
------------------------------------------------------------------------------------------------------------------------------------------------------
-------------------------------------------------------%----------------------------------------------------------------------------------------------
-------------------------------------------------------|---------------------------C-----------------------------%------------------------------------
--------------------------g----------------------------|---------------------------------------%-----------------|----%---%---------------------------
----------------%----%---------------%%------------%---|---------------------------------------|-----%-----------|----|---|------------%-------%-%--%-
-------------%%-|%%-%|---------------||-----------%|--%|-------------------------------------%%|-----|-----------|----|--%|--%------%-%|-------|-|--|-
%%%%%%%%-----||-|||%||---------------||-----------||--||---------%%----------------%---------|||---%-|-----------|----|%-||-%|----%-|-||--%----|-|--|-
||||||||XXXXX||X||||||XXXXXXXXXXXXXXX||XXXXXXX--X-||XX||XXXXXXX-X||XXX-X-XX---XXXXX|XXXXXXXXX|||XXX|X|X-XX-XXXX--|X-X-X|X||X||XXX-|X|X||--|XXXX|X|XX|X