------------------------------------------------------------------------------------------------------------------------------------------------------
------------------------------------------------------------------------------------------------------------------------------------------------------
------------------------------------------------------------------------------------------------------------------------------------------------------
------------------------------------------------------------------------------------------------------------------------------------------------------
------------------------------------------------------------------------------------------------------------------------------------------------------
------------------------------------------------------------------------------------------------------------------------------------------------------
--------------------------------------------------------------------%---------------------------------------------------------------------------------
--------------------------------------------------------------------|----------------%----------------------------------------------------------------
--------------------------------------------------------------------|----------------|---------D------------------------------------------------------
--------------------------------------------------------------------|----------------|------%---------------------------------------------------------
----------------------%---------------------------------------------|---------%------|%-----|---------------------------------------------------------
----------------------|---------------------------------------------|---------|------||%%---|---------------------------------------------------------
----------------------|---%%%%--------------%%--%%------------------|---------|------||||%--|---------%--------------%-----------------%%-------%-----
----------%-------%---|---||||------%-------||-%||----%-------------%---------|--%%--|||||--|---------|--------------|-%%%---%---------||-------|-----
%%%%%%%%--|-------|%--|%--||||%%----|%------||-|||----|%%-----------|-----%---|--||%%|||||--|-%%-%%---|--%-----------|-|||---|---------||----%%-|-----
||||||||XX|X-XXXX-||XX||XX||||||XX-X||XXX-XX||X|||XXXX|||-XXXXXXXXXX|XX-X-|XX-|--|||||||||XX|X||X||XX-|XX|XXXXXXXXXXX|-|||XXX|XX---XXX-||XXXX||X|XXX--