------------------------------------------------------------------------------------------------------------------------------------------------------
------------------------------------------------------------------------------------------------------------------------------------------------------
------------------------------------------------------------------------------------------------------------------------------------------------------
------------------------------------------------------------------------------------------------------------------------------------------------------
------------------------------------------------------------------------------------------------------------------------------------------------------
-------------------------------------------%----------------------------------------------------------------------------------------------------------
-------------------------------------------|----------------------------------------------------------------------------------------------------------
---------------------------------D---------|-------------------------------------------------%--------------------------------------------------------
------------%------------------------------|--------%----------------------------------------|-------------------------------------------------%------
------------|------------------------------|--------|----------------------------------------|-----------------------%-------------------------|------
------------|------------------------------|--------|-------------------------------------%--|-----------------------|-------------------------|------
------------|------%-----------------------|--------|-------------------------------------|--|-----------------------|%-%--%-------------------|-S----
---------%%%|%---%-|------%----------------|--------|--%-------%--------%-------------%---|--|-%------%--------------||-|--|%%-%-------%---%%--|--%---
--------%|||||---|-%--%---|%---------------%--------|--|-------|--------|-------------|---|-%|-|%-----|----%---%-----||-|--|||-|-g---%-|---||--|--|---
%%%%%%%%||||||---|-|--|%--||-----%---------|--------|%-|----%-%|-%------|--%%---%----%|-%%|-||%||---%-|-%--|-%-|--%--||-|-%|||-|-----|-|%%-||--|--|--%
||||||||||||||XXX|X|-X||-X||XXX-X|XXXXXXXX-|XX-XXXXX||-X-XX-|X|XX|---XXX|XX||-XX|X-XX||-|||-|||||-XX|X|-|XX|-|X|XX|XXX|-|-||||X|XXXXX|X|||-||-X|XX|-X|