------------------------------------------------------------------------------------------------------------------------------------------------------
------------------------------------------------------------------------------------------------------------------------------------------------------
------------------------------------------------------------------------------------------------------------------------------------------------------
------------------------------------------------------------------------------------------------------------------------------------------------------
------------------------------------------------------------------------------------------------------------------------------------------------------
------------------------------------------------------------------------------------------------------------------------------------------------------
------------------------------------------------------------------------------------------------------------------------------------------------------
------------------------------------------------------------------------------------------------------------------------------------------------------
-----------------------%------------------------------------------------------------------------------------------------------------------------------
-----------------------|-------------------------------------------------%-------------t--------------------------------------------------------------
---------%-------------|-------------------------------------------------|-------------t------%-------------------------%-----------------------------
---------|-------------|-----------------------------------%-------------|-------------t------|-------------------------|%--------%-------------------
--------%|-------------|------%%-------------------------%-|--%-------%--|-----%---%---%%--%%%|-%-------%---------------||--%-----|-------------------
--------||------%--%---|-%--%%||-----------------------%%|-|--|-------|-%|%----|%--|%--||--||||-|-------|----%----------||--|-----|------%%-----------
%%%%%%%%||------|--|---|-|--||||--%%%-%%--%%---%--%%---|||-|-%|-%-%-%-|-|||--%-||--||--||--||||%|-------|---%|%%%-------||%-|-%---|---%%-||-----%-----
||||||||||XXX-X-|XX|XXX|X|XX||||X-|||X||XX||X--|-X||XXX||XXX-||X|-|-|X|-|||XX|X||X-||XX||-X||||||XXXXX-X|XXX|||||-XXXXX-|||X|X|X-X|XXX||X||X-XXX|-XXXX