------------------------------------------------------------------------------------------------------------------------------------------------------
------------------------------------------------------------------------------------------------------------------------------------------------------
------------------------------------------------------------------------------------------------------------------------------------------------------
------------------------------------------------------------------------------------------------------------------------------------------------------
------------------------------------------------------------------------------------------------------------------------------------------------------
-------------------------------------------S----------------------------------------------------------------------------------------------------------
------------------------------------------------------------------------------------------------------------------------------------------------------
------------------------------------------------------------------------------------------------------------------------------------------------------
-----------------------------------------------------------------------------------------------------%------------------------------------------------
--------------------------------------------------------------------------------------------------%--|---------------------------------------%--------
----------------------------------------------------------S---------------------------------------|--|---------------------------------------|--------
------------------------------------#------%-----------------------------------------------------%|--|------%----------%%--------------------|--------
--------------------------%--%------#----%-|--%%---------------------------------------------%---||-%|--%%--|%----%%-%-||%-%%%%%%-----%------|--------
--------------------------|--|--%---%----|-|--||---%---%-%-G---------%--%--%%%--------%----%-|---||%%|-%||-%||----||-|-|||-||||||----%|------|%----%%-
%%%%%%%%-----%---%--------|--|--|---|---%|-|--||---|---|-|%%--%%%----|--|%-|||%-------|----|-|---||||%-|||-|||----||-|-|||%||||||----||------||--%%||-
||||||||XX-XX|XXX|--XXXXXX|X-|--|X--|XXX||X|XX||X--|--X|-X||XX|||--XX|XX||X||||--X-X-X|XX-X|X|-XXX||||X|||-|||XXXX||X|XX|||||||||-XX-||XXXXXX||X-||||X