------------------------------------------------------------------------------------------------------------------------------------------------------
------------------------------------------------------------------------------------------------------------------------------------------------------
------------------------------------------------------------------------------------------------------------------------------------------------------
------------------------------------------------------------------------------------------------------------------------------------------------------
-------------------------S----------------------------------------------------------------------------------------------------------------------------
------------------------------------------------------------------------------------------------------------------------------------------------------
---------------------------------------------------------------------------------------------------------C--------------------------------------------
----------------%--------%----------------------------------------------------------------------------------------------------------------------------
----------------|--------|-------------------------------------------------------------------%--------------------------------------------------------
----------------|--------|-------------------------------------------------------------------|---------------%%---------------------------------------
----------------|--------|-------------------------------------------------------------------|%%%--------%---||---------------------------------------
----------------|----t---|--------%---------------------------------------------------%------||||-------%|---||---------------------------------------
----------%-----|%---t---|--------|--%-%%-%---------------------%--------%--------%---|---%--||||----%--||%--||----------%------%%-----%---%--------%-
----------|--%--||%--%---%--------|--|-||-|--%%%----------------|--------|---%%-%-|---|-%%|--||||----|--|||--||--%-------|-----%||-----|-%-|-%-----%|-
%%%%%%%%--|%-|--|||--|---|------%-|--|-||-|%-|||---------%-----%|--------|-%-||-|-|%%-|%|||--||||---%|--|||--||--|-------|-----|||-----|-|-|-|--%--||-
||||||||XX||X|XX|||XX|---|X-X-XX|X|--|X||-||X|||XXXX--XXX|XXXXX|XXX--XXXX|X|X||X|X|||X|||||XX||||XXX||XX|||X-||XX|XXXXXX-|XXXXX|X|X-XXX|X|X|X|-X|XX||X