------------------------------------------------------------------------------------------------------------------------------------------------------
------------------------------------------------------------------------------------------------------------------------------------------------------
------------------------------------------------------------------------------------------------------------------------------------------------------
------------------------------------------------------------------------------------------------------------------------------------------------------
------------------------------------------------------------------------------------------------------------------------------------------------------
------------------------------------------------------------------------------------------------------------------------------------------------------
-------------------------------------------------------------------------------------------------------------------------------------------------%----
-------------------------------------------------------------------------------------------------------------------------------------------------|----
--------------------------------------------------------------------------------------------------------------------------------------------%----|----
--------------------------------------------------------------------------------------------------------------------------------------------|----|----
----------------------------%------------------------------------------%----------------------------S------------%-----%--------------------|----|----
----------------------------|------------------------------------------|-----------%%----------------------------|-----|%-------------------|----|----
---------%--------------%---|%-%-%--%-----%%---------------------%-----|-----------||--------%----------------%--|--%-%||-------------%-----|----|----
---------|-----------%--|--%||%|-|--|-%---||---%-%---------------|%---%|-----%----%||--------|----------------|--|%-|%|||%%%----------|%-%--|--%-|%---
%%%%%%%%-|--%-------%|--%--|||||-|--|-|---||---|-|-%------%------||---||%----|----|||--------|------%--------%|--||-|||%||||-----%---%||%|--|--|%||---
||||||||-|-X|XX-XXXX||XX|XX|||||X|XX|-|XXX||-XX|X|X|-XXX-X|-XXXXX||XXX|||XXXX|XXXX|XX--XXXXXX|XXXX-X|-XXXXX--||-X||XX|||||||XXXX-|X-X|||||X-|--||||XX-