------------------------------------------------------------------------------------------------------------------------------------------------------
------------------------------------------------------------------------------------------------------------------------------------------------------
------------------------------------------------------------------------------------------------------------------------------------------------------
------------------------------------------------------------------------------------------------------------------------------------------------------
------------------------------------------------------------------------------------------------------------------------------------------------------
------------------------------------------------------------------------------------------------------------------------------------------------------
------------------------------------------------------------------------------------------------------------------------------------------------------
---------------------------------------------------------------------------------------------------------------%--------------------------------------
---------------------------------------------------------------------------------------------------------------|--------------------------------------
---------------------------------------------------------------------------------------------------------------|--------------------------------------
----------------------------------------------------------------------------------------#---------------------%|--------------------------------------
------------------------------------------------S-------%-------------------------------#---------------------||---------S---------------%-----------%
---------------------%-----------%--------%----%--------|-----------%%%-----------------#------%--------------||---%--------------%--%---|-----------|
---------------------|-----------|--------|----|--------|%----------|||------%----------%----%-|----%---------||-%%|----%---------|--|---|------%----|
%%%%%%%%%------%%%---|------%----|--------|----|--------||%%%-----%-|||%%%---|----%%----|----|-|----|---------||-|||----|--%----%-|--|---|---%--|----|
|||||||||XXXXXX|||X-X|X-XXXX|XXXX|XXXX--XX|XX--|XX-XXXXX|||||XXXX-|X||||||XX-|---X||XXXX|XXXX|X|-XXX|-XXXXX-XX||XX||XX-X|X-|XXXX|X|XX|--X|XX-|-X|-XXX|