------------------------------------------------------------------------------------------------------------------------------------------------------
------------------------------------------------------------------------------------------------------------------------------------------------------
------------------------------------------------------------------------------------------------------------------------------------------------------
------------------------------------------------------------------------------------------------------------------------------------------------------
------------------------------------------------------------------------------------------------------------------------------------------------------
----------------------------------S-------------------------------------------------------------------------------------------------------------------
------------------------------------------------------------------------------------------------------------------------------------------------------
------------------------------------------------------------------------------------------------------------------------------------------------------
-----------------------------------------%---S--------------------------------------------------------------------------------------------------------
-----------------------------------------|------------------------------------------------------------------------------------------------------------
--------S--------------------------------|--------------------------------------------------------%---------------------------------------------------
----------------------------------%------|------------------------------------%-------------------|---------%-----------------------------------------
------------%------------------%--|------%---%----------%-----%-----------%---|-------%-----------|------%--|%%%-----------------------%----------%---
------------|%------------%----|--|------|---|---%------|-----|----------%|---|-------|-%%%-------|-%-K-%|--||||----------------%------|-----%%---|---
%%%%%%%%%%--||-------%----|----|--|----%-|---|---|%%----|---%%|--%-------||---|-------|-|||-------|-|%%-||--||||%-------%%----%%|------|-----||%%-|---
||||||||||X-||XX-X-XX|XX-X|X--X|X-|-XX-|X|XX-|X-X|||XXXX|XXX|||XX|XXXXX-X||XX-XXXXXX-X|X|||XXXX-XX|-X||X||--X||||-XXXX--||XXXX|||XX-XX-|X---X||||X|XXX