------------------------------------------------------------------------------------------------------------------------------------------------------
------------------------------------------------------------------------------------------------------------------------------------------------------
------------------------------------------------------------------------------------------------------------------------------------------------------
------------------------------------------------------------------------------------------------------------------------------------------------------
----------------------------------------------------------------------------------%-------------------------------------------------------------------
----------------------------------------------------------------------------------|-------------------------------------------------------------------
----------------------------------------------------------------------------------|-------------------------------------------------------------------
----------------------------------------------------------------------------------|-------------------------------------------------------------------
---------------------------------------------%------------------------------------|-------------------------------------------------------------------
---------------------------------------------|------------------------------------|-------%-----------------------------------------------------------
---------------------------------------------|---%--------------------------------|-------|-----------------------------------------------------------
-----------------------------%------------%--|---|----------g--------------%------|%------|------------------------%----------------------%-----------
--------------%%%-----%-%----|------------|--|---|%----%-----%------------%|------||----%-|-%--------------%-------|----%%--%%--%--%%----%|%----------
--------------|||-----|%|--%-|------------|--|%-g||%---|--%--|---%%------%||------||----|-|-|-%---%--------|-------|----||--||--|--||--%-|||----------
%%%%%%%%%%----|||-%---|||--|-|-%%--%%-----|--||--|||---|--|--|---||------|||--%--%||----|-|%|-|---|%------%|%------|----||-%||--|%%||--|-|||--%-------
||||||||||X-X-|||X|-X-|||XX|X|X||XX||XXXXX|X-||X-|||XXX|XX|XX|XXX||X--XXX||XX-|XX||X-XXX|X|||X|XXX||----XX|||XXXX-X|XXXX||X|||X-|||||XX|X|X|--|XXXXXXX