------------------------------------------------------------------------------------------------------------------------------------------------------
------------------------------------------------------------------------------------------------------------------------------------------------------
------------------------------------------------------------------------------------------------------------------------------------------------------
------------------------------------------------------------------------------------------------------------------------------------------------------
------------------------------------------------------------------------------------------------------------------------------------------------------
------------------------------------------------------------------------------------------------------------------------------------------------------
------------------------------------------------------------------------------------------------------------------------------------------------------
-----------------------------------------------------------------------%-----------------------------------------------%------------------------------
-----------------------------------------------------------------------|------------------%----------------------------|------------------------------
-------------------------------------C-----------%---------------------|------------------|----------------------------|--------------------D---------
------------------%%-----------------------------|---------------------|----------%-------|----------------------------|---------------%--%-----------
-----------------%||-----------------g-----------|---------------------|----------|-------|%%-------------------------%|---------------|--|-----%--%--
-----------------|||%----------------------------|-------------U-------|----------|--%----|||---------------%%--------||-%---#----%----|--|-----|--|--
-----------------||||--------------%-------------|----------%----------|----%%----|--|--%-|||----------%----||--------||-|---#--%-|%-%-|--|--%--|--|--
%%%%%%%%%------%%||||------------%%|--%----%%----|----------|--------%-|%---||---%|--|--|%|||%%------%-|----||------%%||-|---%-%|-||-|-|--|--|--|--|--
|||||||||XXXX--||||||-XXXXX-X-XXX|||-X|XXXX||XXXX|XXXX-XXXXX|XXXXXXXX|X||XXX||X-X||--|XX|||||||----XX|X|X---X|XXX--X||||-|XXX|X||-||-|X|XX|-X|XXX--|XX