------------------------------------------------------------------------------------------------------------------------------------------------------
------------------------------------------------------------------------------------------------------------------------------------------------------
------------------------------------------------------------------------------------------------------------------------------------------------------
------------------------------------------------------------------------------------------------------------------------------------------------------
------------------------------------------------------------------------------------------------------------------------------------------------------
------------------------------------------------------------------------------------------------------------------------------------------------------
------------------------------------------------------------------------------------------------------------------------------------------------------
----------------------------------------------------------------------------------------------------------------------------------------------D-------
------------------------------------------------------------------------------------------------------------------------------------------------------
------------------------------------------------------------------------------------------------------------------------------------------------------
---------------------------------------------------------------------------------------------------------------%--------------------------------------
-----------------------%----------------------------------------------------------------%---%---------%%-------|--------------------------------------
-------------------#--%|------%-------------%---------%---------------------------------|---|---%-----||--%%---|----%-----------%-------%-------%-----
-------------------#--||%%----|----%--%%%--%|-------%-|------------------------%--------|---|---|-----||--||---|--%-|-----------|--%%%--|---%%-%|-----
%%%%%%%%%----%%---%%%-||||----|---%|--|||-%||----%%-|-|%-----%----------------%|------%-|---|---|----%||--||--%|--|-|-------%--%|--|||--|-%-||-||-----
|||||||||XXXX||-XX|||X||||XXXX|XXX||-X|||-|||XX-X||X|XX|-XX--|XXXXX--XXXXXXXX-||X-XX-X|X|X-X|X-X|X-XX|||-X||--||XX|X|-XXXXXX|XX||XX|||X-|-|X||-||X----