------------------------------------------------------------------------------------------------------------------------------------------------------
------------------------------------------------------------------------------------------------------------------------------------------------------
------------------------------------------------------------------------------------------------------------------------------------------------------
------------------------------------------------------------------------------------------------------------------------------------------------------
------------------------------------------------------------------------------------------------------------------------------------------------------
------------------------------------------------------------------------------------------------------------------------------------------------------
-------------------------------------------------------------------------------------------------------------------%----------------------------------
-------------------------------------------------------------------------------------------------------------------|----------------------------------
-------------------------------------------------------------------------------------------------------------------|----------------------------------
--------------------------------------------------------------------------------------------------S----------------|----------------------------------
------------------------------------------------------------------------%------------------------------------------t------------------------%--%---%--
-------------------------------%-------U--------------%-----------------|----------------------------%-------------T------------------------|--|---|-%
---------------------------%---|%%%-------------------|-----------%---%%|-------------%----%------D-%|---%---------%---------------%%%---%--|--|--%|-|
----------%---------%------|%%%||||-----%----------%--|--%%--%----|---|||-------------|----|--------||---|%---%---%|-%----------%--|||--%|--|--|--||%|
%%%%%%%%%-|%%-------|------||||||||-----|----------|--|--||--|----|---|||-------%-----|----|--------||---||---|---||-|%-%----%--|%-|||%-||--|--|--|%||
|||||||||X|||XXXXXXX|XXXXXX|||||||XX-X-X|XXXXX-XXXX|XXXXX||XX|XXX-|-XX|||X-XX-XX|XXXXX|-XXX|X-XXXXX-||X--||XXX|---||X||X|XXXX|-X||XX|||X||-X|XX|XX|||X