------------------------------------------------------------------------------------------------------------------------------------------------------
------------------------------------------------------------------------------------------------------------------------------------------------------
------------------------------------------------------------------------------------------------------------------------------------------------------
------------------------------------------------------------------------------------------------------------------------------------------------------
------------------------------------------------------------------------------------------------------------------------------------------------------
------------------------------------------------------------------------------------------------------------%-----------------------------------------
--------------------------------------%---------------------------%-----------------------------------------|------------------------2----------------
--------------------------------------|-%-------------------------|-----------------------------------------|-----------------------------------------
--------------------------------------|-|-------------------------|-----------------------------------------|-----------------------------------------
--------------------------------------|-|-------------------------|-----------------------------------------|-----------------------------------------
----------------------------%--------%|-|----%--------------------|----------------------------C------------|------------------------%----------------
-------------------------U--|--%-----||-|----|--------------------|-----------------------------------------|-------%----------------|----------------
----------------------------|--|-----||-|----|--------------------|%%------------------------%-----%-----%--|---%---|%---------------|---------%------
-----------%-----------2----|%%|---%%||-|---%|-%---%--%%%-----%-#-|||--%---------------------|-%-%-|-%---|--|---|---%%--%--------%---|---------|------
%%%%%%%%--%|----%%%-%%------||||-%-||||-%%%-||-|---|%%|||%----|-%-|||%-|-%----------%-----%--|-|-|-|-|---|--|---|---||-%|-------%|---|-----%%--|%%----
||||||||X-|XX--X|||X||XX-X-X||||X|X|||XX|||X||-|-X-|||||||XXXX|X|X||||X|X|XX-XXXXXXX|--XXX|XX|X|X|X|-|XXX|XX|---XXXXXXX||XXXXXXX|X--X|XXXX-||XX|||XXXX