------------------------------------------------------------------------------------------------------------------------------------------------------
------------------------------------------------------------------------------------------------------------------------------------------------------
------------------------------------------------------------------------------------------------------------------------------------------------------
------------------------------------------------------------------------------------------------------------------------------------------------------
-------------------------S----------------------------------------------------------------------------------------------------------------------------
------------------------------------------------------------------------------------------------------------------------------------------------------
------------------------------------------------------------------------------------------------------------------------------------------------------
-------------------------S----------------------------------------------------------------------------------------------------------------------------
------------------------------------------------------------------------------------------%-----------------------------------------------------------
----------------------------------------------%%------------------------------------------|-----------------------------------------------------------
---------------------------%------------------||----%-------------------------------------|-----%------------------------------------%-------%--------
---------------------------|------------------||----|----%--------------------------------|-----|-------------%----------------------|-------|---%----
--------------%------------|------------------||%---|%---|---------------------%-%-%--%%%%|-%---|-------------|-----%----------------|------%|---|%---
--------------|%-%---------|---------%------%-|||%--||---|---------------------|-|-|%-|||||-|---|-------------|%----|%---------------|-%%---||---||---
%%%%%%%%-%----||-|---------|-%-------|------|-||||--||---|---------------------|-|-||-||||%-|---|--%--%-------||----||---------------|-||---||%-%||-%-
||||||||X|---X||X|-XXXXXX-X|X|-X-XXXX|XXXXXX|-||||-X||---|XX-----XXXXXXXXX---XX|X|X||X|||||-|XXX|XX|XX|X-XXXXXX|XXX-||XXXX-XXXXX-XXX-|X||---|||X|||-|-