------------------------------------------------------------------------------------------------------------------------------------------------------
------------------------------------------------------------------------------------------------------------------------------------------------------
------------------------------------------------------------------------------------------------------------------------------------------------------
------------------------------------------------------------------------------------------------------------------------------------------------------
------------------------------------------------------------------------------------------------------------------------------------------------------
---------------------------------------------------------------------------S--------------------------------------------------------------------------
------------------------------------------------------------------------------------------------------------------------------C-----------------------
------------------------------------------------------------------------------------------------------------------------------g-----------------------
---------------------------------------------------------------------------%--------------------------------%-----------------------------------------
---------------------------------------------------------------------------|--------------------------------|-----------------------------------------
---------------------------------%-----------------------------------------|--------------------------------|-----------------------%-----------------
--------------------------%------|-----G------------------------------C----|--------------------------------|-----------------%-----|%----------------
--------------------------|-%---%|-----%------------------------%%--%----%-|-----%%-------------------------|%----------------|-%%--||%---%--------%--
--------------------------|%|%%-||-----|-----%---S--------------||-%|--%%|-|-----||-------------%-----------||-%%-------------|-||-g|||---|--%-----|--
%%%%%%%%----%%%%%%%%%-----|||||-||-----|-----|--%--%--%---------||-||--|||%%-----||-%----%------|-----------||%||%-%----------|-||--|||-%-|--|%----|--
||||||||XXX-|||||||||XXXXXX|X||-||-XXXX|XXXXX|XX|XX|XX|XXXXXXXXX||X||XX|||||XX-XX||-|XXXX|-XXXXX|XXXXXXXXXXX||||||-|XXXX---XXX|X||XX|||-|X|XX||XXXX|X-