------------------------------------------------------------------------------------------------------------------------------------------------------
------------------------------------------------------------------------------------------------------------------------------------------------------
------------------------------------------------------------------------------------------------------------------------------------------------------
------------------------------------------------------------------------------------------------------------------------------------------------------
------------------------------------------------------------------------------------------------------------------------------------------------------
------------------------------------------------------------------------------------------------------------------------------------------------------
------------------------------------------------------------------------------------------------------------------------------------------------------
--------------------------------------------------------------------------------------------------------------------------------------------%---------
--------------------------------------------------------------------------------------------------------------------------------------S-----|---------
--------------------------------------------------------------------------------------------------------------------------------------------|---------
----------------------------------%-----------------------------------------------------------------------------------------------------%---|---------
----------------------------------|------------------%-------%------%--------%----------%t------------%%-----------------%--------------|---%---%-----
---------------------%-------%%---|------------------|-------|------|---%----|--%-%-----|t%--%--------||-%-----------%%--|%%----------%-|---|---|%----
--------------------%|-------||%%-|-----------------%|-%-----|------|---|----|--|%|-----|%|--|%-------||-|-%------%-%||--|||----------|%|---|--%||----
%%%%%%%%------------||----%--||||-|----%--------%---||-|-----|------|---|----|-%|||-----|||--||-------||-|-|------|-|||-%|||--%%%-----|||%%%|-%|||----
||||||||-XX--XXXXXXX||XXXX|XX||||X|XX--|XX-XXXXX|XX-||X|XXXX-|-XXX-X|XXX|X-X-|X||||XXXXX|||X-||-XXXX-XXX-|X|XXXXXXXX||X-||||--|||XXXXX|||||||X|X||-XXX