------------------------------------------------------------------------------------------------------------------------------------------------------
------------------------------------------------------------------------------------------------------------------------------------------------------
------------------------------------------------------------------------------------------------------------------------------------------------------
------------------------------------------------------------------------------------------------------------------------------------------------------
------------------------------------------------------------------------------------------------------------------------------------------------------
------------------------------------------------------------------------------------------------------------------------------------------------------
------------------------------------------------------------------------------------------------------------------------------------------------------
------------------------------------------------------------------------------------------------------------------------------------------------------
-------------------------------------------------------------------------------------------------------------------------S-----%-------------%----%---
----------------------%---------------------------------------------------------------t----------------------------------------|-------------|----|---
---------------%%-----|---------%%-----%%--------------------------%------------------t---------------------%------------------|-------------|----|---
---------------||-----|---------||-----||-------------%------------|%-----------------t---------------------|--------%---%-----|-------------|----|---
---------------||-----|----%-%-%||%----||-----------%-|---%--------||----------------%%------------------%-%|--%----%|---|--%--|----%%------%|----|---
---------%%%---%|-----|----|-|-||||----||-%----%%%--|-|---|%-------||-----%------%--%||-----------------%|-||--|----||---|--|--|----||-%----||----|---
%%%%%%%%%|||--%||%-%--|----|-|%||||----||-|----|||--|-|---||%-%----||%----|------|-%|||-----------%-----||-||--|----||%--|%-|%%|%---||-|----||----|%--
|||||||||X||-X||||X|XXXXXXX|X||||||X-XX||-|XX-X|||X-|X|-XX|||X|XXX-|||XXXX|XXXX-X|X||||XXXXX-XXXXX|XX-XX||XX|--XXXXX|||XX||X|||||-XX||-|XXXX||XXXX||XX