------------------------------------------------------------------------------------------------------------------------------------------------------
------------------------------------------------------------------------------------------------------------------------------------------------------
------------------------------------------------------------------------------------------------------------------------------------------------------
------------------------------------------------------------------------------------------------------------------------------------------------------
------------------------------------------------------------------------------------------------------------------------------------------------------
------------------------------------------------------------------------------------------------------------------------------------------------------
--------------------------------------------------------------------2-------------------------------------------%-------------------------------------
----------------------------------------------------------------------------------------------------------------|-------------------------------------
----------------------------------------------------------------------------------------------------------------|-----------%%------------------------
----------------------------------------------------------------------------------------------------------------|-----------||-----------%------------
--------------------------------------------------------------------%-------------------------------------------|-----------||-----------|------------
------------------------%--------------------%---%%-----------------|-------------------------------------------|-----------||--%--------|------------
--------%--%--------%---|%--------%--%-----%-|---||-----------------|%------%----------%----%----%-%------%-----%%---------%||--|---S----|-----%---%--
--------|--|---%%%--|---||--------|--|-%---|-|---||-----------------||------|-----%-%%-|---%|-%--|-|--%---|-%---||----%----|||--|----%---|-----|--%|%-
%%%%%%%%|-%|%-%|||--|%%-||%-------|--|-|%--|-|---||---%-------%--%%-||------|-----|-||-|---||-|--|-|--|%%%|%|%--||%---|----|||-%|%-%-|---|-%---|--|||-
|||||||||X|||X||||-X|||X|||XXXXXXX|XXXX||XX|X|XXX||-XX|XX--X-X|X-||X||XXXX-X|XXXXX|-||XX--XX|-|XX|X|--||||||||XX|||XXX|-XXX|||-|||-|X|XXX|X|--X|XX|||X