------------------------------------------------------------------------------------------------------------------------------------------------------
------------------------------------------------------------------------------------------------------------------------------------------------------
------------------------------------------------------------------------------------------------------------------------------------------------------
------------------------------------------------------------------------------------------------------------------------------------------------------
------------------------------------------D-----------------------------------------------------------------------------------------------------------
------------------------------------------------------------------------------------------------------------------------------------------------------
------------------------------------------------------------------------------------------------------------------------------------------------------
------------------------------------------------------------------------------------------------------------------------------------------------------
----------------------------------------------------------------------------------------------------------------------------------------%-------------
---------------------------------------------------------------------------------------%-------------------D----------------------------|-------------
------------------------------------------%-----------------%-------%----------------%-|------------------------------------------------|------------%
------------------------------------------|-----------------|-------|-------%--------|-|------------------------------------------------|------------|
----------------%------%------------------|--%------%-%-----|-------|%------|----%---|-|---------%------------%%%-%-%-----------S------%|-------%%---|
--------%----%%-|------|------------%-----|%-|------|-|---%%|%%-%-%-||------|----|---|-|---------%%------g-%%-|||-|-|------%-------%---||-----%-||---|
%%%%%%%%|-%--||%|------|------%-----|-----||-|------|-|---|||||%|-|-||------|----|---|-%---------||--------||-|||-|-|----%-|-------|---||---%-|-||--%|
|||||||||X|--||||XXX-XX|X--XXX|X-X-X|---XX||-|--X-XX|X|X--|||||||X|X||XXXXXX|XXX-|XXX|X|XXXXXXXXXX|XX--XXXX||X|||X|X|-XXX|X|---XXXX|XXX||-XX|X|X||X-||