------------------------------------------------------------------------------------------------------------------------------------------------------
------------------------------------------------------------------------------------------------------------------------------------------------------
------------------------------------------------------------------------------------------------------------------------------------------------------
------------------------------------------------------------------------------------------------------------------------------------------------------
------------------------------------------------------------------------------------------------------------------------------------------------------
------------------------------------------------------------------------------------------------------------------------------------------------------
----------------%-------------------------------------------------------------------------------------------------------------------------------------
----------------|--------------------------------------------------------------------------------------------------------------------------C----------
----------------|------------------------------------------------------------------------------------------------------------------------------%%-----
--------------T-|---------------------------------------------------------------------------------%---%----------------------------------------||-----
--------------t-|---------------------------------------------------------------------------------|---|---------%------------------------%---%-||-----
--------------t-|-----------------------------------------%---------------------%-----------------|2--|---------|---------------%--------|---|-||-----
--------------%-|-------------%---------------------------|---------------------|-----------------|---|%%-------|----%---%------|---%----|---|-||-----
--------------|-%-%%------%---|----------------%-%-%------|---------%----%---%--|------------%----|---|||-------|----|--%|%-%-%%|---|-%--|---|-||-----
%%%%%%%%------|-|-||------|---|---%%%%%----%---|-|-|--%---|--%----%-|---%|---|--|------------|---%|--%|||----%--|%---|--|||-|-|||---|%|--|---|%||-----
||||||||X-XXXXX-|X||---XXX|XXX|X--|||||XXXX|XXX|X|X|XX|XX-X--|-XXX|-|---||XXX|XXXXXXXX---XXXX|XXX||X-||||XXXX|XX||XX-|XX|||X|X||XXXXX||--|-X-||||----X