------------------------------------------------------------------------------------------------------------------------------------------------------
------------------------------------------------------------------------------------------------------------------------------------------------------
------------------------------------------------------------------------------------------------------------------------------------------------------
------------------------------------------------------------------------------------------------------------------------------------------------------
------------------------------------------------------------------------------------------------------------------------------------------------------
------------------------------------------------------------------------------------------------------------------------------------------------------
-------------------------------------------------%%---------------------------------------------------------------------------------------------------
-------------------------------------------------||---------------------------------------------S-----------------------------------------------------
---------------------------------------D---------||---------------------------------------------------------------------------------------------------
------------------------------%---------t--------||--------------------------------------------------------------%------------------------------------
------------------------------|---------t--------||--------------------------------------------------------------|------------------------------------
------------------------------|---%----D%-K------||----------k-------------------------------------------%-------|------------------------------------
------------------------------|---|-----|-%-%%---||----------%%--%--------------%%%-%--------------------|-%--%--|%------%-------------%---------%----
------------%------%-----%--%-|---|-----|-|-||--%||---%%-----||--|----%%--------|||-|-----------%-%------|-|--|--||%---%%|%-%%%------%-|---%-----|----
%%%%%%%%%%--|--%--%|-----|-%|-|---|----%|-|-||%-|||---||-----||--|----||--------|||%|-%%-%%%%---|-|-%----|-|--|--|||---||||-|||---%--|-|---|-%---|-%X-
||||||||||-X|-X|X-||--XXX|X|X-|X-XXXXX-||X|-|||X|||XXX||XXX--X|XX|XX-XX|XXXX--XX|||||X||X||||--X|X|X|-X-X|X|-X|XX|||XXX||||X|||--X|XX|-|XXX|X|-XX|-|X-