------------------------------------------------------------------------------------------------------------------------------------------------------
------------------------------------------------------------------------------------------------------------------------------------------------------
------------------------------------------------------------------------------------------------------------------------------------------------------
------------------------------------------------------------------------------------------------------------------------------------------------------
------------------------------------------------------------------------------------------------------------------------------------------------------
------------------------------------------------------------------------------------------------------------------------------------------------------
------------------------------------------------------------------------------------------------------------------------------------------------------
----------------------------------------------------------------------------------------------------------------------%--%------------D---------------
----------------------------------------------------------------------------------------------------------------------|--|----------------------------
----------------------------------------------------------------------------------------------------------------------|--|S---------------------------
------------------------------------------------------------------------------------------------------------------%---|--|----------------------------
---------------g---------------------------------------------------------------------%----------------------------|---|--|----------------------------
-----------------%%----------------------------------------------------%-----%-------|--------------%-----%--%----|---|--|-%%-----------------%%------
-----------------||---------------%-%-%%-----%---%-------------%-------|-----|%-----%|--------------|----%|--|%---|F%%|%-|%||-----%-----------||------
%%%%%%%%------%--||------%--------|%|%||----%|---|--------%----|-%-----|-----||-----||-----%-----%--|----||--||---|%||||%||||-----|-----------||------
||||||||XX---X|-X||XXXXXX|---X-XXX||||||X-XX||XXX|-XXXXXX-|--XX|X|XXXXX|X-XX-||XXXXX||----X|X----|XXX-X-X||-X||X--|||||||||||XXXXX|XXX-XXXX-XX||XXXXX-