------------------------------------------------------------------------------------------------------------------------------------------------------
------------------------------------------------------------------------------------------------------------------------------------------------------
------------------------------------------------------------------------------------------------------------------------------------------------------
------------------------------------------------------------------------------------------------------------------------------------------------------
------------------------------------------------------------------------------------------------------------------------------------------------------
------------------------------------------------------------------------------------------------------------------------------------------------------
------------------------------------------------------------------------------------------------------------------------------------------------------
---------------------------------------------------------------------------------------------------------------------------------------------------%--
--------------------------------------------------------t------------------------------------------------------------------------------------------|--
------------------------------------------t-------------T------------------------------------------------------------------------------------------|--
-------------------------------%----------t-------------t------------------------------------------------------------------------------------------|--
-------------------%-------%---|---%------t--------%----%---%-------------------------------------------------------------------------%-----------%|--
---------------%---|----%--|---|---|------%------%-|----|%%-|--%--------------%-------%---%%%%%-----------%---------%--------%--------|-%---%%%%--%|%%
--------------K|---|----|--|---|---|------|------|-|--%-|||-|--|--------------|-------|---|||||----%--%---|----%%%--|-------%|--%-----|-|---||||--||||
%%%%%%%%------%|--%|---%|%%|---|--%|------|------|-|%-|-|||-|--|--%--%-%------|--%----|-%-|||||-%--|--|-%-|----|||--|-------||--|-----|%|---||||--|%||
||||||||X-XXX-||-X|XXXX||||X--X|-X|XXXX-XX|XXXX-X|X||X|X|||X|XX|--|XX|-|-XXXXX|--|XXXX|X|-|||||X|X-|--|X|X|XXXX|||XX|--XXX--|XXXXXX-XX|||XXX||||XX||||