------------------------------------------------------------------------------------------------------------------------------------------------------
------------------------------------------------------------------------------------------------------------------------------------------------------
------------------------------------------------------------------------------------------------------------------------------------------------------
------------------------------------------------------------------------------------------------------------------------------------------------------
------------------------------------------------------------------------------------------------------------------------------------------------------
------------------------------------------------------------------------------------------------------------------------------------------------------
------------------------------------------------------------------------------------------------------------------------------------------------------
-----------------------------------------------------------------------------------------------------------------------------------------------%------
----------------------------%------------------------------------------------------------------------------------------------------------------|------
----------------------------|-------------------------------------------------------------------------%----------------------------------------|------
----------------------------|-----------S----%-------%---%------------------------------%-------------|----------------------------------------|------
----------------------------|----------------|-------|---|%%%---------------------------|-------------|----------F-----------------------------|------
----------------------%%%---%---------%------|---%---|%--||||-%---------------------%%--|-%-----------|------%---%-------------------%%--------|------
-----------%--%%------|||-%-|--------%|-%--%-|---|---||--||||-|--%------------------||--|-|%-%--%----%|------%---|-%----%----%-%-----||--------|---%--
%%%%%%%%---|%-||--%--%|||-|-|%-------||-|--|-|---|---||%-||||-|%-|%--%--------%-----||--|-||-|%-|----||-----%|---|-|----|----|-|%%---||%%%%----|---|--
||||||||---||X||-X|X-||||X|-||--XXXXX||X|XX|X|-XX|XXX|||X||||X||-||XX|--XX--XX|XXXXX||-X|X||X||X|-XXX||-XXX-||XXXX-|XXXX|XXXX|X|||X--||||||XXXXX---|XX