------------------------------------------------------------------------------------------------------------------------------------------------------
------------------------------------------------------------------------------------------------------------------------------------------------------
------------------------------------------------------------------------------------------------------------------------------------------------------
------------------------------------------------------------------------------------------------------------------------------------------------------
------------------------------------------------------------------------------------------------------------------------------------------------------
------------------------------------------------------------------------------------------------------------------------------------------------------
---------------------%--------------------------------------------------------------------------------------------------------------------------------
---------------------|-------------------------------------------------------------------------------------------------%------------------------------
---------------------|-------------------------------------------------------------------------------------------------|-------t----------------------
---------------------|---------------------------------------------------------------------%---------------------------|-------t----------------------
-----------------%---|-------------#-------------------------------------------------------|---------------------------|-------t----------------------
-----------------|---|-------------#-------------------------%-----------------------------|----------------------%----|-------%----------------------
-----------------|--%|---------%--%#---------%-----%---------|---%--%------------%-------%-|%----%-------%%-------|----|-------|--%%--------%-%-------
---------%----%-%|--||-----%---|--|%---------|%---%|%--%-%--%|---|--|------------|-------|%||----|--%----||-------|--%%|---%--%|--||-%------|%|--%----
%%%%%%%%%|----|-||%-||--%%%|%--|--||----%%---||%--|||--|-|--||---|%-|----%-%%%--%|%------||||--%-|--|--%-||-------|-%|||---|--||%%||-|------|||%-|--%%
||||||||||XXX-|X|||X||XX|||||-X|XX||XX-X||XXX|||-X|||--|-|-X|X-XX||-|XXXX|X|||XX|||XXXXXX||||-X|X|XX|XX|-X|XXXXXXXX-||||XXX|X-|X||||X|-XXXXX||||X|--||