------------------------------------------------------------------------------------------------------------------------------------------------------
------------------------------------------------------------------------------------------------------------------------------------------------------
------------------------------------------------------------------------------------------------------------------------------------------------------
------------------------------------------------------------------------------------------------------------------------------------------------------
------------------------------------------------------------------------------------------------------------------------------------------------------
------------------------------------------------------------------------------------------------------------------------------------------------------
------------------------------------------------------------------------------------------------------------------------------------------------------
---------------------------------------D----------------------------------------------------------------------------------------------------------%--%
-------------------------------------------------------%------------------------------------------------------------------------------------------|--|
---------------------------------------------S---------|------------------D-----------------------------------------------------------------------|--|
-------------------------------------------------------|--%------%----------------------------------------------------S------------%--------------|--|
-------------------------------------------------------|--|------|----------%--------------%---------------------------------------|--%------%----|--|
--------%---------%%%%--%---%------------------------%-|%-|--%%--|--------%-|--%-%%%-------|--------------%-------%%-%-------------|--|------|----|--|
--------|---%%--%-||||--|---|%--------%---%%-%-------|-||-|%-||-%|-----%--|-|--|-|||---%%--|-%------------|----%--||-|%-----%------|--|------|%---|--%
%%%%%%%%|---||%-|-||||--|---||-%------|-%-||-|----%%-|-||-||-||-||--%--|--|-|--|-|||--X||%-|%|%%%------%--|----|--||-||---%-|%---%%|--|-%----||---|--|
||||||||XXXX|||X|X||||XX|XXX||X|XXXXX-|-|-||X|-XXX||X|X||X||X||X||X-|XX|XX|XXX-|X|||-XX|||X||||||XXXXXX|X-|XXXX|XX||X||-XX|X||X--|||XX|X|--XX||X--|-X|