------------------------------------------------------------------------------------------------------------------------------------------------------
------------------------------------------------------------------------------------------------------------------------------------------------------
------------------------------------------------------------------------------------------------------------------------------------------------------
------------------------------------------------------------------------------------------------------------------------------------------------------
------------------------------------------------------------------------------------------------------------------------------------------------------
------------------------------------------------------------------------------------------------------------------------------------------------------
------------------------------------------------------------------------------------------------------------------------------------------------------
------------------------------------------------------------------------------------------------------------------------------------------------------
------------------------------------------------------------------------------------------%-----------------------------------------------------------
------------------------------------------------------------------------------------------|-----------------------------------------------------------
----------------------------------------------------%-------------------------------------|------%--------------%-------------------------------C-----
----------------------------------------------------|-------------------------------------|------|---------%%---|-------------------------------------
---------%%--------%-----------------------------%--|--%%----------------%---------%-%----%------|%--------||---|------------%--------%----------%----
---------||--------|-----%%%---%--%-------------%|%%|--||----%-----------|---------|-|----|---%--||--------||---|-------%----|--------|%---------|--%-
%%%%%%%%%||%-------|-----|||---|--|-%-----%---%-|||||--||----|-%---------|-------%-|%|%---|---|--||--------||---|------%|----|%-------||--------%|--|-
||||||||||||X--XXXX|X-XX-|||XXX|XX|X|-XXXX|XXX|-|||||XX||X---|X|XXXX-XX--|XXXXXXX|X||||XXX|-XX|XX||XXXXXXXX||-XX|XX-XXX||X-XX||--XX---||XX-XXXX-||--|X