------------------------------------------------------------------------------------------------------------------------------------------------------
------------------------------------------------------------------------------------------------------------------------------------------------------
------------------------------------------------------------------------------------------------------------------------------------------------------
------------------------------------------------------------------------------------------------------------------------------------------------------
------------------------------------------------------------------------------------------------------------------------------------------------------
------------------------------------------------------------------------------------------------------------------------------------------------------
-------------------------------------------------------%----------------------------------------------------------------------------------------------
-------------------------------------------------------|----------------------------------------------------------------------------------------------
-------------------------------------------------------|-----------------------------------------------------------%----------------------------------
-------------------------------------------------------|-----------------------------------------------------------|----------------------------------
----------------------------%--------------------------|-------------------------------------------------------%---|--------------------------%-------
----------------------------|--------------------------|--%----------------------------------------------------|---|-----#--------------------|-------
-----------%------%--------%|------------%----%--%--%--|--|--------%----------------------%--%--%%%------------|---|-%---%%-%---%-------------|-------
--------%--|------|--------||-%-%--------|----|--|--|--|--|------%%|-----------------%%-%-|--|--|||--%%%---%---|---%-|--%||-|-%-|----%%%%%%--%|------%
%%%%%%%%|--|%%----|--------||-|-|%%-----%|-%%-|%-|--|%%|--|------|||----------%--%--%||-|-|-%|--|||--|||---|---|---|-|--|||-|-|-|----||||||--||------|
||||||||XXX|||XXXX|X-XXXXXX||-|X|||XXXXX||-||X||X|XX||||XXXXXXXXX|||XXXXXXX--X|XX|--|||X|X|-||X-|||--|||---|XX-|XX-|X|XX|||X|X|X|XXX-||||X|X-||XXXXX-|