------------------------------------------------------------------------------------------------------------------------------------------------------
------------------------------------------------------------------------------------------------------------------------------------------------------
------------------------------------------------------------------------------------------------------------------------------------------------------
------------------------------------------------------------------------------------------------------------------------------------------------------
------------------------------------------------------------------------------------------------------------------------------------------------------
-------------------------------%------------------------------%---------------------%-----------------------------------------------------------------
-------------------------------|------------------------------|---------------------|-----------------------------------------------------------------
-------------------------------|------------------------------|---------------------|-----------------------------------------------------------------
------------------------S------|------------------------------|---------------------|-----------------------------------------------------------------
-------------------------------|------------------------------|---------------------|-----------------------------------------------------------------
-------------------------------|-----------%------------------|---------------------|-----------------------------------------------------------------
------------------------%---U--|--------g--|------------------|---------------------|--%----------------%---------%-------%--%------%-----g-C---------
-------------%%-%-------|------|-----------|--------%----%----|------%-%%-------%---|--|---------%------|--%-%----|%------|--|-----%|----%%--%--------
-------------||-|-------|-2---2%-C------%--|--------|-%-%|----|------|-||-------%---|--|-%-------|------|--|-|----||------|-%|%----||----||--|----%---
%%%%%%%%-----||-|-------|------|--------|--|--%-----|-|-||%%--|--%---|-||-------|--%|--|-|--%-%%-%--%---|-%|-|-%--||------|-|||-%--||----||--|---%|---
||||||||XXXXX||X|X-XXXX-|XXXXXX|XXXXXXXXXXX|XX|XXXXX|X|X||||XX|--|-XX|X||XXXX---XX-||-X|X|XX|X||X|XX|XXXXX||X|X|--X|-X--XX|X|||X|XX|XXXXX||XX|XXX||XXX