------------------------------------------------------------------------------------------------------------------------------------------------------
------------------------------------------------------------------------------------------------------------------------------------------------------
------------------------------------------------------------------------------------------------------------------------------------------------------
------------------------------------------------------------------------------------------------------------------------------------------------------
------------------------------------------------------------------------------------------------------------------------------------------------------
------------------------------------------------------------------------------------------------------------------------------------------------------
--------------------------------------------------------------------------------------------------%---------------------------------------------------
--------------------------------------------------------------------------------------------------|---------------------------------------------------
--------------------------------------------------------------------------------------------------|---------------------------------------------------
--------------------------------------------------------------------------------------------------|-------------------------------------------------%-
--------------------------------------------%---------------------------------------------%-------|-------------------------------------------------g-
---------------%----------------------------|---------%-----------------------------------|--%----|-------------------------------------%-----------|-
---------------|-----------------%----------|------%-%|-----------------------------------|--|----|------------%-------------%----%%%---|-%---------|-
---------------|-------%%-------%|----------|------|%||-----%---------%%----------------%-|%%|%%%-|---%%%--%--%|----%%%------|----|||---|-|---------|%
%%%%%%%%-------|-%%%%%-||-------||--%%---%%-|--%%%-||||-----|---------||%---------------|-|||||||-|-%%|||--|%-||----|||--%---|----|||---|-|------%--%|
||||||||X-XXXXX|-|||||X||X-X--XX||XX||XXX||X|-X|||X||||-XXX-|X--------|||XX-XXXXXXXXXXXX|X|||X|||X|-|||||X-||-||X--X|||X-|XXX|XXXX|||--XXX|-XXXX-|-X||