------------------------------------------------------------------------------------------------------------------------------------------------------
------------------------------------------------------------------------------------------------------------------------------------------------------
------------------------------------------------------------------------------------------------------------------------------------------------------
------------------------------------------------------------------------------------------------------------------------------------------------------
------------------------------------------------------------------------------------------------------------------------------------------------------
-------------------------------------------------------------------------------%----------------------------------------------------------------------
-------------------------------------------------------------------------------|---------------------D------------------------------------------------
------------------------------------------%------------------------------------|----------------------------------------------------------------------
-----------------------%------------------|------------------------------------|----------------------------------------------------------------------
-----------------------|-------------%----|------------------------------------|----------------------------------------------------------------------
-----------------------|-------------|----|-------------------%----------------|-----------------------------------t----------------------------------
-------------%---------|-------------|----|-------------------|----------------|----------%------------------------t------------------------%---------
------------%|------%--|-%-%---------|%---|----------%--------|%%%%----%-------|--------%-|%-%%------%-------------t------------------------|---------
------------||-----%|--|-|-|---------||%-%|--------%%|--------|||||%---|---%%--|--------|-||-||-----%|-------------%-----------------------%|--------%
%%%%%%%%%---||-----||-%|%|-|-%---%---|||-||--%-----||%----%---||||||---|---||--|----%---|-||-||---%%||------%-%----|-----%------%----------||--------|
|||||||||XXXX|XX-XX||-||||X|X|XXX|X-X|||X||XX|XX--X|||XX--|XXX||||||X-X|--X||-X|XXXX|XXX|X||-|XX-X||||XXXXX-|X|X-XX|XXXXX|XXXXXX|X-XXXXXXXX|XXXXXXXXX|