------------------------------------------------------------------------------------------------------------------------------------------------------
------------------------------------------------------------------------------------------------------------------------------------------------------
------------------------------------------------------------------------------------------------------------------------------------------------------
------------------------------------------------------------------------------------------------------------------------------------------------------
------------------------------------------------------------------------------------------------------------------------------------------------------
---------------------------------------------------------------------------------------------------------------------%--------------------------------
---------------------------------------------------------------------------------------------------------------------|--------------------------------
---------------------------------------------------------------------------------------------------------------------|--------------------------------
---------------------------------------------------------------------------------------------------------------------|--------------------------------
-------------------------------------------------------------------------------------------------------------%-------|--------------------------------
------------%---------------------------------------------------------------------------------%%-------------|---%%--|-----------U--------------------
------------|--------%%-------------%---%--------------------S--------------------------------||--------%----|---||--|----%%--#-----------------------
----------%-|--------||-------%-----|---|---------%----%--%-----------%-----%--------%%%%-----||%-%%%---|-%-%|--%||--|----||--#-----------------------
--------%-|-|--------|%%--%%%%|-----|---|---------|----|-%|-----------|--%%-|--------||||-----|||-|||---|-|-||--|||%-|----||%-%%%----%----------------
%%%%%%%%|-|-|%%------|||--|||||----%|---|---------|%---|-||-----%%----|--||-|--------||||--%%-|||%|||-%-|-|-||%-||||-|----|||%|||%---|-----%-------%%-
|||||||||X|X|||XXXXXXX||XX|||||XXX-||X--|---XXXXX-||XXX|X||X-XX-||XXXX|--||X|XXXXX---||||X-||X|||||||X|XX-|X|||X||||X|XXXX||||||||XXX|XXXXX|XXXXX-X||X