------------------------------------------------------------------------------------------------------------------------------------------------------
------------------------------------------------------------------------------------------------------------------------------------------------------
------------------------------------------------------------------------------------------------------------------------------------------------------
------------------------------------------------------------------------------------------------------------------------------------------------------
-----------------------------------------------------------------------------------------------------------------------------------------------%------
-----------------------------------------------------------------------------------------------------------------------------------------------|------
-----------------------------------------------------------------------------------------------------------------------------------------------|------
-----------------------------------------------------------------------------------------------------------------------------------------------|------
-----------------------------------%-----------------------------------------------------------------------------------------------------------|------
---------------------------%-------|-----------------------------%--------------------------------------------------------------%--------------|------
---------------------------|-------|-----------------------------|------S-----------%----------------%--------------------------|--------------|------
---------------------------|-------|---------%-----------%-------|-----------------F|----------------|----%S-------------%------|--------------|-----%
---------------%%--%-------|%------|---------|--%-%-%-%--|%------|-----------------%|%--------%------|----|----%---------|%%----|--------------|----%|
---------------||-%|-%%%--%||--%---|---------|%-|-|%|-|--||------|%----------------|||--------|------|----|-%-%|---------|||----|-%-----------g|----||
%%%%%%%%%---%--||-||-|||--|||%-|---|%--%%----||%|-|||-|--||-%%-%-||-----%%---%-#---|||%-------|---%%-|---%|-|-||--------%|||---%|-|------------|--%-||
|||||||||X--|XX||-||X|||-X||||-|XXX||XX||XXXXX|||X|||X|-X||X||X|X|XXXXXX||XXX|-XXX-||X|XX----X|XXX||X|XXX||X|XX|XXX--XXX|X||--X||X|XXXXXXX-XXX-|XX|X||