------------------------------------------------------------------------------------------------------------------------------------------------------
------------------------------------------------------------------------------------------------------------------------------------------------------
------------------------------------------------------------------------------------------------------------------------------------------------------
------------------------------------------------------------------------------------------------------------------------------------------------------
------------------------------------------------------------------------------------------------------------------------------------------------------
--------------%-------------%----------------------------------------------------------%--------------------------------------------------------------
--------------|-------------|----------------------------------------------------------|--------------------------------------------------------------
--------------|-------------|----------------------------------------------------------|---------------------------------------------------------%----
--------------|-------------|----------------------------------------------------------%------------------------------------------------T--------|----
--------------|-------------|----------------------------------------------------------|---%-------------%------------------------------t--------|----
--------------|-------------|------%----------%----------------%-----------------------|---|----%%-%-----|------------------------------t--------|----
--------------|-------------|------|----------|----------------|--------%--------------|---|----||-|-----|------------------------------t--------|-S--
--------------|-----%-%-----|----%-|----------|----------%-----|--------|---------%----%-%-|---%||-|-----|-------------%--%---%%-%------%---%%%--|%---
--------------|%----|-|%----|----|-|-%--%--%-%|-%--------|%----|--------|---------|----|-|-|--%|||-|-----|--%----%-----|--|---||-|--%---|%%-|||--||---
%%%%%%%%-%%---||----|-||---%|-%--|%|-|--|%-|-||-|-----%%%||----|--------|%--%%---%|%%%-|-|-|--||||-|-----|--|----|--%-%|--|---||-|%-|---|||-|||--||---
||||||||X||X--||X---|X||XXX||-|XX|||X|X-||X|X||X|-X-X-|||||X-XX|X-XXXXXX||--||XXX|||||X|X|X|XX||||X|X--X-|-X|--XX|--|X||XX|XX-||-||-|XXXX||-|||XX||XXX