------------------------------------------------------------------------------------------------------------------------------------------------------
------------------------------------------------------------------------------------------------------------------------------------------------------
------------------------------------------------------------------------------------------------------------------------------------------------------
------------------------------------------------------------------------------------------------------------------------------------------------------
------------------------------------------------------------------------------------------------------------------------------------------------------
------------------------------------------------------------------------------------------------------------------------------------------------------
------------------------------------------------------------------------------------------------------------------------%-----------------------------
------------------------------------------------------------------------------------------------------------------------|-----------------------------
------------------------------t-----------------------------------------------------------------------------------------|-----------------------------
------------------------------T-----------------------------------------------------------------------------------------|-----------------------------
------------------------------t--------------------------------------%------%-------------------------------------------|-----------------------------
----------S------------------%%--------------------------------------|------|-------------------------%---%%------------|-------g------------t--------
-----------%--#---%--%-------||----%%--%--------%--%%--%--%%----%%%%-|%%%---|-------%%--------%-%-%---|--%||---%------%-|------------------%-t-------%
-----------|--#---|--|--%----||----||--|-%%---%-|--||--|--||%---||||%||||---|----%%-||%-------|-|-|---|--|||--%|-----%|-|---------%----%---|-t-------|
%%%%%%%%---|%%%---|--|--|---%||---%||--|-||---|-|-%|%--|--|||---|||||||||%--|----||-|||-------|-|-|---|-%|||--||----%||-|--%------|----|---|-%-%-----|
||||||||X-X||||XXX|-X|XX|XX-|||XXX|||XX|-||XX-|X|-|X|XX|-X|||XXX||||||||||X-|-X--||X|||XXXXXXX|-|X|--X|X||||XX|X----|||X|X-|X---XX|XXXX|XXX|X|X|-XX--|