------------------------------------------------------------------------------------------------------------------------------------------------------
------------------------------------------------------------------------------------------------------------------------------------------------------
------------------------------------------------------------------------------------------------------------------------------------------------------
------------------------------------------------------------------------------------------------------------------------------------------------------
------------------------------------------------------------------------------------------------------------------------------------------------------
----------------------------------------------------------------------------------%-------------------------------------------------------------------
------------------%---------------------------------------------------------------|-------------------------------------------------------------------
------------------|---------------------------------------------------------------|-%-----------------------------------------------------------------
------------------|---------------------------------------------------------------|-|-----------------------------------------------------------------
------------------|---------------------------------------------------------------|-|----------------------------S------------------------------------
------------------|---------------------------------------------------%-----------|-|-----------------------------------------------------------------
---------------%--|-----------------------------------------%---------|-----------|-|-----------------------------------------------------------------
--------------%|--%------------------------------------%----|---%%-%--|-----------|-|------%-------------%%--------------------%%%--------------%-----
--------------||--|--------------%%-----------%--------|---%|g--||-|--|-----------|%|------|%%---%-%%%---||------%---%---------|||--------------|%%--%
%%%%%%%%---%--||--|--------------||%--%-%-----|--------|---||---||-|--|-----%-----|||------|||---|%|||---||------|---|---------|||%-%--%--------|||--|
||||||||X--|XX||-X|XXXXX----XXX-X|||XX|-|XXXXX|XXXXXXX-|XX-|X-XX||X|XX|XXXXX|XXX-X|||XX-XXX|||XXX|||||XX-||XX---X|XXX|XXXXXX-XX||||X|XX|XX------X||X-|