------------------------------------------------------------------------------------------------------------------------------------------------------
------------------------------------------------------------------------------------------------------------------------------------------------------
------------------------------------------------------------------------------------------------------------------------------------------------------
------------------------------------------------------------------------------------------------------------------------------------------------------
--------------------------------------------------------------------%---------------------------------------------------------------------------------
--------------------------------------------------------------------|---------------------------------------------------------------------------------
--------------------------%-----------------------------------------|---------------------------------------------------------------------------------
--------------------------|-----------------------------------------|---------------------------------------------------------------------------------
--------------------------|----------%------------------------------|-----------------------------------------------%---%-----------------------------
--------------------------|----------|--------%---------------------|-----------------------------------------------|---|-----------------------------
------------------------%-|---------S|--------|---------------------|----------%------------------------------------|---|-----------------------------
------------------------|-|----------|------%-|---------------------|----------|---------------------------%%-------|---|-----------------------------
------------------%---%%|%%%-%%------|------|-|----------------%----|----------|--------%---%--------------||---%---|-%-|-----%----%%%------%------%--
--------%-%-----%-|---||||||-||-%---%|------|-|-----%%%--%%#---|----|----------|%-------|---|%--------%---%||-%-|-%%|-|-|-----|----|||--%-%-|-----%|--
%%%%%%%%|-|-----|-|---||||||-||-|%--||------|-|---%-|||-%||%-%%|----|----%----%||--%----|---||--------|--%|||-|%|-|||-|-|--%--|-%--|||--|-|-|-----||--
|||||||||XXX--XXXX|X-X||||||X|X-||--||----X-|X|XXX|-|||X||||X||XXXXX|XX--|XXXX|||X-|-X--|-XX||XXX--XXXX--||||-|||-|||X|X|XX|XX|-|X-|||X-|X|-|-XXXX||XX