------------------------------------------------------------------------------------------------------------------------------------------------------
------------------------------------------------------------------------------------------------------------------------------------------------------
------------------------------------------------------------------------------------------------------------------------------------------------------
------------------------------------------------------------------------------------------------------------------------------------------------------
------------------------------------------------------------------------------------------------------------------------------------------------------
------------------------------------------D-----------------------------------------------------------------------------------------------------------
------------------------------------------------------------------------------------------------------------------------------------------------------
------------------------------------------------------------------------------------------------------------------------------------------------------
------------------------------------------------------------------------------------------------------------------------------------------------------
---------------------------------------------%--------------------------------------------------------------------------------------------------------
-------------%%------------------------------|---------------------S-------------------------------------------%%-------------------------------------
-------------||------g--------------------%--|Ut-------------%-------------------------------------------------||-------------------------------------
-------------||-----------------------%---|--|-t------%%-----|-------%-------------------%-------%-----------%-||------%----------%%----%%------------
-----------#-||--%--------------%----%|%-%|--|-t-%%-%-||--%--|%-%%%--|-----%---%--%%-----|-------|----------%|-||------|%%----%---||----||------------
%%%%%%%%-%%%-||--|-----%--%---%-|-%--|||-||--|-%-||-|%||--|--||-|||%-|-%---|--%|-%||%%---|-------|-%%---%---||-||------|||%%%%|%%%||----||------------
||||||||-|||X||XX|-XXXX|XX|XXX|-|X|XX|||X||XX|X|X|XX||||XX|XX||X||||X|X|X-X|XX||X|||||XXX|XX-XX-X|X||--X|XXXX|X||XXXXXX|||||||||||||X-XX||XXXX-X----XX