------------------------------------------------------------------------------------------------------------------------------------------------------
------------------------------------------------------------------------------------------------------------------------------------------------------
------------------------------------------------------------------------------------------------------------------------------------------------------
------------------------------------------------------------------------------------------------------------------------------------------------------
-------------------------------------------%----------------------------------------------------------------------------------------------------------
-------------------------------------------|----------------------------------------------------------------------------------------------------------
-------------------------------------------|----------------------------------------------------------------------------------------------------------
-------------------------------------------|------------------------------------------------------------------------%---------------------------------
-------------------------------------------|-%-------------------------------------------------------------S--------|---------------------------------
---------------------------------------%---|-|------------%---------------------------------------------------------|---------------------------------
--------------------------------------%|---|-|------------|--------------%------------------------------------------|---------------------------------
--------------------------------------||---|-|------------|--------------|-----%--------------G------%--------------|---------------------------------
-----------------------------------%--||---|-|------------|---------%----|-%---|---%----------%-----%|-%%-%%-%------|%%------------%#-------------%--%
---------%%%%--%------%--%---------|--||---|-|------------|-----%---|---%|%|---%---|---%------|%--%-||-||-||-|------|||%%---%-----%|#------%-%----|--|
%%%%%%%%%||||--|------|--|--------%|%-||---|-|--------%%--|----%|---|-%-||||---|---|---|------||-%|-||%||-||%|%-%---|||||---|-----||%----%-|-|----|--|
|||||||||||||XX|XXXXXX|XX|XXX-XXXX|||X||XX-XX|XXXXXXXX||XX|-X-X||XXX|X|X||||XXXXXXX|XXX|XXXXXX||X||X|X|||X|||||X|--XX||||---|XXX--|||XXXX|X|X|-X--|XX|