------------------------------------------------------------------------------------------------------------------------------------------------------
------------------------------------------------------------------------------------------------------------------------------------------------------
------------------------------------------------------------------------------------------------------------------------------------------------------
------------------------------------------------------------------------------------------------------------------------------------------------------
------------------------------------------------------------------------------------------------------------------------------------------------------
------------------------------------------------------------------------------------------------------------------------------------------------------
------------------------------------------------------------------------------------------------------------------------------------------------------
-----------------------------------------------------------------------------------------------------------------------------------------------------%
-------------------------------------------------------------------------------------------------------------------------------------------%---------|
-------------------------------------------------------------------------------------------------------------------------------------------|--------%|
----------------------------------------------------------------------------------------------------C--------------------------------------|--------||
---------------------------------------%-----------------------------------------------%---------------------------------------------------|--------||
-----------------%-------%---------%---|G-----------%-----------%---------%------------|---------%--------------%-%---%%--%-%----------%%-%|%-------||
----------%----%%|-------|---------|---|%-%%--%----%|---%-------|---------|----%------F|-----%---|------%-------|-|---||--|%|------%-%-||-|||------%||
%%%%%%%%%-|----|||------%|----%----|--%||%||--|----||---|%----%-|-%-%-----|%%%-|---%--%|---X-|---|-%%%--|-------|-|---||%-|||------|-|%||%|||------|||
|||||||||X|--XX|||XXXXX-||XXXX|XX-X|--||||||XX|-XX-||---||-XX-|XXX|X|XXXXX||||X|XXX|XX||-XXXX|X-X|-|||--|XXXXXXX|X|X--|||X|||XXX-XX|X||||||||X-XXXX|||