------------------------------------------------------------------------------------------------------------------------------------------------------
------------------------------------------------------------------------------------------------------------------------------------------------------
------------------------------------------------------------------------------------------------------------------------------------------------------
------------------------------------------------------------------------------------------------------------------------------------------------------
------------------------------------------------------------------------------------------------------------------------------------------------------
-------------------------------------------------------------------------------------%----------------------------------------------------------------
-------------------------------------------------------------------------y-----------|----------------------------------------------------------------
-------------------------------------------------------------------------%-----------|----------------------------------------------------------------
-------------------------------------------------------------------------|---------%-g----------------------------------------------------------------
-------------------------------------------------------------------------|---------|-%----------------------------------------------------t-----------
---------%---------------------------------------------------------------|---------|-|----------------------------------------------------t-----------
---------|-----------------------------S-------------------%-------------|-S-------|-|-----%----------------%-------------C---------------t-----------
---------|----------------%%-%--------------C-----%%%------|-------------|---------|-|----%|----------------|-----------------------------%-----------
---------|-------%%%%%%-%-||-|%-----------------%-|||------|%%-----------|-----%%%-|-|%-%%||%-%-------%-----|-----------------------%%----|-----------
%%%%%%%%-|-%%---%||||||-|-||-||%----------------|-|||------|||%-------%--|-----|||-|-||-|||||%|-------|--%-%|----------------%%%-%%%||----|---------%-
||||||||X|-||XX-|||||||X|X||X|||XXX-X-XX-XXXXXXX|X|||XXXXXXX|||XXXXXXX|XX|-XXXX|||X|X||X|||||||XXXXXX-|--|X|XXXXXXXXXX-XXXXXX|||X|||||XXXX|XXXXXXXXX|-