------------------------------------------------------------------------------------------------------------------------------------------------------
------------------------------------------------------------------------------------------------------------------------------------------------------
------------------------------------------------------------------------------------------------------------------------------------------------------
------------------------------------------------------------------------------------------------------------------------------------------------------
------------------------------------------------------------------------------------------------------------------------------------------------------
------------------------------------------------------------------------------------------------------------------------------------------------------
------------------------------------------------------------------------------------------------------------------------------------------------------
------------------------------------------------------------------------------------------------------------------------------------------------------
-----------------------------------%------------------------------------------------------------------------------------------------------------------
-----------------------------------|-------------------%---------------------------------------------------------------------------------------------t
-----------------------------------|-----------------%-|---------------------------------------------------------------------%-----------------------t
-----------------------------------|-----%-----------|-|---------------------------------------%-----------------------------|-----------------------t
-----------%--%-%%---------%%%-----|-----|-------%---|-|%----%%--------------%U%-%-%-----------|-----%---------------%%-%%---|----------%--%---------%
-----------|-%|-||---------|||%%---|-----|-------|---|%||%---||-----------%--|-|-|-|-%%-----%%-|%%---|------------%--||-||%--|-%-%%%%---|--|-----%---|
%%%%%%%%---|%||%||---------|||||-%-|-%---|--%---%|---|||||--%||%-%%----%--|--|-|-|-|%||%----||-|||%--|---%----%---|--||-|||--|-|-||||---|--|%---%|---|
||||||||XXX|||||||XXXXXXXXX|XX||X|X|-|XXX|X-|---||XXX|||||XX||||-||XXXX|--|XX|X|X|X||X||XXXX||X||||--|XXX|XXXX|XXXXXX||X|||--|X|-||||XXX|XX||XXX||-XX|