------------------------------------------------------------------------------------------------------------------------------------------------------
------------------------------------------------------------------------------------------------------------------------------------------------------
------------------------------------------------------------------------------------------------------------------------------------------------------
------------------------------------------------------------------------------------------------------------------------------------------------------
-------------------------------------------D----------------------------------------------------------------------------------------------------------
------------------------------------------------------------------------------------------------------------------------------------------------------
------------------------------------------------------------------------------------------------------------------------------------------------------
------------------------------------------------------------------------------------------------------------------------------------------------------
--------------------%--S-------------------------------------------------------------------------------------------------------------------%----------
--------------------|----------------------D-----------%-----------------------------------------------------------------------------------|----------
--------------------|--------------------------%-------|--------------------------%-------------------------------------------------------C|----------
--------------------|--%-----------------%-----|---%---|-----------%-----G--------|-------------------------------------------------%------|----------
--------%%-%----%---|--|-%---------%-----|-----|-%%|-%-|-----------|%---%%--------|-----%%-%------%%----------------%%%%%--------%--|---%--|----------
--------||-|-%--|---|-%|-|%------%-|%----|-----|-|||-|-|-----------||---||-------%|-----||-|----%-||%%---%--%%-%----|||||-%-----%|--|---|--|--------%%
%%%%%%%%||-|%|--|%%%|-||%||-%----|-||----|-----|-|||-|-|----%%%----||---||-------||-%---||-|----|-||||-%-|--||X|-%%-|||||-|----%||--|-%-|-%|---%----||
||||||||||X|||--|||||X|||||X|XXXX|X|XXXXX|XXXXX|X|||-|-|XXXX|||XXXX||XXX||XXXXXX-||X|X-XXXX|X-XX|X||||X|-|--||X|-||-|||||-|XXXX|||-XX-|X|-||X--|XXX-||