------------------------------------------------------------------------------------------------------------------------------------------------------
------------------------------------------------------------------------------------------------------------------------------------------------------
------------------------------------------------------------------------------------------------------------------------------------------------------
------------------------------------------------------------------------------------------------------------------------------------------------------
------------------------------------------------------------------------------------------------------------------------------------------------------
-----------------------------------------------------------------------------------------------------------------%------------------------------------
-----------------------------------------------------------------------------------------------------------------|------------------------------------
-----------------------------------------------------------------------------------------------------------------|-------------------------%----------
---------------------------------------------------------------------------------------------------------t-------|-------------------------|----------
----------------------------------------------------------------%--------------k-------------------------t-------|-------------------------|----------
--------------------------------------------------------%-------|--------------|-------------------------t-------|-------------------------|----------
----------------------------------------%---------------|-------|-------------%|-----%-------------------%-------|-------------------------|----------
--------%---------%U--%-----------------|-%%-%%---------|-------|---%---------||-----|---%---%-----%-----|-------|%----------------%-------|----------
--------|---------|---|%----------------|-||-||---------|-------|---|--%----%-|%-----|--U|---|-----|%---%|--%----||-----%-%----%---|-------%--%%%-%%%%
%%%%%%%%|-%-------|---||%---%--%--%%%---|%||-||-%----%--|-------|---|--|----|-||---%-|---|---|--%--||---||--|-%%%||-----|-|----|---|-------|--|||-||||
|||||||||-|XX-X--X|X-X|X|--X|XX|--|||XXXX|||X||X|-XXX|XX|XXXXXX-|XXX|X-|-XXX|X||XXX|X|XXX|X-X|XX|--||---|X--|X|||||XXXX-|-|XXXX|-XX|XXX-X-X|XX|||X||XX