------------------------------------------------------------------------------------------------------------------------------------------------------
------------------------------------------------------------------------------------------------------------------------------------------------------
------------------------------------------------------------------------------------------------------------------------------------------------------
------------------------------------------------------------------------------------------------------------------------------------------------------
------------------------------------------------------------------------------------------------------------------------------------------------------
----------------------------------------------------------------------------------------------------------------%-------------------------------------
----------------------------------------------------------------------------------------------------------------|-------------------------------------
----------------------------------------------------------------------------------------------------------------|-------------------------------------
------------------------%-----------------------------------------------------------------------------------%---|-%-----------------------------------
------------------------|-----------------------------------------------------------------------------------|---|-|-----------------------------------
------------------------|-----------------------------------------------%-----------------------------------|---|-|-----------------------------------
--------------------%---|---------------%-------------------------------|------%----------G-----------------|---|-|--------------C--------------------
----------------%--%|-%%|----------%%%%-|-%%-%-%---%--------------------|------|-----%----%---%-%-----------|---|-|-------%---------------------------
--------%%-%---%|-%||-|||--%%%%%-%-||||-|-||-|-|---|-------%------------|------%---%-|--%-|---|%|%%-------%-|---|-|---%--%|-------%----%%%----%-------
%%%%%%%%||%|---||%|||%|||--|||||-|-||||-|-||-|%|%--|------%|------%----%|------|%--|-|--|-|---|||||---%---|-|%--|-|---|-%||-------|----|||----|-------
||||||||||||XXX||||||||||-X|||||X|-||||X|X||X||||-X|-XXXXX||XXXX--|X---||------X|-X|X|XX|X|XX-|||||XXX|X--|X||X-|X|XXX|X|||XX-XXXX|XXXX|||X--X|XXX--XX