------------------------------------------------------------------------------------------------------------------------------------------------------
------------------------------------------------------------------------------------------------------------------------------------------------------
------------------------------------------------------------------------------------------------------------------------------------------------------
------------------------------------------------------------------------------------------------------------------------------------------------------
------------------------------------------------------------------------------------------------------------------------------------------------------
------------------------------------------------------------------------------------------------------------------------------------------------------
------------------------------------------------------------------------------------------------------------------------------------------------------
-----------------------------------------------%--------------------------%---------------------------------------------------------------------------
-----------------------------------------------|--------------------------|---------------------------------------------------------------------------
-----------------------------------------------|--------------------------|---------------------------------------------------------------------------
-----------------------------------------------|--------------------------|-------------------------%%------------------------------------------------
-----------------------------------------------|--%-----------------------|-------------------------||-----%------------------------------------------
------------------------------%----------------|--|---%%-------%--%-%-%---|--%%%%---------------%--%||%----|------%%%--%---%--%--%%------%------------
------------------------------|-----%----------|--|---||%------|--|-|-|---%--||||---------------|-%||||----|-%----|||-%|-%%|%-|%-||%%-%--|---%---%--%-
%%%%%%%%%%%--%---%%-------%%-%|---%%|----------|--|---|||-----%|--|-|-|---|--||||%%%-----%-----%|-|||||----|-|-%--|||-||-||||-||-||||-|--|--%|-%-|--|-
|||||||||||XX|-X-||XXXXXXX||X||X--|||----XX-XX-|--|--X|||-XXX-||XX|X|X|XXX|XX|||||||XXXXX|XXXXX||X|||||XX-X|X|-|XX|||X||X||||X||-||||X|XX|XX||-|X|XX|X