------------------------------------------------------------------------------------------------------------------------------------------------------
------------------------------------------------------------------------------------------------------------------------------------------------------
------------------------------------------------------------------------------------------------------------------------------------------------------
------------------------------------------------------------------------------------------------------------------------------------------------------
------------------------%-----------------------------------------------------------------------------------------------------------------------------
------------------------|-----------------------------------------------------------------------------------------------------------------------------
------------------------|--------------------------------------------------------------------------------------------%--------------------------------
------------------------|--------------------------------------------------------------------------------------------|-------------------%------------
------------------------|--------------------------------------------------------------------------------------------|-------------------|------------
------------------------D--------------------------------------------------------------------------------------------|-------------------|------------
----------------------------------------------------------------------------------------------------------------%----|-------------------|------------
-----------------------T-----------------------------------------------%------S----------%----%-----%-----%-----|----|-------------------|------------
---------------------%%t-----------%-----%--%--------------------------|-----------------|%--%|---%-|%%---|-----|----|----%--------------|------------
--------%----%----%--||t----%------|-----|--|---------%----------%--%--|----------%%-----||--||---|-|||---|----%|%---|----|--------------%-%--%--%----
%%%%%%%%|--%%|----|--||%----|---%--|---%-|--|%--------|--%-------|%-|--|---------%||%--%-||--|%-%%|-|||---|----|||---|-%%-|%%%%--------%%|%|%-|--|%--%
|||||||||XX|||XXX-XXXXX|XXX-|XXX|XX|X-X|X|XX||XX--X-XX|XX|XXXXX--||X|XXXX--X-XXXX||||XX|XX|XX||-|||-X||XXX|XXXX|||XXX|-||X|||||XXXXX--X||||||-XXX||XX|