------------------------------------------------------------------------------------------------------------------------------------------------------
------------------------------------------------------------------------------------------------------------------------------------------------------
------------------------------------------------------------------------------------------------------------------------------------------------------
------------------------------------------------------------------------------------------------------------------------------------------------------
------------------------------------------------------------------------------------------------------------------------------------------------------
------------------------------------------------------------------------------------------------------------------------------------------------------
------------------------------------------------------------------------------------------------------------------------------------------------------
------------------------------------------------------------------------------------------------------------------------------------------------------
------------------------------------------------------------------------------------------------------------------------------------------------------
------------------------g-----------------------------------------------------------------------------------------------------------------------%-----
------------------------|--%t---------------------------------------------------------------------------------%----------%----------------------|-----
------------------------|--|t-------%-----%----------------%---------#----------------------------------------|----------|%---------------------|-----
------------------------|--|t-------|-----|%---------------|---------%-%--------------%----------------------%|%-------%-||----------%-----%----|-----
----------------%------%%-%|%-------%-----||-----------%---|---------|-|---G%---------|--------------%---%%--|||%%-----|-||----------|-----|----|-----
%%%%%%%%%%%----%|--%---||-|||-----%-|-----||-----------|---|----%----|-|---%|-----%---|%-------------|---||--|||||-%---|-||----------|-----|----|-----
|||||||||||-X-X||XX|-XX||X|||XX---|XXXX---|XX-XXXXX--XX|XXX|XXXX|XX-X|X|XXX||---X-|XX-||XXXXXXX-X-XXX|---||XX|||||X|X-XXX|XX-XXXXXXXX|XXXXX|-XXXXX-XXX