------------------------------------------------------------------------------------------------------------------------------------------------------
------------------------------------------------------------------------------------------------------------------------------------------------------
------------------------------------------------------------------------------------------------------------------------------------------------------
------------------------------------------------------------------------------------------------------------------------------------------------------
------------------------------------------------------------------------------------------------------------------------------------------------------
------------------------------------------------------------------------------------------------------------------------------------------------------
------------------------------------------------------------------------------------------------------------------------------------------------------
------------------------------------------------------------------------------------------------------------------------------------------------------
----------------------------------------------------------------------------------------------------------------------------------------------D-------
------------------------------------------------------------------------------------------------------------------------------------------------------
----------------------%--------------------------------%-------------------------------------------------------------------------------S--------------
----------------------|--------------------------------|----------------------------------------------------------2-----------------------------------
--------------%------%|---%-------%-%---------%%--%%---|-------%%%--------------%----%%%-----------%--%-%---%----%--------------------------%-----%---
--------%---%%|------||---|-------|-|---%-----||--||---|--%----|||--------------|----|||-----------|%-|%|---|----|-%----------%-%-----------|-----|---
%%%%%%%%|-%%|||%-%%--||%--|-------|-|---|-%-%-||--||---|-%|-%%-|||-----%--------|-%%%|||%------%---||-|||--%|---%|-|%-----%---|%|-----%%%---|-%---|-%%
|||||||||X||||X|-||XX|||XX|XXXX---|X|XXX|X|X|X||XX|XXXX|X||X||-|||XXXXX|XX-XXXXX|X|||||||----XX|X--||-|X|-X||-XX||X||XXXXX|XXX|||--XXX|||XXX|X|XX-|X||