------------------------------------------------------------------------------------------------------------------------------------------------------
------------------------------------------------------------------------------------------------------------------------------------------------------
------------------------------------------------------------------------------------------------------------------------------------------------------
------------------------------------------------------------------------------------------------------------------------------------------------------
------------------------------------------------------------------------------------------------------------------------------------------------------
------------------------------------------------------------------------------------------------------------------------------------------------------
------------------------------------------------------------------------------------------------------------------------------------------------------
------------------------------------------------------------------------------------------------------------------------------D-----------------------
--------------S------------------------------------------------------------------------------%------------------------%-------------------------------
---------------------------------------------------------------------------------------------|------------------------|-------------------------------
------------%--------------------------------------------------------------------------------|------------------------|-------%-----------------------
------------|-----%-----------------------------------------g-t-----------------------g------|----------------%-------|-------|-----------------------
------------|-%---|-%------------%-----------%----------%-----t-----%-------------%--%--%----|%---%----------%|---%%--|-------|----%---%%--%----------
------------|-|---|-|--%%--------|---%%-----%|----------|-----%-----|-------------|--|-%|---%%|-%-|%------%--||---||--|-------|----|---||--|----%%----
%%%%%%%%----|-|---|-|--||%-------|---||-%---||------%--%|-----|-----|-------------|--|-||---|||-|%||------|--||---||--|--%----|%---|---||%-|----||----
||||||||XX-X|-|--X|-XX-|||-XXXXXX|XXX|X-|XXX||X-XX--|XX||XXXXX|-XXX-|--XXXXX-XXXXX|-X|X||-XX|||-||||XXXXX-XXX||XX-||XX|XX|XXXX||XXX|-XX|||-|XXXX||-XX-