------------------------------------------------------------------------------------------------------------------------------------------------------
------------------------------------------------------------------------------------------------------------------------------------------------------
------------------------------------------------------------------------------------------------------------------------------------------------------
------------------------------------------------------------------------------------------------------------------------------------------------------
------------------------------------------------------------------------------------------------------------------------------------------------------
------------------------------------------------------------------------------------------------------------------------------------------------------
-----------------------------------------------------------------------%----------S-------------------------------------------------------------------
-----------%-----------------------------------------------------------|-------------------------------------------------------------%----------------
-----------|----------------D------------------------------------------|-------------------------------------------------------------|----------------
-----------|-----------------------------------------------------------|-----%----%--------------------------------------------------|----------------
-----------|------------------------------------------%%---------------|-----|----|--------------------------------------------------|----------------
-----------|------------------------------------------||-----%---------|-----|----|------------------%-------------------------------|----------------
-----------|---%--%----------%------%-%-------%-------||-----|---------|-----|----|-----%---%%--%---%|-----%%%------------%--------%-|--%--%----------
-----------|---|--|--------%-|-----%|-|%---%-%|--%----||----g|---------|%%--%|----|--%--|---||--|---||-----|||------%--%--|----%--%|%|%-|%-|----------
%%%%%%%%%-%|---|--|--------|%|---%%||-||---|-||--|%-%-||-%---|%%%---%--|||-%||-%--|%%|--|---||--|---||%%%%%|||------|--|--|----|--|||||-||-|%-%--%----
|||||||||X||XX-|--|-XXXXXXX|||XXX||||-||XXX|XX|XX||X|X||-|XXXX|||---|XX|||X|X|-|--||||--|XXX||-X|XXX|||||||X||X-X-XX|--|X-|-XXX|XX|||||X||X||X|X-|XXX-