------------------------------------------------------------------------------------------------------------------------------------------------------
------------------------------------------------------------------------------------------------------------------------------------------------------
------------------------------------------------------------------------------------------------------------------------------------------------------
------------------------------------------------------------------------------------------------------------------------------------------------------
------------------------------------------------------------------------------------------------------------------------------------------------------
------------------------------------------------------------------------------------------------------------------------------------------------------
------------------------------------------------------------------------------------------------------------------------------------------------------
------------------------------------------------------------------------------------------------------------------------------------------------------
------------------------------------------------------------------------------------------------------------------------------------------------------
------------------------------------------------------------------------------------------------------------------------------------------------------
---------%----------------------------------------------------%---------------------------------------------------------------------------------------
---------|----------------------------------------------------|------%%--------------------%#--------%-------%------C-------%%------------------------
--------%|-----------------------%---%---%--------------------|------||----------------S--%|%--------|-------|%--%----------||----------------%-------
--------||--------%-------%%%-%--|%%%|---|%-%------%-----F----|-----t||%--------------%---|||------%-|---%---||--|----------||---%------%%%-%-|---%-%-
%%%%%%%%||---%%-%-|-------|||-|--|||||---||-|------|-%--%%----|-----t|||%%%%%------%--|---|||-%%---|-|%%-|---||--|-%%-%%---%||---|------|||-|%|%%-|%|-
||||||||||---||X|-|XXXX---|||X|--X||||XXX||X|XXXXXXXX|XX||XXXX|XXXXXXXX||||||XXX-X-|XX|XXX|X|-||X--XXX||-|X--||XX|-||X||XXX|X|X-X|XXXXXX|||X|||||-|||X