------------------------------------------------------------------------------------------------------------------------------------------------------
------------------------------------------------------------------------------------------------------------------------------------------------------
------------------------------------------------------------------------------------------------------------------------------------------------------
------------------------------------------------------------------------------------------------------------------------------------------------------
------------------------------------------------------------------------------------------------------------------------------------------------------
------------------------------------------------------------------------------------------------------------------------------------------------------
------------------------------------------------------------------------------------------------------------------------------------------------------
-------------------------------------------------------------------------------------------D----------------------------------------------------------
--------------------------------------------------------------------------------------------------------------------------------%---------------------
--------------------------------------------------------------------------------------------------------------------------------|---------------------
--------------------------------------------------------------------------------------------------------------------------------|---------------------
-------------------------------------------------------------------------------------------%------------------------------------|-----------------S---
-------------%------%----%-------%%-------%------%%---%-------------------------------%S---|--%-------------%%--------%--%%-----|---------%-----------
------------%|-%----|----|---%---||-------|------||---|%-%-------------%-%------------|---%|--|-------------||-----%--|--||----%|-%---%-%-|%--------%-
%%%%%%%%----||%|----|----|-%%|---||---%%%-|------||--%||-|%---%--------|%|%%-------%--|---||--|-%-%%%-%-%-%%||-----|--|--||----||%|---|-|%||--------|-
||||||||XXXX||||XXXX|--X-|X|||-XX||XXX|||X|-XXXX-||--|||X||XXX|XXX-----X||||X--XXXX|XX|XXX||--|X|-|||X|-|X|||X--XXX|-XX-X||X-XX||||XXX|X||||--XXXXXX|X