------------------------------------------------------------------------------------------------------------------------------------------------------
------------------------------------------------------------------------------------------------------------------------------------------------------
------------------------------------------------------------------------------------------------------------------------------------------------------
------------------------------------------------------------------------------------------------------------------------------------------------------
------------------------------------------------------------------------------------------------------------------------------------------------------
-------------------------------%----------------------------------------------------------------------------------------------------------------------
-------------------------------|----------------------------------------------------------------------------------------------------------------------
-------------------------------|--------------------------------%-------------------------------------------------------------------------------------
-------------------------------|--------------------------------|-------------------------------------------------------------------------------------
-------------------------------|--------------------------------|-------------------------------------------------------------------------------------
------------------------%----%-|--------------------------------|-------------------------------------------------------------------------------------
-------------%----------|----|-|-------------------U---%--------|---------------------------------------%--------------------------%----------g-------
-------------%------%---|---%|-|-%%-%-----%-----%------|%-------|-----------%%------------%-------------|----------------%%--------|----------------%%
-------------|------|---|---||-|-||-|-----|-----|----%%||-------%-%-%--%%---||------------|-------------|---%%--%--------||-%------|----------------||
%%%%%%%%--%%-|-%%%--|%%-|---||-|%||-|---%-|%----|----||||-------|%|-|%-||---||-%%%----%---|-------------|--%||%-|-%------||-|----%-|---%%%---%-%-%--||
||||||||XX||-|X|||-X|||X|XXX||-||||X|XXX|X||XXXX|XXXX||X|XXXXXXX|||-||X||XXX||-|||XXXX|XXX|XXX-XXXXXXXXXXXX||||X|-|XXXX-X||X|XXX-|X|---|||XXX|-|X|XX||