------------------------------------------------------------------------------------------------------------------------------------------------------
------------------------------------------------------------------------------------------------------------------------------------------------------
------------------------------------------------------------------------------------------------------------------------------------------------------
------------------------------------------------------------------------------------------------------------------------------------------------------
------------------------------------------------------------------------------------------------------------------------------------------------------
------------------------------------------------------------------------------------------------------------------------------------------------------
------------------------------------------------------------------------------------------------------------------------------------------------------
---------------------------------------------------------------------------------------------------------------------------------%--------------------
-------------------------------------------------------------------------------------------------------------------%-------------|--------------------
-------------------------------------------------------------------------------------------------------------------|-------------|--------------------
-------------------------------------------------------------------------------------------------------------------|-------------|--------------------
-----------------------------------------------------%--g------------------------%---------------------------------|------%------|--------------------
----------------------%%----------------%------------|--S---------%%-----%-%--%%-|----------------%%%----%%--------|----%-|%-----|---%------------%---
----------------------||----------------|----%-%F%%%%|---------%%-||-----|-|--||-|---------------%|||----||-%------|----|-||-----%---|-%----------|---
%%%%%%%%----------%%%%||--%-------%-----|----|%|%|||||%----%---||-||-----|-|--||%|---%-----%%----||||---%||-|------|----|-||-----|---|-|%---------|%--
||||||||XX-XXXXXXX||||||X-|-XXXXX-|XXXXXXXX-X||||||X|||XX-X|XXX||X||X-X-X|X|XX||||XXX|X-XXX||XXXX||||XXX|||X|--XX-XXX--X|X||X----|XXX|X||--X------||--