------------------------------------------------------------------------------------------------------------------------------------------------------
------------------------------------------------------------------------------------------------------------------------------------------------------
------------------------------------------------------------------------------------------------------------------------------------------------------
------------------------------------------------------------------------------------------------------------------------------------------------------
------------------------------------------------------------------------------------------------------------------------------------------------------
------------------------------------------------------------------------------------------------------------------------------------------------------
------------------------------S------------------------------------------------------------------------------------------------------------g----------
----------------------------------------------------------------------------------------------------------------t--------------------------%----------
----------------------------------------------------------------------------------------------------------------t-----------%--------------|----------
-------------------------------------------------------------------------------------------------------------%--%-----------|--------------|--t-D-%---
------------------------------%------------------------------------------------------------------------------|--|-----------|--------------|-%t--%|%--
-------------------%----------|--------------------------%---------------------------------------------------|--|-----------|-----g---%--%-|%|t--|||--
----------%--------|----------|----------%--------------%|----%-----------%%------------------%--%-----%%----|--|---%%------|-%-------|--|-|||%%%|||--
----------|--------|----%%%%--|%%--%%----|--------------||-%%%|--%-%------||------------------|%-|-----||----|--|---||------|-|-------|-%|-|||||||||--
%%%%%%%%--|--%-----|----||||--|||--||----|-----%-%-%----||-||||--|-|------||---------%%-------||%|-----||--%-|%-|---||-%----|-|-------|-||-|||||||||-%
||||||||--|-X|XXXXX|XXXX||||X-|||XX||X---|XXXXX|X|X|X-XX||-||||-X|X|XXX--X||XX--XXXXX||XXXXXXXX|||X--X-||XX|-||X|X-X||-|-X-X|-|---XXXX|X||X|||X|||||X|