------------------------------------------------------------------------------------------------------------------------------------------------------
------------------------------------------------------------------------------------------------------------------------------------------------------
------------------------------------------------------------------------------------------------------------------------------------------------------
------------------------------------------------------------------------------------------------------------------------------------------------------
------------------------------------------------------------------------------------------------------------------------------------------------------
---------------------%--------------------------------------------------------------------------------------------------------------------------------
---------------------|--------------------------------------------------------------------------------------------------------------------------------
---------------------|--------------------------------------------------------------------------------------------------------------------------------
---------------------|--------------------------------------------------------------------------------------------------------------------------------
---------------------|--------------------------------------------------------------------------------------------------------------------------------
---------------------|----------------------------------------------------------------------------------------------%-----%---------------------------
---------------------|----------------------------------------------------------------------------------------------|-----|---------------------------
---------------------|%%%----%-%----%-----------------%------%%--------------------%-------------%----------------%%|-----|----%-%----%---------------
---------%%%---------||||--%-|-|----|-----------------|------||------%-------------|---------%---|%--%-----%------|||--%%%|--%-|%|%---|------------%-%
%%%%%%%%%|||%%%%%-%-%||||--|-|-|----|--%----%---------|------||%%-%--|---%--------%|%---%----|---||-%|%--%-|------|||--||||--|-||||%--|%--%--%%----|-|
||||||||||X||||||X|X|||||X-XXXX|X-X-|XX|-XXX|-XXXXX-XX|-X-XX-||||X|XX|XXX|XX-X-XXX|||XXX|XXX-|XXX||X|||-X|-|XXXXXX|||--||||XX|X|||||XX||XX|XX||XXXX|-|