------------------------------------------------------------------------------------------------------------------------------------------------------
------------------------------------------------------------------------------------------------------------------------------------------------------
------------------------------------------------------------------------------------------------------------------------------------------------------
------------------------------------------------------------------------------------------------------------------------------------------------------
--------------------------------------------------------------------------------t---------------------------------------------------------------------
---------------------------------------------%----------------------------------t---------------------------------------------------------------------
---------------------------------------------|----------------------------------%------------------------------------S--------------------------------
----------------%----------------------------|----------------------------------|---------------------------------------------------------------------
----------------|----------------------------|----------------------------------|---------------------------------------------------------------------
----------------|----------------------------|---%-------------------------%----|---------------------------------------------------------------------
----------------|----------------------------|---|------------%---------%%-|----|%----------------------------------%%---------------------------k----
---------%------|-----------S------%%--------|---|------------|---------||-|----||----------------------------------||---------------------------|----
--------%|------|%-------------%%--||------%-|---|------------|--------%||-|----||-----%%---------------------------||---------%%------%--%--%--%|---%
--------||%-----||---------%-%-||-%||-----%|-|---|------------|%%%%-%%-|||%|----%|-%-%-||-------------%%------------||---------||---%--|--|--|--||%%-|
%%%%%%%%|||-----||--------%|-|-||-|||%-%--||-|-%-|------------|||||-||%|||||---%||-|%|%||-------------||----%------%||---------||---|--|--|--|--|%||-|
|||||||||||X--XX||XXXXXX-X|XX|-||X|XX|X|-X||-|X|X|XXXXXXXXXXXX|||||X||||||||---|||-||||||XXXXXXXXXXXXX|XXXXX|-XXXXX|||XXXXXXXX-||---|-X|XX|XX|X-||||-|