------------------------------------------------------------------------------------------------------------------------------------------------------
------------------------------------------------------------------------------------------------------------------------------------------------------
------------------------------------------------------------------------------------------------------------------------------------------------------
------------------------------------------------------------------------------------------------------------------------------------------------------
------------------------------------------------------------------------------------------------------------------------------------------------------
------------------------------------------------------------------------------------------------------------------------------------------------------
-------------------------------------------------------------------------------------------C----------------------------------------------------------
------------------------------------------------------------------------------------------------------------------------------------------------------
-------------------------------------------------------------U----------------------------------------------------------------------------------------
-----------------------------------------------------------------------------------%-----------------------%-------------------%----------------------
-----------------------------------------------------------------------------------|---%--%%------%--------|-------------------|--%-------------------
-----------------------------------------------------------------------------------|---|--||------|--------|----------%-%------|--|-------------------
------------------------%%---%----%-------%%-----%-----------%---------------%-----|-%-|--||------|-%-%----|----------|-|------|--|-%-------------%---
---------------%%------%||--%|----|-------||-----|-----------|---------------|-----|-|-|--||--%---|%|-|----|----------|-|----%-|--|-|%%%-%--------|%%-
%%%%%%%%-------||------|||%-||---%|-----%-||--%-%|%----------|-%-------------|-----|-|-|--||%-|--%|||-|%---|--------%-|-|---%|%|--|-||||%|--------|||-
||||||||XXXX---||XX-XXX||||X||XX-||X-XXX|X||X-|X|||XXXXX--X-X|X|-X-XXX-X---XX|-XX-X|X|X|XX|||X|-X||||X||X-X|XXXXXXXX|XXX|XXX||||XX|X||||||XXXXXXXX||XX