------------------------------------------------------------------------------------------------------------------------------------------------------
------------------------------------------------------------------------------------------------------------------------------------------------------
------------------------------------------------------------------------------------------------------------------------------------------------------
------------------------------------------------------------------------------------------------------------------------------------------------------
------------------------------------------------------------------------------------------------------------------------------------------------------
------------------------------------------------------------------------------------------------------------------------------------------------------
---------------------------------------------------------------------------------------%--------------------------------------------------------------
---------------------------------------------------------------------------------------|--------------------------------------------------------------
-----------------------------------------------------------------%---------------------|--------------------------------------------------------------
-----------------------------------------------------------------|---------------------|-------------------------------------------------------%------
-------------------------------%---------------------------------|---------------------|-------------------%----------------g------------------|------
-------------------------------|---------------------------------|---------------------|-------------------|-------------%---------------------|------
-----------%-----%--------%-%--|--------%-------%------------%---|----------%----------|---------%---------|-------------|---%-----------------|------
----------%|-----|%-------|%|--|--------|--%----|%------%----|%--%----------|----------|---------|----%----|-----%-------%---|-----%-----------|%-----
%%%%%%%%--||-----||--%--%-|||-%|---%--%-|--|%---||------|----||--|-%%%---%%%|-------%%%|%-%--%---|%-%-|----|----%|-------|--%|%----|-----------||-%--%
||||||||X-||X-X-XX|XX|XX|X|||X||XXX|XX|X|-X||XXX||-X---X|--X-||XX|X|||--X||||XXXXXXX|||||X|XX|-XX||X|X|XXXX|XXX-||XXXX---XXX|||X-X-|-XXX-XXXX--||-|X-|