------------------------------------------------------------------------------------------------------------------------------------------------------
------------------------------------------------------------------------------------------------------------------------------------------------------
------------------------------------------------------------------------------------------------------------------------------------------------------
------------------------------------------------------------------------------------------------------------------------------------------------------
------------------------------------------------------------------------------------------------------------------------------------------------------
---------------------------------------------------------------------------------------------------------------------------------------------------%--
---------------------------------------------------------------------------------------------------------------------------------------------------|--
---------------------------------------------------------------------------------------------%-----------------------------------------------------|--
----------------------------------------------------C----------------------------------------|-------------------------S---------------------------|--
------------------------------------------C--------------------------------------------------|-----%-----------------------------------------------|--
---------------------------------------------------------------------------------------------|-----|---------------------%-------------------------|--
--------%-------%-----------------------------------r--------------------%----------------%--|-----|---------------------|-------------------------|--
--------|--%----|------------------------------%---%%----%---%-----------|--------%-------|--|---%-|------%------------%-|----%--------------------|--
--------|--|----|--%-----------%---------------|---||---%|---|------%---%|-%---%--|-------|-%|-%%|-|------|------%-----|-|--%%|-----------%----%---|%-
%%%%%%%%|--|--%%%--|----%-----%|-------%-------|---||-%%||-%-|------|---||-|---|--|-----%%|%||-|||-|--%---|------|----%|-|--|||--%--%-----|----|---||-
|||||||||XX|XX|||XX|X-XX|XX-XX||XXXXXXX|X-XXX--|---||X||||X|-|X-XXXX|XXX||X|-X-|--|XXX--||||||X|||X|XX|-XX|XXXXX-|XXXX||X|XX|||XX|XX|XXXXX|XXXX|XXX||X