------------------------------------------------------------------------------------------------------------------------------------------------------
------------------------------------------------------------------------------------------------------------------------------------------------------
------------------------------------------------------------------------------------------------------------------------------------------------------
------------------------------------------------------------------------------------------------------------------------------------------------------
------------------------------------------------------------------------------------------------------------------------------------------------------
-------------------------------------------------------------%----------------------------------------------------------------------------------------
-------------------------------------------------------------|-------------------------%--------------------------------------------------------------
-------------------------------------------------------%-----|-------------------------|--------------------------------------------------------------
-------------------------------------------------------|-----|------%------------------|--------------------------------------------------------------
-------------------------------------------------------|-----|------|------------------|--------------------------------%-----------------------------
---------------------t---------------------------------|-----|------|%-----------------|--------------------------------|-----------------------------
---------------------t---------------------------------|-----|---%--||%----------------|--------------------------------|----------------------------%
---------------------t------%----%--%%---%-------------|%%---|---|--|||------------%---|--------%%-------%%--%-%------%%|----%----%%-%%%------%------|
----------------%----%%-----|----|--||---|------%------%||---|%%%|--|||------------|-%-|---%%-%%||-------||--|-|%-----|||----|----||-|||---%--|------|
%%%%%%%%-%-----%|%---||-%%%-|%---|--||%-%|----%-|------|||---|||||--|||------------|-|-|---||-||||-------||--|-||-----|||----|-%--||-|||---|-%|------|
||||||||X|XXX-X|||XXX||X|||-||XXX|--|||X||-XX-|X|-XX-XX|||XXX|||||--||XXXXXXXXXXXXX|-|X|X-X||X||||XXXXXXX||XX|X||XXXX-|||XX-X|-|-X||X|||XXX|X||--XXXXX