------------------------------------------------------------------------------------------------------------------------------------------------------
------------------------------------------------------------------------------------------------------------------------------------------------------
------------------------------------------------------------------------------------------------------------------------------------------------------
------------------------------------------------------------------------------------------------------------------------------------------------------
------------------------------------------------------------------------------------------------------------------------------------------------------
-------------------------------------%-------------------------S--------------------------------------------------------------------------------------
-------------------------------------|----------------------------------------------------------------------------------------------------------------
-------------------------------------|------------------------------------------------------------------------------------------%---------------------
-------------------------------------|------------------------------------------------------------------------------------------|---------------------
-------------------------------------|------------------------------------------------------------------------------------------|---------------------
------------------------%------------|------------------------%-----------------------------------------------------%--g---%----|------------------t--
------------------------|------------%------------------------|%------%-D-------------------------------------------|-%--%-|----|------------------t--
--------------%--------%|---------%--|------------------------||------|------%----------%--%----%--------------%--%-|-|--|%|----|------------%--%-%%--
--------------|-----%%%||-%%-----%|--|------------------------||------|%----%|-------%--|--|----|--------------|--|-|-|-%|||----|----%-------|--|-||--
%%%%%%%%------|-----|||||-||-----||%-|---%----------------%-%-||--%%%%||----||---%---|--|--|--%%|----------%-%%|--|-|-|-||||--%%|-%--|-%%%---|--|-||--
||||||||XXXXXX|XXXXX|||||X||X--XX|||X|XX-|XXXX--XXX---X-X-|-|X||XX||||||XXXX||---|XXX|XX|--|XX||XXXXXXXXXXX|X|||-X|X|XX-|XX|XX|||-|--|X|||X--|XX|X||-X