------------------------------------------------------------------------------------------------------------------------------------------------------
------------------------------------------------------------------------------------------------------------------------------------------------------
------------------------------------------------------------------------------------------------------------------------------------------------------
------------------------------------------------------------------------------------------------------------------------------------------------------
------------------------------------------------------------------------------------------------------------------------------------------------------
------------------------------------------------------------------------------------------------------------------------------------------------------
------------------------------------------------------------------------------------------------------------------------------------------------------
-----------------------------D------------------------------------------------------------------------------------------------------------------------
------------------------------------------------------------------------------------------------------------------------------------------------------
--------------------------------------------------------------------------------------%-------%%------------------------------------------------------
---------------------------------%----------------------------------------------------|-------||------------------------------------------------------
---------------------%-----------|------------------------------------S---------------|-----%%||---------------------------------------%--------------
--------------%%%----|--%-%%-----|---------------------%%%----------------------------|---%-||||-------------%-------------------------|----------%---
--------------|||%%--|--|-||-%---|-%---%---------%-----|||----%-----%------%%------%--|--%|-||||------------%|%--------%-%%------------|-%--------|---
%%%%%%%%%%---%|||||--|--|-||-|---|-|%--|%--------|--%--|||----|-----|%-----||-%%---|-%|--||%||||-%----%---%%|||--------|%||-%---%---%%-|%|----%---|---
||||||||||XXX||XX||-X|XX|X||X|XX-|X||XX||XXXX---X|--|XX|||XXXX|---XX||X-XXX||X||--X|X||XXX||||||X|X-XX|XXX|||||-XXXXX-X||||-|XX-|-XX||XX||XXXX|--X|XXX