------------------------------------------------------------------------------------------------------------------------------------------------------
------------------------------------------------------------------------------------------------------------------------------------------------------
------------------------------------------------------------------------------------------------------------------------------------------------------
------------------------------------------------------------------------------------------------------------------------------------------------------
-------------------------------------------------------------------------------------------------------------------------------------%----------------
-------------------------------------------------------------------------------------------------------------------------------------|----------------
-------------------------------------------------------------------------------------------------------------------------------------|----------------
---------------------------------------------------------------------------------------------------------------------------%---------|----------------
----------S---------------------------------------------------------------------------------%--------%---------------------|---------|----------------
--------------------------------------------------------------------------------------------|--------|--------------%------|---------|----------------
--------------------------------------------------------------------------------g-----%%%--%|------%-|--------------|------|---------|----------------
-----------S-------%-----------------------------------------------------------%------|||--||------|-|--------------|-----S|g--------|----------------
---------%%----%%%-|--------------%--%--%--%------------------%---%------------|------|||-%||---%%-|-|--------------|------|-------%-|----------------
---------||----|||%|--------------|%%|--|--|------------%----%|---|------------|-----%|||-|||---||-|-|--------------|--%---%-------|-|%%-%-%-------%%%
%%%%%%%%%||%---|||||-----%--------||||%-|--|%------%%---|-%%%||%%-|%----------%%%----||||-|||%--||-|-|%--%%%%----%--|--|---|-------|%|||-|-|-------|||
||||||||||||X-X||||XXXX-X|X-XXX-XXX||||X|--||XX-XXX||XXX|X|||||||-||XXXXXXXXXX|||XXXX||||-||||--||-|X||XX||||X-XX|--|-X|XXX|X--X-XX|||||X|-|-XX---X|||