------------------------------------------------------------------------------------------------------------------------------------------------------
------------------------------------------------------------------------------------------------------------------------------------------------------
------------------------------------------------------------------------------------------------------------------------------------------------------
------------------------------------------------------------------------------------------------------------------------------------------------------
------------------------------------------------------------------------------------------------------------------------------------------------------
------------------------------------------------------------------------------------------------------------------------------------------------------
------------------------------------------------------------------------------------------------------------------------------------------------------
-----------------------------------------------%------------------------------------------------------------------------------------------------------
-----------------------------------------------|------------------------------------------------------------------------------------------------------
-----------------------------------------------|------------------------------------------------------------------------------------------------------
---------------------------------S-------------|------------------------------------------------------------------------------------------------------
---------------%-----------------------%-------|--------%-------------------%--------------------%-------------%--------------------------------------
----------%----|--------%----------%---|--%----|------%-|--%%---------------|---------%----------|-%----------%|-%----%%%---------%------------------%
----------|----|--%-----|---%--%---|---|--|---%|------|-|--||-----------%---|%--------|---------%|-|%---------||-|%---|||-%-------|------------------|
%%%%%%%%%%|----|--|%%---|--%|--|-%-|---|%%|---||------|-|--||---------%-|---||--%%----|--------%||-||---%%---%||-||--%|||-|%----%-|-%-%-%-%-%--%-----|
|||||||||||X-XX|XXX||XXX|-X|XXX|X|X|XXX||||XXX||XXX---|X|XX||-XXXXX-X-|X|XXXX|X-||XXXX|X-XXXX-X||XX||XXX||XXX|||X||-X||||X||XXXX|X|X|-|X|X|X|XX|XXXXX|