------------------------------------------------------------------------------------------------------------------------------------------------------
------------------------------------------------------------------------------------------------------------------------------------------------------
------------------------------------------------------------------------------------------------------------------------------------------------------
------------------------------------------------------------------------------------------------------------------------------------------------------
------------------------------------------------------------------------------------------------------------------------------------------------------
---------------------------------------------------------------------------------------------S--------------------------------------------------------
-----------------------------------------------------------------------------------------------------------------------------------------------------%
-----------------------------------------------------------------------------------------------------------------------------------------------------|
-----------------------------------------------------------------------------------------------------------------------------------------------------|
--------------------------------------------------------------------------%--------------------------------------------------------------------------|
-----------------------------------------------------------------------%--|----------%-------------------------g----%--------------------------------|
---------------------%-------------------------------------------------|--|----------|-------%----------------------|--------------------------------|
---------------------%--------%-------------%------------%-------------|--|--%-------|------%|------------------%---|-------------------%------------%
---------------------|---%----|-------------|-----%---%--|---------%---|--|--|-------|------||--------%-----%%--|---|-------------------|-----%%-----|
%%%%%%%%-------------|%--|----|-%-%%%%----%-|-----|---|--|---------|---|--|--|%------|------||--------|-----||-%|%--|--%%%%-------%-%---|-----||-----|
||||||||XXXXXX-XXXXXXX|XX|XXX-XX|X||||X-XX|-|XXXXX|XXX|-X|XXXXXXXXX|XXX|XX|XX||-XXXXX|XXXXXXX|XXXX-XXX|X----||X|||-X|XX||||XXXX---|X|XXX|-XXXX||XXXXX|