------------------------------------------------------------------------------------------------------------------------------------------------------
------------------------------------------------------------------------------------------------------------------------------------------------------
------------------------------------------------------------------------------------------------------------------------------------------------------
------------------------------------------------------------------------------------------------------------------------------------------------------
------------------------------------------------------------------------------------------------------------------------------------------------------
------------------------------------------------------------------------------------------------------------------------------------------------------
------------------------------------------------------------------------------------------------------------------------------------------------------
------------------------------------------------------------------------------------------------------------------------------------------------------
------------------------------------------------------------------------------------------------------------------------------------------------------
----------------------------------------------S-------------------------------------------------------------------------------------------------------
--------------------------------------------------------S-----------------------------%----------------------------------t------------------%---------
--------------------------------------------------------------------------------------|--------------------------%-----%-t------------------|---------
---------%-------------%------------%---%----------%------------%%-----------------%%-|%%-%%-----%---------------|--%--|-t------------------|-%---%---
---------|-------%%----|--%%%----%--|---|%-%--%----|---%--------||-------%---------||-|||%||-%---|-------------%-|--|--|-%%-----%%-%%-%-----|-|---|---
%%%%%%%%-|%------||----|--|||----|--|-%-||-|--|----|%--|%%%-----||%%-----|-----%---||-||||||%|---|-------%----%|-|--|--|-||-----||-||-|---%-|-|--%|%%-
||||||||X||XXXXXX||XX--|XX|||XX--|XX|-|X||X|-X|XXXX||X-||||XXXXX||||XXX-X|-XXXX|--X||X||||||||XXX|XXXXXX-|XXXX||XX-X|XX|-||XXXXX||-||X|XXX|X|X|XX||||-