------------------------------------------------------------------------------------------------------------------------------------------------------
------------------------------------------------------------------------------------------------------------------------------------------------------
------------------------------------------------------------------------------------------------------------------------------------------------------
------------------------------------------------------------------------------------------------------------------------------------------------------
------------------------------------------------------------------------------------------------------------------------------------------------------
------------------------------------------------------------------------------------------------------------------------------------------------------
--------------------%---------------------------------------------------------------------------------------------------------------------------------
--------------------|---------------------------------------------------------------------------------------------------------------------------------
--------------------|------------------%--------------------------------------------------------------------------------------------------------------
--------------------|------------------|-----------------------%---------------------------C--r-----------------------------------------%-------------
--------------------|----------------S-|-----------------------|----------#-------------------%------------------k----------------------|-------------
------------%-------|------------------|%----------------------|----------#-------------------|---------%-------------------------------|-------------
------------|--%-r-%|------------------||----------%----------%|%----%----%%%-----%-----------|-----%---|-------%--------------%------%-|-------------
---------%%%%-%|%%-||---%--%%----------||-------%--|----------|||----|----|||-----|-----------|--%%%|%--|%------|-----%--------|------|-|-------%-----
%%%%%%%%-||||-||||-||---|--||--------%-||%------|-%|-%----%---|||-%--|%-%-|||%-%%%|------%----|--|||||--||-%----|%----|--------|------|-|-------|-----
||||||||X||||X||||X||XXX|--||X-X---XX|X|||XXX-XX|X||X|XXXX|XXX|||-|XX||-|-||||X||||XXXXXX|XXXX|XX|||||--||X|XXXX||XXX-|XXXXX-X-|XXX-XX|X|XXXXXXX|-XXXX