------------------------------------------------------------------------------------------------------------------------------------------------------
------------------------------------------------------------------------------------------------------------------------------------------------------
------------------------------------------------------------------------------------------------------------------------------------------------------
------------------------------------------------------------------------------------------------------------------------------------------------------
------------------------------------------------------------------------------------------------------------------------------------------------------
------------------------------------------------------------------------------------------------------------------------------------------------------
--------------------------------------%---------------------------------------------------------------------------------------------------------------
--------------------------------------|---------------------------------------------------------------------------------------------------------------
-------------------------%------------|---------------------------------------------------------------------------------------------------------------
-------------------------|------------|---------------------------------------------------------------------------------------------------------------
------------C------------|------------|---------------------------------------------------------------------------------------------------------------
---------%g--------------|------------|---------------------------------%-------------------------------------------%---------------------------------
---------|---------------|-----%-%----|---------%--------%%-%-----------|--------------------%-%-%--------%%--------|--%-%---------%------------------
---------|------------%%%|---%%|%|-%--|-------%-|--%----%||-|-----------|--%-----------------|-|-|--------||--------|--|-|---------|---%--------------
%%%%%%%%%|-%%---%-----||||---|||||-|--|%%-----|-|--|----|||-|%%-%%%----%|%-|%%--------%------|-|-|%-%%----||--------|--|-|--%-----%|%--|------%%------
||||||||||X||XXX|XXXXX||||XXX|||||X|XX|||XXXXX|X|XX|XXXX|||X|||X|||-XX-|||X|||XXXXXXXX|X-XXXX|X|X||X||X-XX|X-XXXXX-X|XX|X|X-|-XXXX|||-X|XXXXXX||X--XXX