------------------------------------------------------------------------------------------------------------------------------------------------------
------------------------------------------------------------------------------------------------------------------------------------------------------
------------------------------------------------------------------------------------------------------------------------------------------------------
------------------------------------------------------------------------------------------------------------------------------------------------------
-------------------------------------------------------------------------------D----------------------------------------------------------------------
------------------------------------------------------------------------------------------------------------------------------------------------------
-----------------------------------------------------------------------------------D------------------------------------------------------------------
------------------------------------------------------------------------------------------------------------------------------------------------------
------------------------------------------------%---------------------------------------------------------------------------S-------------------------
------------------------------------------------|------------------------------------------------------------------------------------%----------------
--------------------------%-----%---------------|------------------t-----------%-----------D-----------------------------------------|----------------
--------------------------|-----|-------------%-|------------------t-----------|---%-------------------------------------------------|----------------
--------------%-----------|----%|----%--------|-|--------%%---%----%-----------|%--|%%-----------------------------%------%-%--------|----------------
--------------|-----%%%---|----||----|--------|-|------%-||---|-%--|----%------||-%|||-----%----------%%%--%---%--%|----%%|-|--%%%---|----------------
%%%%%%%%%-%%-%|-----|||---|%---||----|---%--%%|-|%%%%%-|-||---|-|--|----|------||-||||-----|--%%%-%---|||--|-%%|--||----|||-|--|||---|--------%-------
|||||||||X||X||XX-XX|||X--||XXX||X-XX|X-X|XX|||-||||||X|X||XXX|X|XX|XXXX|XXX---||-||||XXXX-|X-|||X|XX-|||-X|-|||XX||-XXX|||-|XX|||XXX|XXXXXXXX|X-XXX-X