------------------------------------------------------------------------------------------------------------------------------------------------------
------------------------------------------------------------------------------------------------------------------------------------------------------
------------------------------------------------------------------------------------------------------------------------------------------------------
------------------------------------------------------------------------------------------------------------------------------------------------------
------------------------------------------------------------------------------------------------------------------------------------------------------
------------------------------------------------------------------------------------------------------------------------------------------------------
----------------------------------------------D-------------------------------------------------------------------------------------------------------
---------------------------------------------------------------------------------------------------------------------------------------S--------------
---------------S-------------------------------%------------------------------------------------------------------------------------------------------
--------------------------------%--------------|----%-------------------------------------------------------------------------------------------------
--------------------------------|-------------t|----|%-%---------------------C---------------------------------------------------------%--------------
---------%----------------------|-------------t|----||-|-%------------%--#-----%-----%%------------------------------------------------|--------------
---------|-----%--------%-%%---%|-----%--%----%|--%%||-|%|------%-----|--#-----|-----||---%----------%--%---%-------------------%------|-------%------
---------|----%|--------|-||---||-%---|--|----||--||||-|||%--%--|-----|-%%-----|%%%--||---|%-----%---|--|---|-----%-------------|------|---%---|---%--
%%%%%%%%-|----||-%-----%|-||--%||%|%-%|--|-%--||--||||-||||%-|--|-----|-||---%-%|||--||%%-||---%%|---|%%|-%%|-----|--------%%%--|------|--%|---|%%%|--
||||||||XXXXXX||X|XXXX-||X||X-||||||X||--|X|X-||--||||X|||||X|XX|XXX--|X||-X-|-||||XX||||-||XXX|||XXX||||X|||XXXXX|-X--X--X|||XX|X-X-XX|XX||XXX|||||XX