------------------------------------------------------------------------------------------------------------------------------------------------------
------------------------------------------------------------------------------------------------------------------------------------------------------
------------------------------------------------------------------------------------------------------------------------------------------------------
------------------------------------------------------------------------------------------------------------------------------------------------------
------------------------------------------------------------------------------------------------------------------------------------------------------
-------------------------------------------------------------------------------------------------------------------------%----------------------------
-------------------------------------------------------------------------------------------------------------------------|----------------------------
-------------------------------------------------------------------------------------------------------------------------|----------------------------
-------------------------------------------------------------------------------------------------------------------------|----------------------------
----------------------%---------------------%----------------------------------------------------------------%-----------|----------------------------
---------------------%|---------------------|-------------------------------------------------%--------------|-----------|--------%-------------------
---------------------||---------------------|---------------------------------t---------------|--------------|--------%--|--------|-------------------
---------------%-----||-----%%-%%%%---------|---%------%-%%%%-----%--%-%------t%----%-%-------|%--%-%-----%--|--------|--|--------|---%%%----%-------%
---------------|%%---||-----||-||||---------|%--|----%-|-||||-----|%%|%|------t|----|-|---%---||--|-|-----|--|--------|--%%-------|%--|||-%--|-------|
%%%%%%%%-%-----|||---||----%||-||||---------||-%|----|-|-||||---%-||||||------%|----|-|---|---||%%|-|-----|--|%----%-%|--||-------||--|||%|%%|--%%---|
||||||||X|XXX--|X|XXX||XXXX|||X||||X-XXXXXXX||X||XXXX|-|X||||X-X|X||||||X-XXXX||XXXX|X|XX-|XXX|||||X|XX---|XX||XXXX|X|XXX||--XX-XX||XX||||X|||XX||XXX|