------------------------------------------------------------------------------------------------------------------------------------------------------
------------------------------------------------------------------------------------------------------------------------------------------------------
------------------------------------------------------------------------------------------------------------------------------------------------------
------------------------------------------------------------------------------------------------------------------------------------------------------
------------------------------------------------------------------------------------------------------------------------------------------------------
------------------------------------------------------------------------------------------------------------------------------------------------------
---------------S--------------------------------------------------------------------------------------------------------------------------------------
------------------------------------------------------------------------------------------------------------------------------------------------------
------------------%--------------------------------------------------------------------------------------------------------------------%--------------
------------------|--------------------------------------------------------------------------------------------------------------------|--------------
---------------%--|-----------------------------------------------------%--------------------------------------------------------------|--------------
--------------%|--|-------------------------%----------------%------%--%|--------------------------------------------------------------|--------------
--------------||--|----------------%---%----|---%%%----------|------|--||------------------%---------------%--------------%-----------%|-%%-----------
------------%%||--|-%%-------------|---|----|---|||----------|------|--||%%%-%--%--------%-|---------------|-----%-----%--|---%-------||-||-----------
%%%%%%%%-%--||||--|-||--%---%------|---|----|---|||----------|---%--|-%|||||%|--|-%%%----|-|%%%%------%-%--|-----|-----|--|---|----%-%||-%|-----------
||||||||X|-X||||XX|X||XX|-XX|XXXXXX|-XX|XXXX|X--|||XX-----XXXXXXX|-XXX||||||||--X-|||X--X|X|||||XXX-XX|X|X-|XXXXX|XX-XX|XX|XXX|XXX-|X|X|X||XXXXXXXXXXX