------------------------------------------------------------------------------------------------------------------------------------------------------
------------------------------------------------------------------------------------------------------------------------------------------------------
------------------------------------------------------------------------------------------------------------------------------------------------------
------------------------------------------------------------------------------------------------------------------------------------------------------
------------------------------------------------------------------------------------------------------------------------------------------------------
------------------------------------------------------------------------------------------------------------------------------------------------------
------------------------------------------------------------------------------------------------------------------------------------------------------
------------------------------------------------------------------------------------------------------------------------------------------------------
------------------------------------------------------------------------------------------------------------------------------------------------------
----------------------------------S--%------------------------------------------------------------%---------------------------------------------------
-------------------------------------|----------------------------------t-------------------------|--------------------------%------------------------
------------------------------------%|----------------------------------t%------------------%--%--|-%-----------------C------|%--S--------------------
---------%--------%%-----%%------%-%||%-%%----------%-------------------t|------%-----%-%---|--|--|%|-------%--%%-----------%||------%%---------%-%-%%
---------|--------||--%--||----%-|%||||-||----------|-%--%%---%---------%%-----%|-----|-|---|-%|%-|||-%-----|%-||-----------|||---%--||---------|-|-||
%%%%%%%%%|-%-%%%--||-%|--||%---|-||||||-||----------|-|--||---|------%--||-----||-%-%-|%|---|-|||-|||-|---%%||-||------%%%--|||%%-|--||------%--|-|%||
||||||||||X|-|||XX||X||-XX||X-X|X||||||X||XXX-XXX---|-|X-||XXX|XXX-XX|-X|X-XXXXX|X|-|X|||XXXX-|||-|||X|XX-||||X||XXXXXX|||-X|||||XXXX||X-XX--|-X|-||||