------------------------------------------------------------------------------------------------------------------------------------------------------
------------------------------------------------------------------------------------------------------------------------------------------------------
------------------------------------------------------------------------------------------------------------------------------------------------------
------------------------------------------------------------------------------------------------------------------------------------------------------
------------------------------------------------------------------------------------------------------------------------------------------------------
------------------------------------------------------------------------------------------------------------------------------------------------------
------------------------------------------------------------------------------------------------------------------------------------------------------
------------------------------------------------------------------------------------------------------------------------------------------------------
------------------------------------------------------------------------------------------------------------------------------------------------------
------------------------------------------------------------------------%-----------------------------------------------------------------------------
---------------------------------%--------------------------------------|-----------------------------------------------------------------------------
---------------------------------|------------------------%-------------|--%-------------%------------------------------------------------------------
--------------%--------%%--------|---%-------%--%-----%%--|---------%%--|-%|%------%--%-%|--%----%--%---%%%-------%----------%%%------%--------%----%-
--------------|-----%%%||--------|---|-------%--|-%%--||--|-%%%-----||--|-|||%-----|-%|-||--|----|--|---|||-----%-|----------|||%-----|--------|%---|-
%%%%%%%%------|%----|||||----%---|---|%%%%---|--|%||--||--|-|||----%||--|-||||-----|-||%||%%|-%--|--|---|||---%-|-|----------||||%---%|%-------||---|-
||||||||XXXXXX||X-XX||X||XX--|XX-|XX-|||||X-XX-X||||XX||XXXX|||--X-|||XX|-||||XXXX-|-||||||||X|--|XX|XXX|||XXX|X|X|XXXXX--XXX|||||X--|||XXXXXXX||XXXXX