------------------------------------------------------------------------------------------------------------------------------------------------------
------------------------------------------------------------------------------------------------------------------------------------------------------
------------------------------------------------------------------------------------------------------------------------------------------------------
------------------------------------------------------------------------------------------------------------------------------------------------------
------------------------------------------------------------------------------------------------------------------------------------------------------
------------------------------------------------------------------------------------------------------------------------------------------------------
------------------------------------------------------S-----------------------------------------------------------------------------------------------
------------------------------------------------------------------------------------------------------------------------------------------------------
----------------------------------------------------------------------U-------------------------------------------------------------------------------
--------------%--------------%------------------------------------------------------------------------------------%-----------------------------------
--------------|--------------|------------------------%----------------------------------------------------%%-----|-----------------------------------
--------------|--------------|------------------------|----------------------------------------------------||----%|-----------------g-----------------
--------------|-----------%--|------------------------|----%-----#---%%---------U--------------------------||--%-||--------%%%------------------%--%%-
----------%---|-----------|-%|------%---------------%-|---%|--%--#---||----%--2---%--%-----%---%---%--%----||--|-||--------|||%----%---------%--|--||-
%%%%%%%%%%|---|-%--%%%%%%-|%||----%%|-%-------------|-|---||--|--%-%%||-%--|%-----|--|-----|---|---|--|----||--|%||--------||||%--%|-----%---|%-|--||-
||||||||||XXXX|-|X-||||||-||||----|||-|X-XXXXXXXXXXX|X|XXX||XX|X-|-||||-|XX||XXXX-|XXX-XXX-|XX-|XXX|XX|XXXX||X-||||XXXXXXXX|||||X-||X-XXX|---||X|--||-