------------------------------------------------------------------------------------------------------------------------------------------------------
------------------------------------------------------------------------------------------------------------------------------------------------------
------------------------------------------------------------------------------------------------------------------------------------------------------
------------------------------------------------------------------------------------------------------------------------------------------------------
--------------------------------------------------------------------------------------------------------------------------------------------------#---
--------------------------------------------------------------------------------------------------------------------------------------------------#---
---------------------------------------------------------------------------------------------------%----------------------------------------------#---
---------------------------------------------------------------------------------------------------|---------------------------------------------%#---
---------------------------------------------------------------------------------------------------|---------------------------------------------|%---
------------------------------------%--------------------------------------------------------------|---------------------------------------------||---
-------------------------%--S-------|--------------------------------------------------------------|---------------------------------------------||---
------------------g------|----------|-----------------------------%--------------------------------|-----------------------------%---------------||---
------------%------------|----------|---%---%%--%%----------------|----------%----------------%%---|%%-----%--------%-------%----|----%-----%----||---
------------|---%--%%----|-%---%%---|---|---||--||----------%-----|---%%-%---|----%----%------||---|||-----|--------|----%t-|--%%|----|-----|----||---
%%%%%%%%%---|%-%|--||----|%|%-%||---|%--|---||-%||----------|-----|-%-||-|---|--%%|----|------||---|||%----|%-----%-|----|t-|--|||----|-----%----%%---
|||||||||---||X||XX||X--X||||-|||XXX||XX|-XX||X|||XXXXXX-XXX|--XXXX-|X||X|XXX|X-|||XXXX|XXXXXX||XXX||||X-XX||XXX--|-|XXXX|X-|-X|||-XX-XXXXX-|X-XX||X-X