------------------------------------------------------------------------------------------------------------------------------------------------------
------------------------------------------------------------------------------------------------------------------------------------------------------
------------------------------------------------------------------------------------------------------------------------------------------------------
------------------------------------------------------------------------------------------------------------------------------------------------------
------------------------------------------------------------------------------------------------------------------------------------------------------
------------------------------------------------------------------------------------------------------------------------------------------------------
------------------------------------------------------------------------------------------------------------------------------------------------------
------------------------------------------------------------------------------------------------------------------------------------------------------
------------------------------------------------------------------------------------------------------------------------------------------------------
------------------------------------------------------------------------------------------------------------------------------------------------------
------------------------------------------------------------------------------------------%-------%---------------------------------------------------
-------------------------------------------------%----------------t-----------------------|-------|-----------------%----------%----------------------
----------%-------%----%---%---------------------|----%%--------%-t--%-----%%%------------|-%-----|-----------------|----------|--%%------------------
----------|%-%--%%|----|%--|---------%-----------|-%%%||--%-----|-%--|-----|||%-%---------|-|-----|------%%%---%----|%-%-------|%-||------------------
%%%%%%%%--||-|--|||----||--|--------%|-----%-----|-|||||--|%----|-|%%|--%--||||-|------%--|-|%--%-|%-----|||---|--%-||-|-------||-||--%---------------
||||||||XX||XX-X|||-XXX||XX|XXXXXXXX||-XXXX|XXXXXXXX||||XX||-X-X|X||||XX|-X||||-|XXXXXX|XX|-||--|X||XX-XX|||XXX|XX|X||X|-XX-X-X||X||XX|XXXXXXXX-----XX