------------------------------------------------------------------------------------------------------------------------------------------------------
------------------------------------------------------------------------------------------------------------------------------------------------------
------------------------------------------------------------------------------------------------------------------------------------------------------
------------------------------------------------------------------------------------------------------------------------------------------------------
----------------------------------------------------------------------------------------------------------------------------------------------%-------
----------------------------------------------------------------------------------------------------------------------------------------------|-------
----------------------------------------------------------------------------------------------------------------------------------------------|-------
-------------------------------------%--------------------------------------------------------------------------------------------------------|-------
-------------------------------------|---------------------------------------------------------------------%----------------------------------|-------
-------------------------------------|---------------------------------------------------------------------|----------------------------------|-------
-------------------------------------|---------------------------------------------------------------------|------------------------%-%---%%--|-------
-----------------%-------------------|---%--%-------%--------------------------------------------%%----%---|------------------------|-|S--||--|-------
---------%%------|---%-%-------------|---|--|-%--%--|---%-%%-------------------------------%-----||----|--%|%--%---------%----------|-|---||%%|-%--%%-
---------||%-----|---|-|---%%-----g-%|%--|%-|-|--|--|---|-||-----------------------%-------|-----||----|--|||--|---------|--------%%|-|---|||||-|%%||-
%%%%%%%%-|||%----|---|-|---||-------|||%-||%|-|-%|--|---|-||-------%--%-----%------|-%-----|----%||----|--|||--|--%------|--%--%-%|||-|g--|||||-|||||-
||||||||X||||XXXX|XXX|-|XXX||--XX-XX||||-||||X|-||XX|XX-|X||-XX-XXX|XX|X--XX|XX-X--|X|XXXXX|XXXX|||-XX-X--|||XX|XX|-XX-X-|XX|XX|X||||X|XXX|||||-|||||-