------------------------------------------------------------------------------------------------------------------------------------------------------
------------------------------------------------------------------------------------------------------------------------------------------------------
------------------------------------------------------------------------------------------------------------------------------------------------------
------------------------------------------------------------------------------------------------------------------------------------------------------
------------------------------------------------------------------------------------------------------------------------------------------------------
------------------------------------------------------------------------------------------------------------------------------------------------------
------------------------------------------------------------------------------------------------------------------------------------------------------
----------------------------------------------------------------%---%---------------------------------------------------------------------------------
---------------------%------------------------------------------|---|----------------------------------------------------------------------------D----
---------------------|------------------------------#-----------|---|--------------------------------------------------------%------------------------
---------------------|---------------------------%--#-----------|---|---------------%----------------------------------------|------------------------
---------------------|--------------------%------|--#-----------|---|---------------|----%%----------------------------------|------------------------
---------------------|%-----------%-------|------|--%%%---------|---|---------------|----||%-----------------%--%--------%---|---------------------%%%
---------------------||---%------%|%------|--%---|-%|||---------|---|--------K------|----|||%----------------|--|--%-----|-%-|--%-------%%---%-----|||
%%%%%%%%%------------||%-%|------|||------|%%|---|-||||-----%%%-|--%|--------%-%%-%-|----||||----------%%%---|%-|--|----%|-|-|--|%%-----||---|---%-|||
|||||||||XXXXXXXX-X-X|||X||---XX-|||-XX---||||XXX|X||||XXXXX|||-|-X||XX--XXXX|-||X|-|XXXX||||XXX--XX-XX|||X-X||X|XX|XXXX||X|X|XX|||--XXX||XXX|--X|X|||