------------------------------------------------------------------------------------------------------------------------------------------------------
------------------------------------------------------------------------------------------------------------------------------------------------------
------------------------------------------------------------------------------------------------------------------------------------------------------
------------------------------------------------------------------------------------------------------------------------------------------------------
------------------------------------------------------------------------------------------------------------------------------------------------------
------------------------------------------------------------------------------------------------------------------------------------------------------
------------------------------------------------------------------------------------------------------------------------------------------------------
------------------------------------------------------------------------------------------------------%-----------------------------------------------
------------------------------------------------------------------------------------------------------|-----------------------------------------------
--------------------------------------%-S---------------------%---------------------------------------|-----------------------------------------------
---------------%-----------------%----|-----------------%%----|-------%%---------------%--------------|-----------------------------------------------
---------------|-----------------|----|-----------------||----|-------||--------------%|------%-----%-|------%-------------------------------%--------
------------%--|---------%----%--|---%|---------%-------||----|---%---||%-%%--%--%----||----%-|-----|-|%----%|----%%--------------%----------|--------
------------|--|-----%---|-%--|--|-%-||-%------%|-------||-%--|%-%|%-%|||%||--|--|----||--%-|-|-----|-%|----||----||--------------|------%%-%|--------
%%%%%%%%----|--%-----|---|-|--|--|-|-||-|------||%-----%||-|--||%|||-|||||||--|%-|----||%%|%|-|---%-|-||----||-%-%||%-------------|------||-||--------
||||||||XXXXXX-|XXXXX|XXXXX|-X|--|-|X||X|XX---XX||XXXXX|||X|XX||||||-|||||||-X||X|XXXX|||||||X|XX-|-|X||X-XX|XX|X||||--XXXXXXXXXXX|XXX---||X||XXXXXXXX