------------------------------------------------------------------------------------------------------------------------------------------------------
------------------------------------------------------------------------------------------------------------------------------------------------------
------------------------------------------------------------------------------------------------------------------------------------------------------
------------------------------------------------------------------------------------------------------------------------------------------------------
------------------------------------------------------------------------------------------------------------------------------------------------------
--------------------------------------g---------------------------------------------------------------------------------------------------------------
------------------------------------------------------------------------------------------------------------------------------------------------------
------------------------------------------------------------------------------------------------------------------------------------------------------
------------------------------------------------------------------------------------------------------------------------------------------------------
--------------------------------------%-------------------------%-------------------------------------------------------------------------------------
--------------------------------------|-%-----------------------|--------------------------------------%----------------------------------------------
--------------------------------------|-|-----------------------|----------t--------------2------------|----------------------------------------------
------------------------%%------------|-|-----------------------|----------t------%-%------------------|------------------%--%---------%-%--%---------
------------------------||------------|-|---%--%--%-------%-----|----------%------|-|-%--%------%------|---%--------------|%-|---------|-|--|-----%---
%%%%%%%%%%%----%%%-%----||------------|-|---|-%|-%|-------|-%%%-|----------|------|-|-|--|------|------|-%-|---%%------%--||-|---------|-|-%|%%%--|%%-
|||||||||||XXXX|||X|XXXX||XXXXX-XXXX-X|X|XXX|X||X||XXXXXXX|X|||X|---XXXXXXX|XX-XXX|X|-|-X|XX-XXX|--XXXX|-|X|XXX||X-XXXX|XX||XXXXXXXXXXX|X|X|||||XX|||X