------------------------------------------------------------------------------------------------------------------------------------------------------
------------------------------------------------------------------------------------------------------------------------------------------------------
------------------------------------------------------------------------------------------------------------------------------------------------------
------------------------------------------------------------------------------------------------------------------------------------------------------
------------------------------------------------------------------------------------------------------------------------------------------------------
------------------------------------------------------------------------------------------------------------------------------------------------------
--------------------------------------------------------------------------------------------------------------------------------%---------------------
----------------S---------------------------------------------------------------------------------------------------------------|---------------------
--------------------------------------------------------------------------t------------------%----------------------------------|---------------------
---------------------------------------------------------%----------------t------------------|----------------------------------|---------------------
----------------------------------------------------T----|--------%-------t------------------|----------t-----------------------%---------------------
----------------%-----------------------------------t----|--------|-------%--t---------------|----------t-----------------------|---------------------
----------------|---------%----%--%-----%----------%t----|--%-----|%------|--T---------------|-------%--t------------%%-%-------|---------%-%%--%%%---
----------------|---%-----|----|--|-----|----------|%----|--|-----||%-----|%-%---------%-----|---%%--|--t--------%---||%|----%--|---------|%||%-|||---
%%%%%%%%%%-%--%-|---|-----|---%|%%|--%--|%--------%||--%-|--|-----%||-----||-|---------|-----%---||--|%%%-----%--|-%-||||----|--|-----%---|||||-|||---
||||||||||X|XX|-|XXX|XX--X|X--|||||-X|XX||--XXX-XX|||XX|X|XX|XXXXX|||XX--X||X|XXXXXXXX-|X-X--|---||--||||XX--X|XX|X|X||||X--X|XX|X-XXX|XX-|||||X|||XXX