------------------------------------------------------------------------------------------------------------------------------------------------------
------------------------------------------------------------------------------------------------------------------------------------------------------
------------------------------------------------------------------------------------------------------------------------------------------------------
------------------------------------------------------------------------------------------------------------------------------------------------------
------------------------------------------------------------------------------------------------------------------------------------------------------
------------------------------------------------------------------------------------------------------------------------------------------------------
-----------------------------------------------------------------------------------%------------------------------------------------------------------
-----------------------------------------------------------------------------------|------------------------------------------------------------------
-----------------------------------------------------------------------------------|------------------------------------------------------------------
-----------------------------------------------------------------------------------|------------------------------------------------------------------
-----------------------------------------------------------------------------------|-------%----------------%---------------------------------------%-
-----------------------------------------------------------------------------------|-------|--------%----%--|--------------------%------------------|-
---------%-------------------%-%%--%-%--%--------%--------%--%---------------------|-%-----|%------%|----|--|---------%----------|-------%%--%------|-
---------|------------------%|-||--%-|-%|--------|--------|--|---%-------------%---%-|-----||-----%||----|--|---------|-----%----|-------||--|------|-
%%%%%%%%-|----%----------%--||-||--|-|-||%%%-----|-------%|--|---|%%-----------|---|-|----%||----%|||--%-|--|-%%------|-----|----|--%----||-%|---%--|-
||||||||XX-XXX|XXXXXXXXXX|X-X|-||-XXX|X|||||XXXX-|XXXXXXX||--|---|||XXX-XXX----|XX-|X|XXXX|||X-X-|X||X-|-X-X|X||XXXXX-XX-XX-XXXX-XXX|XXXX||X||--X|XX|X