------------------------------------------------------------------------------------------------------------------------------------------------------
------------------------------------------------------------------------------------------------------------------------------------------------------
------------------------------------------------------------------------------------------------------------------------------------------------------
------------------------------------------------------------------------------------------------------------------------------------------------------
------------------------------------------------------------------------------------------------------------------------------------------------------
------------------------------------------------------------------------------------------------------------------------------------------------------
----------------------------------------------------------------------------------------------------------------------%-------------------------------
--------------------------------------------------------------------%-------------------------------------------------|-------------------------------
--------------------------------------------------------------------|-------------------------------------------------|-------------------------------
------------------------------%-------------------------------------|-------------------------------------------------|-------------------------------
------------------------------|-------------------------------------|---------------------%---------------------------|--------------S----------------
---------------%--------------|-------------------------------------|-------------%-------|---------------------------|-------------------------------
---------------|--------------|-#%-----------------%----------------|%---------%--|--%----|-%-%---%-----------------%-%%-----%---%%-------------------
---------------|------%-%%-%--|-#|--------------%--|---------%g-----||---%%%---|--|%-|--%-|-|-|---|------------%----|-||---%-|---||-------------%---%-
%%%%%%%%------%|--%%%%|-||%|--|%%|---%-------%--|%-|%---%--%%|------|%---|||%-%|--||-|--|-|-|-|---|-------%----|----|-||---|-|---||-%%---%%--%--|---|-
||||||||XXXXXX||--|||||XX|||XX||||XXX|--XXXXX|XX||X||XX-|-X|||XXXXXX||-X-||||X||-X||-|XX|-|X|X|X--|----XXX|--X-|-XXX|X||--X|X|---||-||-XX||XX|XX|XXX|-