------------------------------------------------------------------------------------------------------------------------------------------------------
------------------------------------------------------------------------------------------------------------------------------------------------------
------------------------------------------------------------------------------------------------------------------------------------------------------
------------------------------------------------------------------------------------------------------------------------------------------------------
------------------------------------------------------------------------------------------------------------------------------------------------------
------------------------------------------------------------------------------------------------------------------------------------------------------
------------------------------------------------------------------------------------------------------------------------------------------------------
------------------------------------------------------------------------------------------------------------------------------------------------------
------------------------------------------------------------------------------------------------------------------------------------------------------
----------------------------t--------------------------------------%---------------------------------------------------------------------------%------
----------------------------T--------------------------------------|---------------------------------------------------------%-----------------|------
----------------------------t--------------------------------------|---------------------------------------------------------|-----------------|------
----------------------------%%-----------------%%----%-------------|---------%%-------------------------%%--%----------------|-----------------|-----%
--------%--------------%----||---%---%---------||----|--%----------|---------||-%--%%-----------%-------||--|-%----%%-%---%%-%---%---%---%---%-|-----|
%%%%%%%%|-----%%-------|----||---|---|---%-%-%-||----|%%|----------|---------||-|%-||--------%--|----%--||--|-|----||%|---||-|--%|---|---|---|-|-----|
|||||||||XXXX-||--XX-XX|X--X||XXX|X-XX-XX|X|X|X||XXXX||||XX-XXXXXXX|X-XXXXXXX||X||X|X-XX-XXXX|X-|XXXX|XX||XX|X|XXXX||||X-X||X|XX||XX-XXXXXXX-|X|-XXXX|