------------------------------------------------------------------------------------------------------------------------------------------------------
------------------------------------------------------------------------------------------------------------------------------------------------------
------------------------------------------------------------------------------------------------------------------------------------------------------
------------------------------------------------------------------------------------------------------------------------------------------------------
------------------------------------------------------------------------------------------------------------------------------------------------------
--------------------------------C---------------------------------------------------------------------------------------------------------------------
------------------------------------------------------------------------------------------------------------------------------------------------------
------------------------------------------------------------------------------------------------------------------------------------------------------
------------------------------------------------------------------------------------------------------------------------------------------------------
--------------------------------%---------------------------------------------------------------------------------------------------------------------
------------%-------------%%----|----------------------------------%-------------------%----------------------------------------%---------------------
------------|-----%-------||----|---%------------------------------|----------------g--|-------------------%--------------------|---------------------
-----------%|-%---|%-%----||----|---|---%---%---%%-----------%-----|-------%---------%-|-%-----------------|%----------%--------|-----------%--------%
-----------||-|---||-|----||-%-%|---|---|---|--%||----------%|-----|-------|---------|-|%|-------------%%--||----------|--------|----------%|---%--%-|
%%%%%%%%---||-|-%-||-|----||-|-||---|-%-|---|--|||%%%-----%-||%----|--%----|---------|-|||---%---------||--||----%-----|%%-%%---|-%------%-||---|--|-|
||||||||---||X|X|X||X|----||X|X||XXXXX|X|XX-|X-||||||XXX--|X|||XXXX|XX|--XX|X-XXX-XX-|X|||--X|XXXXX-XXX||XX||XXX-|XXXXX|||X||XX-|X|XXXXXX|X||XXXXXX|X|