------------------------------------------------------------------------------------------------------------------------------------------------------
------------------------------------------------------------------------------------------------------------------------------------------------------
------------------------------------------------------------------------------------------------------------------------------------------------------
------------------------------------------------------------------------------------------------------------------------------------------------------
------------------------------------------------------------------------------------------------------------------------------------------------------
------------------------------------------------------------------------------------------------------------------------------------------------------
------------------------------------------------------------------------------------------------------------------------------------------------------
----------------------%----------------------%---------------------g-----------------------------------------------%----------------------------------
----------------------|----------------------|---------------------|-------------%--------------------------%------|----------------------------------
----------------------|----------------------|---------------------|-------------|--------------%-----------|------|-------------------------%--------
----------------------|----------------------|---------------------|-------------|--------------|-----------|-%----|-------------------------|--------
----------S-----------|----------------------|-%------%-------%----%-------------|--------------|-----------|-|-%--|-------------------------|--------
--------------%-------|---%-------%----------|-|-%%---|--%%---|---%|-------------|---------%%---%----%------|-|-|--|------%%%%--------%------|--------
------------%-|-------|--%|-%%---%|----------|-|-||---|--||%%-|---||-----%-------|---------||---|---%|-%----|-|-|--|g-----||||----%---|------|--------
%%%%%%%%----|-|-%%%---|--||-||---||-%---%-%%-|-|-||-%-|--||||-|-%-||-----|-------|--------%||%--|--%||%|%%%%|-|-|--|--%---||||%-%-|---|---%--|-%------
||||||||XXXX|X|-|||XXX|XX||-||-XX||X|XX-|X||X|X|X||X|X|-X||||X|-|X||-XXXX|XXXXX-X|XXXXXX-X||||X-|XX||||||||||-|X|XX|X-|XXX|||||-|X|XXX|XXX|XX|X|XXXXXX