------------------------------------------------------------------------------------------------------------------------------------------------------
------------------------------------------------------------------------------------------------------------------------------------------------------
------------------------------------------------------------------------------------------------------------------------------------------------------
------------------------------------------------------------------------------------------------------------------------------------------------------
------------------------------------------------------------------------------------------------------------------------------------------------------
------------------------------------------------------------------------------------------------------------------------------------------------------
------------------------------------------------------------------------------------------------------------------------------------------------------
--------------------------%--------------------------------------------------------------------------------------%--------------%---------------------
--------------------------|----------------g---------------------------------------------------------------------|--------------|---------------------
--------------------------|--------------------------------------------------------------------------------------|--------------|---------------------
--------------------------|----------------%---------------------------------------------------------------------|--------------|---%-----------------
--------------------------|---%------------|-------------------%-------------C%---S-----%-----------------------%|--------------|---|-----------------
---------%----%---%-%%----|---|------------|-----%---%---%%----|------S-------|------%--|----------%------%-----||-----------%--|---|%---%-----------%
---------|---%|---|-||----|---|-%----%%%---|-----|%-%|---||--%-|%-------%-----%------|--|----%----%|------|---%-%|-----------|%%|---||---|----%%-%---|
%%%%%%%%%|---||--%|-||----%%%%|-|----|||---|-----||-||---||%-|-||%%%----|%%%--|------|--|----|%---||-%--%-|---|-||%%%------%%||||---||%%-|----||-|--%%
||||||||||XXX||XX||X||-X--|||||X|X---|||X-X|XXXXX||X||XXX|||X|-|||||XXXX||||XXXXX-XXX|XXXX-XX||X--||-|XX|-|XXX|-|||||XX-XXX||||||XXX||||XXXXXX||X|X-||