------------------------------------------------------------------------------------------------------------------------------------------------------
------------------------------------------------------------------------------------------------------------------------------------------------------
------------------------------------------------------------------------------------------------------------------------------------------------------
------------------------------------------------------------------------------------------------------------------------------------------------------
------------------------------------------------------------------------------------------------------------------------------------------------------
------------------------------------------------------------------------------------------------------------------------------------------------------
--------------------------------------------------------------------------------%--------------D-----------------%---------------------------%--------
--------------------------------------------------------------------------------|--------------------------------|---------------------------|--------
--------------------------------------------------------------------------------|--------------------------------|---------------------------|--------
-------------------------------------------------------------------%-----------%|-%------------------------------|---------------------------|--------
-------------------------------------------------------------------|--------%--||-|------------------------------|---------------------------|--------
---------------%-------------------------------%-------------------|--------|--||-|----%--------------%----------|-----------------------%%--|-----%--
----------%----|-%%%-------------%%-%----------|%-------%%---------|%-%-%---|--||-|---%|%--%---%-%----|--%-------|-------------------%---||--|-----|--
--------%-|----|-|||-------------||%|--%-------||-t-----||---#-%---||-|-|---|--||%|---|||-%|t--|-|%---%--|-------|----%-------------%|---||%-|-----|--
%%%%%%%%|%|----|-|||--%--%-%%%---||||--|-------||-t-----||---%-|%%-||-|-|---%--||||%--|||-||t%-|-||--%|--|-------|%%-%|%%---------%-||---|||%|----%|--
|||||||||||XXXX|X|||XX|XX|X|||X-XXX||XX|---XXXXX|XXXXXXX||XX-|-|||-X|X|X|--X|XX||X||XX|X|X||X|X|X|XXX|XXX|XXXXXXX|||X||||XXXXXXXXX|X||XXX|||||-XXX|XXX