------------------------------------------------------------------------------------------------------------------------------------------------------
------------------------------------------------------------------------------------------------------------------------------------------------------
------------------------------------------------------------------------------------------------------------------------------------------------------
------------------------------------------------------------------------------------------------------------------------------------------------------
------------------------------------------------------------------------------------------------------------------------------------------------------
------------------------------------------------------------------------------------------------------------------------------------------------------
------------------------------------------------------------------------------------------------------------------------------%-----------------------
------------------------------------------------------------------------------------------------------------------------------|-----------------------
------------------------------------------------------------------------------------------------------------------------------|-----------------------
---------------------------------------t-------------------------------------------------------------------------%---%----S---|-----------------------
--------------------------S------------t-----------------------S-------------------------------------------------|-%-|-----%--|-----------------------
---------------------------------------t---------------------------------------------------%-------------%-------|%|-|---%-|--|-----------------------
---------------------------------------%%----------------%----------%-%------------%%--%--%|---------%---|-------|||-|---|-|%-|----------------------%
-----------%--------------%--%-----%---||-%%---%--%%-----%%----%----|-|--%-------%-||--|%-||--%%----%|---|-------|||%|---|-||-|----------------------|
%%%%%%%%---|-%%-%---------|--|-----|---||-||---|-%||%%-%-||----|---%|-|-%|-------|-||-%||-||--||---%||---|-------|||||---|-||%|--%-%---%----%-------%|
||||||||XXX|X||X|XXXXXXXXX|--XXXX-X|X-X||X||XXX|X|||||X|XX|X---|XX-||-|X||XXXX-XX|XX|-|||X|X-XX|XX-|||XXX|XXX-XXX|||||-XX|X||||XX|X|---|---X|XXX--XX||