------------------------------------------------------------------------------------------------------------------------------------------------------
------------------------------------------------------------------------------------------------------------------------------------------------------
------------------------------------------------------------------------------------------------------------------------------------------------------
------------------------------------------------------------------------------------------------------------------------------------------------------
-----------------------------------------------------%------------------------------------------------------------------------------------------------
-----------------------------------------------------|------------------------------------------------------------------------------------------------
-----------------------------------------------------|------------------------------------------------------------------------------------------------
-----------------------------------------------------|---------------------C--------------------------------------%-----------------------------------
-----------------------------------------------------|------------------------------------------------------------|-----------------------------------
-----------------------------------------------------|-------%----------------------------------------------------|-----------------------------------
--------U--------------------------------------------|----%--|-------------%--------------------------------------|---------%-------------------------
---------------------------------------------------%-|---%|--|-------------|--------------------------------------|---------|-------------------------
---------------%--------------------------%-%--%---|-|---||--|-------------|---%---------------%-------------%----|---------|-----------%----%--------
---------------|--------------------------|-|-%|---|-|---||-%|------%---%--|--%|---------%-%---|-----%-%---%-|----%-----%--%|-----%%----|---%|--------
%%%%%%%%%%%%%--|--------------%------%-%--|-|-||---|-|--%||-||-----%|---|--|--||%%%%%----|-|---|-----|%|-%%|-|-%--|%--%%|--||%-%%-||----|---||--------
|||||||||||||-X|XXXXX-XXXX-XXX|XXXXX-|X|XX|-|X||X-X|-|X-|X|X||XX--X||XXX|XX|XX|||||||XXXX|-|XXX|--XXX|||X|||X|X|XX||XX|||X-|||-||-||XXXX|--XX|XXXX-X-X