------------------------------------------------------------------------------------------------------------------------------------------------------
------------------------------------------------------------------------------------------------------------------------------------------------------
------------------------------------------------------------------------------------------------------------------------------------------------------
------------------------------------------------------------------------------------------------------------------------------------------------------
------------------------------------------------------------------------------------------------------------------------------------------------------
------------------------------------------------------------------------------------------------------------------------------------------------------
-------------------------------------------------------%----------------------------------------------------------------------------------------------
-------------------------------------------------------|----------------------------------------------------------------------------------------------
-------------------------------------------------------|----------------------------------------------------------------------------------------------
-------------------------------------------------------|----------------------------------------------------%-----------------------------------------
------------------------%------------------------------|----------------------------------------------%-----|-----------------------------------------
------------------------|------------------------------|----------------------------------------------|-----|-------------------------------%---------
------------------------|-%%-------%------------%%-----|-%%%-----------%%-----%-----------------------|-----|---------------------------%--%|%-%---%--
------------------------|-||---%---|---%--%-%%%%||-----|-|||---%-------||-----|----------------%----%-|-----|------%----------%--%%%%%%-|--|||%|---|--
%%%%%%%%-%-%------------|-||%--|---|---|-%|-||||||---%-|-|||--%|--%--%-||--%--|--%-----%--%---%|-%--|-|---%-|------|%---------|--||||||%|-%|||||-%-|%-
||||||||X|X|XXXXXXXXXXXX|X|||XX|X-X|--X|X||X||||||XXX|X|X|||XX||XX|--|X||--|XX|-X|XXXX-|XX|XX-||-|X-|X|-XX|-|---XXX||XXXXXXXXX|XX||||||||X||||||-|-||X