------------------------------------------------------------------------------------------------------------------------------------------------------
------------------------------------------------------------------------------------------------------------------------------------------------------
------------------------------------------------------------------------------------------------------------------------------------------------------
------------------------------------------------------------------------------------------------------------------------------------------------------
------------------------------------------------------------------------------------------------------------------------------------------------------
------------------------------------------------------------------------------------------------------------------------------------------------------
------------------------------------------------------------------------------------------------------------------------------------------------------
------------------------------------------------------------------%-----------------------------------------------------------------------------------
------------------------------------------------------------------|-----------------------------------------------------------------------------------
------------------------------------------------------------------|---------------------%-----%--------------------------------%----------------------
------------------------------------------------------------------|---------------------|-----|--------%-----------------------|----------------------
----------------C-----------%-------------S-----%-----------------|-----------------%---|-----|--------|--------------%--------|---------------------%
-----------%--%---------%---|----%--------------|----------------%|------%%---------|%%-|-----|---%----|-------------%|--------|---------------------|
-----------|-%|---------|---|----|--------------|-%----%----%----||--%%%%||%-%%%%---|||-|-----|---|----|-%-----------||%-------|-%--%%-%%%%-%%%%%%---|
%%%%%%%%---|-||--------%|---|%---|%-------------|-|----|----|----||--|||||||-||||%--|||-|---%-|---|-%-%|-|----%-----%|||-------|-|--||-||||-||||||-%%|
||||||||XXX|X||-XX-XXX-||--X||XXX||XX-XXXXXXXXXX|X|-XXX|X-XX|XXXX||-X|||||||X|||||--|||X|XX-|X|XXX|X|X|X-|XXXX|X-XXX|XX|X--XXXX|X|--||X||||-||||||X|||