------------------------------------------------------------------------------------------------------------------------------------------------------
------------------------------------------------------------------------------------------------------------------------------------------------------
------------------------------------------------------------------------------------------------------------------------------------------------------
------------------------------------------------------------------------------------------------------------------------------------------------------
------------------------------------------------------------------------------------------------------------------------------------------------------
------------------------------------------------------------------------------------------------------------------------------------------------------
------------------------------------------------------------------------------------------------------------------------------------------------------
------------------------------------------------------------------------------------------------------------------------------------------------------
------------------------------------------------------------------------------------------------------------------------------------------------------
----------------------------------------------------------------------------------------------%-------------------------------------------------------
-----------------%-------S--------------------------------------------------------------------|------------------------------S%-----------------------
-----------------|----------------------------%------------------------------------------%g---|----------------------%--------|----------%------------
----------%------|---------%%-----------------|---%-%%---------------%%-------%---------%|-%--|----%-%--------------%|--------|t---------|-%%-----%---
----------|-----%|-----%%%-||-%-%--%-------%--|---|-||%-%--------%---||-------|%--------||-|S-|----|-|----%-----%%--|%-------%|t---------|-||--%--|---
%%%%%%%%%-|%%---||-----|||-||%|-|-%|-%-%-%-|--|---|-|||%|-%%-----|%%-||-------||--%-----||-|--|----|-|%--%|-----||--||%------||t------%%-|-||--|%%|-%-
|||||||||-|||-X-||X--XX|||X||||X|-||-|X|X|X|-X|XX-|X|||||X||XXXX-X||X||XXXXX-XX|XX|XXXXX|XXXX-|XX-XXX||--||XXXX-||XX|||-XXXXX||X-XXXXX||-X-||X-||||X|X