------------------------------------------------------------------------------------------------------------------------------------------------------
------------------------------------------------------------------------------------------------------------------------------------------------------
------------------------------------------------------------------------------------------------------------------------------------------------------
------------------------------------------------------------------------------------------------------------------------------------------------------
-----------------%------------------------------------------------------------------------------------------------------------------------------------
-----------------|------------------------------------------------------------------------------------------------------------------------------------
-----------------|-----------------------------%---------------------%--------------------------------------------------------------------------------
-----------------|-----------------------------|%----%---------------|--------------------------------------------------------------------------------
-----------------|-----------------------------||----|---------------|--------------------------------------------------------------------------------
-----------------D-------------------------%---||----|-----%---------|-------------------------------------------------------------%------------------
-------------------------------------------|---||---%|-----|---------|-------------------------------------------------------------|------------------
-------------------------------------------|--%||g--||-----|---------|-------------------------------------------------------------|------------------
---------------%----------%----------------|--|||---|%-----|----%----|%------%-------%----%----------------%-------%-------------%%|-----%%-%---------
---------------|%---%-----|%-------%-------|--|||%%-||--%--|----|-%--%|------|-------|-%--|---------------%|-------|-----------%-|||-----||%|--%%-----
%%%%%%%%-------||---|-----||-------|-----%-|--|||||-||--|%-|%%-%|-|--||-----%|-%-----|-|--|-%-%---%%------||------%|--------%--|-|||---%-||||--||-----
||||||||XXX-XXX||XXX|----X||XXXX--X|----X|X|XXX||X|-||-X||X|||X||X|X-||--XXX||X|XXX-X|-|--|X|X|XXX||XXXX-X||-XX-XX||--XXXXXX|XX|-|||XXX|X||||XX||XXXXX