------------------------------------------------------------------------------------------------------------------------------------------------------
------------------------------------------------------------------------------------------------------------------------------------------------------
------------------------------------------------------------------------------------------------------------------------------------------------------
------------------------------------------------------------------------------------------------------------------------------------------------------
------------------------------------------------------------------------------------------------------------------------------------------------------
------------------------------------------------------------------------------------------------------------------------------------------------------
------------------------------------------------------------------------------------------------------------------------------------------------------
--------------------------------------------------------------------------------------------------------------------------------------------%---------
--------------------------------------------------------------------------------------------------------------------------------------------|---------
--------------------------------------------------------------------------------------------------------------------------------------------|-%-------
-----------------------------------------------------------------------------------------------%---%----%%---------%------------------------|-|-------
---------%-------------------%------------------%----------------------------------------------|---|----||---------|------------------------|-|------C
---------|---------------%---|%------%---%-%----|-----%-%---------%%------%%-%%----------------|---|----||--%%-----|------------------------|-|%------
---------|-----------%--%|%--||--%---|--%|-|----|-----|-|---------||---%%-||-||%----------%----|---|----||%-||-----|-----%----%%--%---------%-||-%%---
%%%%%%%%-|--------%%-|--|||--||--|%--|-%||-|----|-----|-|-%-------||---||-||-|||----%----%|--%-|---|----|||-||-----|-----|----||--|--%----%%|-||-||---
||||||||X|XXXXXXXX||X|XX|||X-||XX||XX|X|||X|XXX-|X--X-|X|X|XXXXXXX||X--||X||-|||X-X-|XXXX||XX|X|XX-|X---|||X||XX-XX|X-XXX|XXXXXXXX|X-|X-XX|||X||-||--X