------------------------------------------------------------------------------------------------------------------------------------------------------
------------------------------------------------------------------------------------------------------------------------------------------------------
------------------------------------------------------------------------------------------------------------------------------------------------------
------------------------------------------------------------------------------------------------------------------------------------------------------
------------------------------------------------------------------------------------------------------------------------------------------------------
--------------------------------------------------------------------------------------------------------------------------%---------------------------
--------------------------------------------------------------------------------------------------------------------------|---------------------------
--------------------------------------------------------------------------------------------------------------------------|---------------------------
--------------------------------------------------------------------------------------------------------------------------|---------------------------
-------------------------------------------------------------------------------%----%-------------------------------------|---------------------------
---------------%-------------------------------------------------------%-------|----|-------------------------------------|--------%------------------
---------------|-%-----------------%-----------------------------------|-----%-|---%|-------------------------------------|----%---|----T-------------
---------------|-|---%-------------|-------------%----------%---------%|-----|-|---||-------%--------------%----------%---|----|---|----t----%%-------
---------%---%-|-|---|-%-----------|-g%---------%|---%------|---------||-----|-|---||-------|--%-----------|----------|-%-%--%-|-%-|%--%%----||-------
%%%%%%%%-|---|-|-|%--|-|-----------|--|----%%---||--%|------|---%%----||-----|-|%--||-------|--|%--%-------|--%-------|-|-|--|-|-|-||--||----||%------
||||||||X|XX-|-|-||-X|X|XX---XXXXXX|X-|XXXX||-X-||--||-XXX--|XX-||XXXXX|X--XX|X||X-X|--XXXXX|XX||X-|XXXXXX-|XX|XXXX-XXXX|-|XX|X|-|X||-X||XXXX|||XXXX--