------------------------------------------------------------------------------------------------------------------------------------------------------
------------------------------------------------------------------------------------------------------------------------------------------------------
------------------------------------------------------------------------------------------------------------------------------------------------------
------------------------------------------------------------------------------------------------------------------------------------------------------
------------------------------------------------------------------------------------------------------------------------------------------------------
------------------------------------------------------------------------------------------------------------------------------------------------------
------------------------------------------------------------------------------------------------------------------------------------------------------
------------------------------------------------------------------------------------------------------------------------------------------------------
-------------------------------------------------------------------------------------------%----------------------------------------------------------
-----------------------------------------------------------------%-------------------------|----------------------------------------------------------
-----------------------------------------------------------------|-------------------------|--------------------------------------------------%-------
------------------------------------%----------------------------|--------%----------------|----------------------%---------------------------|-------
------------%--%--------------------%---U-------------%----------|----%%-%|%%------%-------|%%-%-----------%-%----|-----------------------%---|-%%%---
------------|--|--------------------|--%--------------|----%-----|----||-||||------|%------%||%|---%%-%%%--|-|----|%---%-%-%--%---------%-|---|-|||---
%%%%%%%%%---|-%|-%%%------%---%---%%|--|-------------%%--%-|-%---|----||-||||%%--%-||------|||||---||-|||--|-|----||-%-|-|%|--|---------|-|--%|%|||%--
|||||||||XX-|X|XX|||XXXXXX|XXX|-XX|||X-|XXXXXXXX-XX--||X-|X|X|XXX|XX-X||X||||||XX|X||XXXXXX|||||-X-||X|||-X|X|-XXXX|X|X|X|||-X|X--XXXXXX|-|XX|||||||XX