------------------------------------------------------------------------------------------------------------------------------------------------------
------------------------------------------------------------------------------------------------------------------------------------------------------
------------------------------------------------------------------------------------------------------------------------------------------------------
------------------------------------------------------------------------------------------------------------------------------------------------------
------------------------------------------------------------------------------------------------------------------------------------------------------
----------------------------------------------------------------%-------------------------------------------------------------------------------------
----------------------------------------------------------------|---%----------------------------------------------------------------%----------------
----------------------------------------------------------------|---|------------------------------------------------------%---------|----------------
----------------------------------------------------------------|---|------------------------------------------------------|---------|----------------
----------------------------------------------------------------|---|-----%----------------------------------%-------------|-------%-|----------------
------------------------------------------------%---------------|---|----%|--------------------------%-------|-------------|-------|-|----------------
----------------------%-------------------------|%-------------%|---|----||--------------------------|-------|-------------|-------|-|----------------
----------------------|-------------------------||--%%---------||---|----||-%%C%---------------------|-------|-----%---U-G-|-------|-|---%%-----------
----------------%-%---|%-------%%%--------%%----||--||------%--||---|----||-||-|------%--------------|----%--|-----|%%---%-|---%---|-|---||------%----
%%%%%%%%-------%|-|--%||%------|||--------||----||-%||------|%%||--%|----||-||-|--%---|%----%--------|----|--|-----|||%--|-|---|-%-|-|%%-||-%-%%%|----
||||||||XXXXXX-||X|XX|X||XXX-XX|||-XXXXXXX||XXXX|XX|||--XXX-|||||-X||X---||XXXX|--|-XX||X---|XXXX--XX|XXXX|XX|XXXXX||||XX|X|XXX|X|-|X|||X||-|X||||XXXX