------------------------------------------------------------------------------------------------------------------------------------------------------
------------------------------------------------------------------------------------------------------------------------------------------------------
------------------------------------------------------------------------------------------------------------------------------------------------------
------------------------------------------------------------------------------------------------------------------------------------------------------
-------------------------------------------------------------%----------------------------------------------------------------------------------------
-------------------------------------------------------------|----------------------------------------------------------------------------------------
-------------------------%-----------------------------------|----------------------------------------------------------------------------------------
-------------------------|-----------------------------------|----------------------------------------------------------------------------------------
-------------------------|-----------------------------------|----------------------------------------------------------------------------------------
-------------------------|---%-------------------------------|---------------------------------------------------------%------------------------------
------------------------%|---|-------------------------------|----------------------------------------%-----------%--%-|------------------------------
------------------------||---|-------------------------------|----------------------------------------|-----------|--|-|-----%-----%--%%--------------
-----------------%----%-||---|------%---------------%--------|--%--------------%------%-%---%-%%------|%%---------|%-|%|-----|--%--|--||--------%-%-%-
-----------%----%|----|-||%--|--%---|--S------------|----%---|--|--------------|------|-|-%-|-||---%%-|||---------||-|||-----|--|--|--||------%%|-|%|-
%%%%%%%%---|-%--||----|-|||--|--|---|-------------%-|----|--%|--|--%---------%%|----%-|-|-|-|%||---||-|||------%%-||%|||%%-%-|--|--|--||----%-|||-|||-
||||||||-XX|X|-X||X-XX|X|||-X|XX|X--|XXXXXXXXXX-XX|X|XXXX|XX||XX|--|XXXXXXX-X|||XXXX|-|-|-|X||||--X||X|||XXXXXX||X||||X|||X|-|XXXXX|--||-XXX|X|||-|||-