------------------------------------------------------------------------------------------------------------------------------------------------------
------------------------------------------------------------------------------------------------------------------------------------------------------
------------------------------------------------------------------------------------------------------------------------------------------------------
------------------------------------------------------------------------------------------------------------------------------------------------------
------------------------------------------------------------------------------------------------------------------------------------------------------
------------------------------------------------------------------------------------------------------------------------------------------------------
------------------------------------------------------------------------------------------------------------------------------------------------------
---------------------------------------------%--------------------------------------------------------------------------------------------------------
---------------------------------------------|--------------------------------------------------------------------------------------------------------
---------------------------------------------|--------------------------------------------------------------------------------------------------------
---------------------------------------------|--%--------------------------------------------------------------%---------%----------------------------
-----------------------------t----%----------|--|---------%----------------------------------------------------|--------%|------------%---------------
-----------------S---------%-t--%%|----------|--|--%------|-----------%%---------g---------------%-------%%%-%%|-%------||----------%%|-------%-------
---------------------------|-t--|||----%-----|%%%--|------|---%%-%----||--%------%-------%-------|-------|||-|||-|-----%||%---------|||%%%---%|-------
%%%%%%%%------------%--%---|-%--|||----|-----||||--|%----%|---||-|%---||--|------|-------|------%|-------|||-|||-|---%-||||---------||||||---||%------
||||||||XXXX-XX-XX--|-X|XX-|X|-X|||XXX-X--X-X||||XX||---X|XXX-||-||XX-||X-|X--X--|--XXXXX|-XXXXX||XXX-XXX|||X|||X|XXX|X|X||XXXXXX-XX||||||XXX|||X-XXXX