------------------------------------------------------------------------------------------------------------------------------------------------------
------------------------------------------------------------------------------------------------------------------------------------------------------
------------------------------------------------------------------------------------------------------------------------------------------------------
------------------------------------------------------------------------------------------------------------------------------------------------------
------------------------------------------------------------------------------------------------------------------------------------------------------
-------------------------------------------------%----------------------------------------------------%-----------------------------------------------
-------------------------------------------------|----------------------------------------------------|-----------------------------------------------
-------------------------------------------------|----------------------------------------------------|-----------------------------------------------
-------------------------------------------------|----------------------------------------------------|---------%--------g----------------------------
-------------------------------------------------|---------------------------------------------------%|---------|-------------------------------------
-------------------------------------------------|%--------------------------------------------------||-g-------|-------------------------------------
-----------------%-----------------------%-------||---------------------------%----------------------||%|%------|-------------------------------------
----------%-----%|--C-%------%-----------|----%--||-%---%%%-------------------|-%%%-------------%----|||||------|--------------%----------%%---------%
----------|-%---||%---|------|----%%-%---|----|--||-|-%-|||%%-----%----%%%%%%%|-|||--%----------|----|||||------|------%-------|---------%||---------|
%%%%%%%%--|-|%--|||%-%|----%-|--%-||-|---|----|--||-|-|-|||||%----|----||||||||-|||%-|-%-----%--|---%|||%|------|%-----|-------|---------|||%------%%|
||||||||XX|X||XX||||X||XXXX|X|XX|X||X|---|X--X|XX||X|-|-||X|||XXXX|--XX|||||||X-||||-|X|-XXXX|XXXXXX|||X||--XX-X||-XXXX|X----XX|XXX-XXXXX||||XX--X-|||