------------------------------------------------------------------------------------------------------------------------------------------------------
------------------------------------------------------------------------------------------------------------------------------------------------------
------------------------------------------------------------------------------------------------------------------------------------------------------
------------------------------------------------------------------------------------------------------------------------------------------------------
------------------------------------------------------------------------------------------------------------------------------------------------------
------------------------------------------------------------------------------------------------------------------------------------------------------
------------------------------------------------------------------------------------------------------------------------------------------------------
------------------------------------------------------------------------------------------------------------------------------------------------------
------------------------------------------------------------------------------------------------------------------------------------------------------
------------------------------------------------------------------------------------------------------------------------------%-----------------------
---------------------------------------------------------------g--------------------------------------------------------------|--------------%--------
----------------------------------%----------------------------|--------------------------------------------------------------|--------------|--------
---------%---------%%%-------%%--%|-----%%---%%---------------%|----%%---------------------------%-----------%-------------%%-|-%--%--------%|-%------
--------%|%-%------|||-------||--||-----||---||---------%--%-%||%---||%---%------%---------------|-----------|-----%-------||-|-|--|--------||-|------
%%%%%%%%|||-|--%-%%|||-------||--||-----||---||---------|-%|-||%|---|||--%|--%---|--%------------|-----------|-----|-------||-|-|--|-%------||-|-%---%
|||||||||||X|XX|X|||||XX-X-XX||XX||XX--X||XX-||--XXX-XXX|X||-||||-XX||X-X||--|XXX|-X|XXXXXXXXXX-X|XXXX-XXX--X|XXXXX|-XXXXXX||-|X|XX|X|XXXXXX||X|X|XXX|