------------------------------------------------------------------------------------------------------------------------------------------------------
------------------------------------------------------------------------------------------------------------------------------------------------------
------------------------------------------------------------------------------------------------------------------------------------------------------
------------------------------------------------------------------------------------------------------------------------------------------------------
------------------------------------------------------------------------------------------------------------------------------------------------------
------------------------------------------------------------------------------------------------------------------------------------------------------
------------------------------------------------------------------------------------------------------------------------------------------------------
------------------------------------------------------------------------------------------------------------------------------------------------------
----------S------------------------------------------------------------------------------------------------------------------------------------------%
--------------------------------------------------------------------------------------------------------------------------------%--------------------|
-----------T----------------------------------------------------------------------------------------S---------------------------|--------------------|
-----------t---------------------------------------------------------%----------------------------------------------------------|---------------g----|
-----------t-------------------%----2--------------%-----------------|--%%---------------------------------%%-------------------|---------------|----|
---------%-t-------------------|-----%-----------%-|----%------------|--||--------%--------%-%---%--%------||--%%---%-----------|---------------|---%|
%%%%%%%%-|-%%%-%%----%---------|--%--|--%--------|-|----|-%---%-%----|--||--------|-----%%%|-|---|--|------||%-||%--|-----------|---------------|-%-||
||||||||X|X|||-||XXXX|XXX-XXXXX|--|XX|--|-XX-XXXX|X|XXXX|X|-XX|X|XXXX|XX||--X--XXX|--XXX|||XX|XXX|XX|X---X-|||X|||XX|XX-XX---XXX|-X-XXXXXXX--XXXXX|-||