------------------------------------------------------------------------------------------------------------------------------------------------------
------------------------------------------------------------------------------------------------------------------------------------------------------
------------------------------------------------------------------------------------------------------------------------------------------------------
------------------------------------------------------------------------------------------------------------------------------------------------------
------------------------------------------------------------------------------------------------------------------------------------------------------
------------------------------------------------------------------------------------------------------------------------------------------------------
------------------------------------------------------------------------------------------------------------------------------------------------------
------------------------------------------------------------------------------------------------------------------------------------------------------
------------------------------------------------------------------------------------------------------------------------------------------------------
----------------------%-----------------------------------%-%-----------------------------------------------------------------------------------------
----------------------|-----------------------------------|-|-----------------------------------------------------------------------------------------
----------------------|----%-------%----%-----------------|-|-------2---------------------------------------------------------------------------------
----------------------|----|-------|----|%-----%%--%----%-|-|---%-%--%-%-----------------%%------------------------%-%---%--%%%-----%%%--------%------
------------%---------|----|-------|----||-----||--|----|%|-|---|%|--|-|----%---%--------||-%----%%%---------------|-|---|--|||-----|||%%------|------
%%%%%%%%%---|-----%%--|----|--%--%%|-%%-%|-----||%-|%--%|||-|---|||--|-|--%-|---|--%%-%--||-|%-%-|||%--------------|-|---|--|||%----|||||----%%|-----%
|||||||||XXX|XXXXX||XX|XX--|XX|XX|||X||-||XXXXX|||X||XX||||X|XXX|||-X|X|XX|X|XXX|XX||X|XXXXX||-|-||||---XXXXXXXXX-X|-|---|XX||||X-XX|||||--XX|||XXXXX|