------------------------------------------------------------------------------------------------------------------------------------------------------
------------------------------------------------------------------------------------------------------------------------------------------------------
------------------------------------------------------------------------------------------------------------------------------------------------------
------------------------------------------------------------------------------------------------------------------------------------------------------
----------------------------------------------------------------------------------%-------------------------------------------------------------------
----------------------------------------------------------------------------------|-------------------------------------------------------------------
-----------------------------------------------------S----------------------------|-----------------------------------------------------------%-------
--------------------------------------------------------------------------------%-|------r----------------------------------------------------|-------
--------------------------------------------------------------------------------|-|------%-----------------------------------------%----------|-------
-----------------------------------------------%--------------------------------|-S------|-----------------------------------------|----------|-------
--------------------------------------%-----%--|--------------------------------|--------|-----%-----------------------------------|----------|-------
--------------------------%-----%-----|-----|-r|----------------%---------------|--------|-----|---------------k------%------------|----------|-------
--------------------------|-----|----%|---K%|-%|--%--%---%--%---|------------%--|---%%-%-|-----|---#------------%---%-|%-----%-----|----------|----%%-
----------%---------------%-%---|---%||%%-2||-||--|--|--%|%%|%-%|----%%------|--|-%-||-|-|-----|-%-#---%%-------|---|-||---%-|-----|---%--%---%--%-||%
%%%%%%%%-%|--%------------|%|---|---|||||--||-||--|-%|--||||||-||----||--%%%-|--|-|-||-|%|-----|-|-%--%||----%--|---|-||---|-|-----|--%|%%|---|-%|-|||
||||||||X||-X|XXXXXXXXXX--|||-XX|XXX|||||XX||X||-X|X||XX||||||X|X--XX||XX|||-|XX|X|XXXX|||--XXX|-|-|-X|||XX-X|XX|XX-|X||XX-|X|XX-X-|XX|||||-XX|X||-|||