------------------------------------------------------------------------------------------------------------------------------------------------------
------------------------------------------------------------------------------------------------------------------------------------------------------
------------------------------------------------------------------------------------------------------------------------------------------------------
------------------------------------------------------------------------------------------------------------------------------------------------------
------------------------------------------------------------------------------------------------------------------------------------------------------
--------------------------------------%---------------------------------------------------------------------------------------------------------------
--------------------------------------|---------------------------------------------------------------------------------------------------------------
--------------------------------------|--------%-----------------------------------------------------------------------------S------------------------
--------------------------------------|--------|-------------------------------------------------------S----------------------C-----------------------
--------------------------------------|--------|---------------------------------------------------------%------------------------------%-------------
--------------------------------------|--------|------------------------------------%-----------%------t%|------------------------------|-------------
-----------------------%--------------|--------|------------------------------------|-----------|-----%t||------%%----------------------|-------------
--------%--%----%--%---|----%-%-------|--%%----|--%------------------%%--%%------%%-|-----------|-----|%||%--%-%||%--%-----%--%%--------|--%%%--%-----
--------|--|----|--|%%-|----|-|-----%-|--||---%|--|---%--%--------%--||--||------||-|-----------|-----|||||--|-||||--|-%---|-%||----%---|--|||--|-----
%%%%%%%%|%-|---%|--|||-|----|-|---%-|-|--||%-%||--|---|%-|--------|--||--||--%%--||-|----%----%%|-%---|||||--|-||||--|-|---|-|||%---|%%%|--|||--|-%-%-
||||||||||-|X--||--|||X|---X|X|XXX|X|X|X-|||-|X|XX|-XX||X|XXXX----|XX||X-||X-||XX||X|-X-X|-XXX|||X|XX-|||||X-|X||||--|X|---|X||||X-X|||||XX|||-X|X|X|X