------------------------------------------------------------------------------------------------------------------------------------------------------
------------------------------------------------------------------------------------------------------------------------------------------------------
------------------------------------------------------------------------------------------------------------------------------------------------------
------------------------------------------------------------------------------------------------------------------------------------------------------
------------------------------------------------------------------------------------------------------------------------------------------------------
------------------------------------------------------------------------------------------------------------------------------------------------------
------------------------------------------------------------------------------------------------------------------------------------------------------
---------------------------------------------------------------------------------------------------------------------------%--------------------------
---------------------------------------------------------------------------------------------------------------------------|--------------------------
---------------------------------------------------------------------------------------------------------------------------|-------------------------%
------------------------C----------------------%------------%--------------------------------------------------------------|-------------------------|
---------%-------------------------------------|------------|--------------------------------------------------------------|-------------------------|
---------|------------%%--------%%%----%-------|--------%---|--S%-%--%%-%---%-----%---------%-----%%-%-----------%%----%---|-------%---%-----%-------|
---------|------------||-------%|||----|---%%--|--%-----|---|---|-|%-||-|---|-----|---------|-----||-|-----------||----|---%-------|---|----%|-------|
%%%%%%%%-|---------%-%||%%-----||||-%--|-%-||%%|--|-----|-%-%%--|%||-||-|%--|%----|%%-------|-%%--||-|-%%-%------||----|---|-%%----|---|-%--||-------|
||||||||X|XXXXXXX-X|X|||||---X-X|||X|X-|X|X|||||X-|XX-X-|X|-||XX||||X||X||-X||---X|||-XXXXXX|X||XX||X|X||X|XXX-XX||XXX-|XXX|X||XXXX|-XX|-|XX||-XXXXXX|