------------------------------------------------------------------------------------------------------------------------------------------------------
------------------------------------------------------------------------------------------------------------------------------------------------------
------------------------------------------------------------------------------------------------------------------------------------------------------
------------------------------------------------------------------------------------------------------------------------------------------------------
------------------------------------------------------------------------------------------------------------------------------------------------------
-----------%---------------------------------------------------------------------------------------------------------------------------------S--------
-----------|----------------------------------%-------------------------------------------------------------------------------------------------------
-----------|----------------------------------|-------------------------%-----------------------------------------------------------------------------
-----------|----------------------------------|-------------------------|-----------------------------------------------------------------------------
-----------|----------------------------------|-------------------------|-----------------------------------------------------------------------------
-----------|----------------------------------|%------------------------|---------------------C-------------------------------------------------------
-----------|----------------------------------||%-----%-g---------------S----------------%----------------------g--------%-------%--------------------
--------%%-|-----------------%------------%---|||-----|-------%------------%%%-----------|-------%----------------%-----%|-%-----|--------------------
--------||-|-----------------|------------|---|||-----|%---%--|----------%-|||--%--------|--%---%|%--%%%-%-------t|-----||-%-----|-------------%---%--
%%%%%%%%||-|--%%%-%%%%%--%---|---%-----%--|---|%|-----||---|--|---------%|-|||--|%-------|--|-%-|||--|||-|-------t|%----||-|--%--|-------------|---|--
||||||||||-|XX|||X|||||XX|XXX|XX-|X-XXX|XX|XXX|||X--X-X|XXX|XX|-XX--XX--||X|X|X-||XXX-XXXXXXXX|X|||XX|||X|XXXXXXXX||-XX-|XXXXX|XX|-X--XXXXXXXXX|-XX|--