------------------------------------------------------------------------------------------------------------------------------------------------------
------------------------------------------------------------------------------------------------------------------------------------------------------
------------------------------------------------------------------------------------------------------------------------------------------------------
------------------------------------------------------------------------------------------------------------------------------------------------------
------------------------------------------------------------------------------------------------------------------------------------------------------
------------------------------------------------------------------------------------------------------------------------------------------------------
------------------------------------------------------------------------------------------------------------------------------------------------------
-------------------------------------------%----------------------------------------------------------------------------------------------------------
-------------------------------------------|----------------------------------------------------------------------------------------------------------
---------------------S---------------------|--------------------------------------------%-------------------------------------------------------------
-------------------------------------------|--------------------------------------------|------------------------%------------------------------------
-------------------------------------------|%g------------------------------------------|------------------------|------------------------------------
---------------%--%-%%----------------%-%--||--%-------------------%--------------------|---%%%%-----------------|%-------------------%---------------
-------------%-|--|-||--%------------%|-|-%||-%|--%-%%-------%---%%|-----t--%-----------|---||||--%%--%---%-%%--%||---%%--%%----------|---------------
%%%%%%%%-----|-|--|-||--|------------||-|-|||-||--|%||-------|--%|||-%---t--|%--------%-|---||||--||--|---|-||--|||---||--||---------%|----%-------%--
||||||||XXX-X|X|XX|-||XX|XXXXXXXXXX-X||X|X||XX||-X||||-X---XX|XX||||X|X-XXXX||X-XXXXXX|X|XX-X|||XX||XX|-X-|X||XX|||-XX||--||XXXXX-XXX||X-XX|XXXXXXX|--