------------------------------------------------------------------------------------------------------------------------------------------------------
------------------------------------------------------------------------------------------------------------------------------------------------------
------------------------------------------------------------------------------------------------------------------------------------------------------
------------------------------------------------------------------------------------------------------------------------------------------------------
------------------------------------------------------------------------------------------------------------------------------------------------------
------------------------------------------------------------------------------------------------------------------------------------------------------
------------------------------------------------------------------------------------------------------------------------------------------------------
------------------------------------------------------------------------------------------------------------------------------------------------------
-----------------------------------------------------------------------------------%------------------------------------------------------------------
-----------------------------------------------------------------------------------|---------t-----------%--------------------------------------------
-----------------------------------------------------------------------------------|---------t-----------|--------------------------------------------
-----------------------%-G---------------------------------------------k----------%|---------t-----------|--------------------------------------------
----------%%%-----%----|-%--%%--%--%-----------%------------------------%---%-----||---------t%----------|------%---------%---------%%%------%--%-----
----------|||----%|%%--|-|--||--|--|%----------|%--------%--%-%-%------%|--%|--%--||--%------%|----------|------|---------|---------|||------|--|%%--%
%%%%%%%%%-|||%---||||%-|-|--||%%|--||---%--%---||---%-%--|-%|-|-|%-----||%-||-%|%-||--|-----%||----%%----|-%----|%%--%---%|--%%%----|||-----%|%-|||-%|
|||||||||X||||XXX|||||X|XXXX|||||-X||XXX|XX|X--||--X|X|-X|X||X|X||XXX-X|||X||X|||X||-X|--X-X|||-X--||XXXX|X|XXXX|||XX|XX-||XX|||XXXX|||XXXXX|||X|||X|X