------------------------------------------------------------------------------------------------------------------------------------------------------
------------------------------------------------------------------------------------------------------------------------------------------------------
------------------------------------------------------------------------------------------------------------------------------------------------------
------------------------------------------------------------------------------------------------------------------------------------------------------
------------------------------------------------------------------------------------------------------------------------------------------------------
--------------------------------------------------------------------------------------------------------------------------------------g---------------
------------------------------------------------------------------------------------------------------------------------------------------------------
-----------------------------------------------------------------------------------------------%------------------------------------------------------
-----------------------------------------------------------------------------------------------|-------------------------------------S----------------
-----------------------------------------------------------------------------------------------|----------------------------%-------------------------
-----------------------------------------------------------------------------------------------|----------------------------|----------------g--------
-------------g--------------------------------------------%------------------------------------|----------------------------|-------------------------
-------------%------------%------%%-------%----%-%--------|---%------%-----%%------------------|---%-----%--------------%---|----%------%-------------
------------%|--%%%-------|------||-------|----|-|--------|---|------|-%---||----------%----%%-|---|----%|--------------|---|----|------|-------------
%%%%%%%%----||--|||-----%-|------||----%%-|----%-|-------%|---|----%-|%|%%-||---%---%%-|%%-%||-|---|----||--%%%%%%%%--%-|---|%%--|%%----|%------%%%---
||||||||X--X|X-X|||XX--X|-|-X-XXXX|XXX-||X|XX-X|X|X-X-XXX|XXXX|XX-X|X|||||X||XX-|XXX||X|||X|||-|X-X|XX--||XX||||||||-X|X|XXX|||XX|||---X||XFX---|||XXX