------------------------------------------------------------------------------------------------------------------------------------------------------
------------------------------------------------------------------------------------------------------------------------------------------------------
------------------------------------------------------------------------------------------------------------------------------------------------------
------------------------------------------------------------------------------------------------------------------------------------------------------
------------------------------------------------------------------------------------------------------------------------------------------------------
------------------------------------------------------------------------------------%-----------------------------------------------------------------
------------------------------------------------------------------------------------|-----------------------------------------------------------------
------------------------------------------------------------------------------------|-----------------------------------------------------------------
-----------------------------%------------------------------------------------------|-----------------------------------------------------------------
-----------------------------|------------------------------------------------------|------%-------------------------------%--------------------------
-----------------------------|------------------------------------------------------|------|-------------------------------|--------------------------
-----------------------------|--------------------------------g---------------------|------|-------------------------------|--------------------------
---------%----------------%--%-----------%---%%-%%-%---------%%-----%-%-----%%%---%%|---%%%|%%--%%%%---------%-%-%%----%%%-|%-------------------------
---------|----%-----------|--|-----------|--%||-||-|%--------||----%|-|-----|||%--|||%%-||||||-%||||---------r-|-||--%G|||-||-%%--------%%-----%------
%%%%%%%%%|%-%-|--%---%----|--|--%%%%-----|%-|||-||-||%-%%----||--%-||-|-----||||--|||||-||||||-|||||---------%%|%||--|%|||-||-||------%-||-----|%-%--%
|||||||||||X|X|XX|---|-X--|-X|X-||||X-XXX||-X||X||X|||X||XXXX|XXX|X||X|--XXX||||XX|||XX-||||||X|||||-XXXXX-XX||||XXX-|||||XX|X||XXXXXX|X||XXXXX||X|X-|