------------------------------------------------------------------------------------------------------------------------------------------------------
------------------------------------------------------------------------------------------------------------------------------------------------------
------------------------------------------------------------------------------------------------------------------------------------------------------
------------------------------------------------------------------------------------------------------------------------------------------------------
--------------------------------------------------------------------%---------------------------------------------------------------------------------
--------------------------------------------------------------------|---------------------------------------------------------------------------------
--------------------------------------------------------------------|-------------------------------------------------%-------------------------------
-------------------%------------------------------------------------|--------------------------------------%%---------|-----------S-------------------
-------------------|------------------------------------------------|--------------------------------------||---------|-------------------------------
-------------------|------------------------------------------------D--------------------------------------||---------|-------------------------------
--------------%----|-----------%-------------------------------------------------%-%---------------------%-||---------|---%-------%-------------------
--------------|----|-----------|-----------------------------%%------------------|-|-----%---------------|-||---------|---|-%-----|----------%--------
--------------|----|%----------|--------%-%---%--%----%----%%||------%-----%-----|-|--%--|%-%%%---%-%%%--|-||---------|---|-|-----|-------%--|-----%--
----------%%--|%%--||--%---%---|-%------|-|---|%-|----|----||||-%--%-|-----|-----|-|%-|%-||-|||---|-|||--|-||--------%|---|-|-----|-----%-|-%|%%---|--
%%%%%%%%-%||--|||--||--|%%%|-%-|-|--%---|-|-%-||-|----|%%%-||||%|%-|-|-%---|---%%|%||-||%||%|||%--|-|||--|-%|--%-%%--||---|-|-----|%%---|-|-||||%-%|%%
||||||||X|||X-|||X-||--|||||X|-|X|XX|X-X|X|X|-||X|-XXX||||X|||||||X|XX-|XXX|--X||||||X||||||||||-X|X|||--|-||XX|X||X-||X-X|X|-XX-X|||XXX|-|X|X|||X||||