------------------------------------------------------------------------------------------------------------------------------------------------------
------------------------------------------------------------------------------------------------------------------------------------------------------
------------------------------------------------------------------------------------------------------------------------------------------------------
------------------------------------------------------------------------------------------------------------------------------------------------------
------------------------------------------------------------------------------------------------------------------------------------------------------
------------------------------------------------------------------------------------------------------------------------------------------------------
------------------------------------------------------------------------------------------------------------------------------------------------------
------------------------------------------------------------------------------------------------------------------------------------------------------
------------------------------------------------------------------------------------------------------------------------------------------------------
---------------------%--------------------------------------%---------------------------------------------------%-------------------------------------
---------------------|--------------------------------------|-------------------------------------%-------------|------%------------------------------
---------------------|--------------------------------------|-------------------------------------|-------------|--%---|------------------------------
---------------------|----%--------%-%------------------%---|----------------------------------%-%|--------%--%%|--|---|--%--------------%---%-----%--
---------------%--%--|--g-|------%-|g|-----------%----%-|%%%|%---%-%------%--%#-------%%-------|-||--------|--|||--|%%-|--|%%%-----------|---|-----|--
%%%%%%%%-------|--|--|----|------|-|-|%----%-----|--%%|-||||||-%%%-|%-----|--|%-------||----%%-|-||-%-----%|--|||--|||-|--||||-----------|---|-%-%-|--
||||||||-XXXXXX|-X|X-|X--X|XXXXX-|X|X||XXX-|-XX-XXXX|||X||||||X|||X||-XXXXXX-||X--X-XX||XXXX||-|XX|X|XXXXX|XXX|||XX|||X|XX||||XXXXXXXXXXX|-XX|X|X|X|X-