------------------------------------------------------------------------------------------------------------------------------------------------------
------------------------------------------------------------------------------------------------------------------------------------------------------
------------------------------------------------------------------------------------------------------------------------------------------------------
------------------------------------------------------------------------------------------------------------------------------------------------------
------------------------------------------------------------------------------------------------------------------------------------------------------
------------------------------------------------------------------------------------------------------------------------------------------------------
-----------------------------------------------------------------------------------%--------------------------%---------------------------------------
-----------------------------------------------------------------------------------|--------------------------|---------------------------------------
-----------------------------------------------------------------------------------|--------------------------|---------------------------------------
----------------------------------------------------------------------------------%|--------------------------|--C------------------------------------
--------------------------------------------------------------------%-------------||----------%%%-------------|---------------------------------------
--------------------------------------------------------------------|------------%||----------|||----%--------|--g-------%----------------------------
------------------%--%-------------------%%--%%-----%-----%%-%-----%|------------|||-%--------|||--%%|--------%%%----%---|-------%-----------------%--
------------------|--|-----------%-------||-%||----%|-----||-|---%-||------------|||-|--------|||--|||--------|||----|---|-------|---%%-----%%---%-|--
%%%%%%%%%--%------|--|%----%%-%%-|%---%%%||%|||-%%-||-----||-|---|%||%----------%|||-|-%%-----|||--|||--------|||----|---|-------|---||%----||---|%|--
|||||||||XX|XXXX--|X-||XXXX||X||X||XXX|||||||||-||-||XXXXX||X|XXX|||||--XXX-XXX-||||X|-||----X|||-X|||X---XX-X|||XX-X|XX-|XXXX-X-|-X-|||XX--||XX-|||XX