------------------------------------------------------------------------------------------------------------------------------------------------------
------------------------------------------------------------------------------------------------------------------------------------------------------
------------------------------------------------------------------------------------------------------------------------------------------------------
------------------------------------------------------------------------------------------------------------------------------------------------------
------------------------------------------------------------------------------------------------------------------------------------------------------
------------------------------------------------------------------------------------------------------------------------------------------------------
------------------------------------S-------------------------------------------------------------------------------------%---------------------------
--------------------------------------------------------------------------------------------------------------------------|---------------------------
--------------------------------------------------------------------------------------------------------------------------|---------------------------
---------------------------------------%----------------------------------------------------------------------------------|---------------------------
------------------------------------%--|----------------------------------------------------------------------------------|---------------------------
------------------------------------|--|%-------------------------------%---------------------------------------%---------|---------------------------
-----------------%%--%%-%%%---%-----|%-||-------%----%%------------%----|-%-----%-----%---------%------%%-%----%|---------|----------------------%%---
------------%----||%%||-|||---|-----||-||-------|----||--%-------%-|----|-|-----|%---%|---------|---%--||-|-%--||-2-%-----|---%----%--------%----||---
%%%%%%%%---%|----||||||-|||---|-----||-||%----%-|-%%-||--|--%----|-|----|-|-%---||--%||-----%---|---|--||-|-|--||---|-----|%%-|--%%|---%----|----||---
||||||||XXX||XXXX||||||X|||--X|XXXXX||X|X|-XX-|XXX||-||XX|-X|XX-X|X|-XX-|X|X|--X||-X|||-X-XX|X--|XX-|XX||X|X|XXX|XXX|XX--X|||X|XX|||XXX|XX-XXXXXX||XXX