------------------------------------------------------------------------------------------------------------------------------------------------------
------------------------------------------------------------------------------------------------------------------------------------------------------
------------------------------------------------------------------------------------------------------------------------------------------------------
------------------------------------------------------------------------------------------------------------------------------------------------------
------------------------------------------------------------------------------------------------------------------------------------------------------
------------------------------------------------------------------------------------------------------------------------------------------------------
------------------------------------------------------------------------------------------------------------------------------------------------------
-------------------------------------------------------------------------------------%----------------------------------------------------------------
-----------------------------D-------------------------------------------------------|----------------------------------------------------------------
---------------------%-------------------------------------------------------%-------|----------------%-----------------------------------------------
---------------------|-------------------------------------------------------|-------|----------------|--------------------------------------%--------
--------%------------|-------------------------------------------------------|-------|---------------%|----------------%-----------------%%--|--------
--------|----------%-|---%%------%%%%------%%-%---------------%-------%-%----|-----%%|-%----------%%-||--%%%%%-----%---|%%--------G--%---||--|--------
--------|-%-%--%---|-|-%-||-----%||||----%-||-|--------------%|--g----|-|----|-----%||-|----------||-||--|||||-----|%--|%|--%-----%-%|---||--|-----%%%
%%%%%%%%|-|-|--|--%|-|-|-||--%--|||||----|-||%|--%-----%-----||-------|-|----|---%-|||%|%-----%%%-||-||-%|||||-----||--|||-%|---%%|-||--%||%-|-----|||
||||||||XX|-|--|XX||X|-|-X|XX|XX|||||XX-X|X||||XX|XXXX-|XXXXX||X----XX|X|XX-X|XXX|XX|||||XXXX-|||X||-X|X|||XX|-XX-XX|X-|||X||-X-|||X||XX|XX|-|XXXXX|||