------------------------------------------------------------------------------------------------------------------------------------------------------
------------------------------------------------------------------------------------------------------------------------------------------------------
------------------------------------------------------------------------------------------------------------------------------------------------------
------------------------------------------------------------------------------------------------------------------------------------------------------
------------------------------------------------------------------------------------------------------------------------------------------------------
------------------------------------------------------------------------------------------------------------------------------------------------------
------------------------------------------------------------------------------------------------------------------------------------------------------
------------------------------------------------------------------------------------------------------------------------------------------------------
---------------------------------------------------------------------------------------------------------r--------------------------------------------
-------------------------------------------------------------------------------------------------------------%----------------------------------------
-------------------t------------------------------------------------------------------------------%----------|------%---------------U-----------------
-------------------t------------------------------------------------------------------------------|----------|------|---------------------------------
--------%---%------t------------%---------%--%-----------%-%%------%--------------%---------------|----------|----%-|-------#%--%-----%%-%------%-----
--------|---|%-%%-%%------%-----|%%----%-%|--|--%------%-|-||---2--|---------%----|---------------|---------%|%-%-|-|-------#|%-|-----||-|------|-----
%%%%%%%%|---||%||-||---%--|-----|||---%|-|%--|--|------|-|-||------|--------%|----|------%%%%%%---|---------|||-|-|%|%%%----#||-|%--%-||-|-%%--%|-%%-%
|||||||||-XX|||||X||XXX|X-|XX--X|||X-X||X||XX|--|XXXXX-|-|X||-XXXXX|XX-XXX-X||-XXX|XXXXXX||||||XXX|XXXXXX-XX|||-XX||||||XXX-X|XX||XX|-||X|X||XX||X||X|