------------------------------------------------------------------------------------------------------------------------------------------------------
------------------------------------------------------------------------------------------------------------------------------------------------------
------------------------------------------------------------------------------------------------------------------------------------------------------
------------------------------------------------------------------------------------------------------------------------------------------------------
------------------------------------------------------------------------------------------------------------------------------------------------------
------------------------------------------------------------------------------------------------------------------------------%-----------------------
------------------------------------------------------------------------------------------------------------------------------|-----------------------
------------------------------------------------------------------------------------------------------------------------------|-----------------------
-------------------------------%----------------------------------------------------------------------------------------------|%----------------------
-------------------------------|----------------------------------------------------------------------%-----------------------||----------------------
-------------------------------|---%------------------------------------------------------------------|-----------------------||----------------------
-------------------------------|--%|----------------------------------------------------------%%------|-----------------------||----------------------
-------------------%%----%-----%%-||-%-------------------------------%--%-%---%%----%--%------||------|%%---%------%%---------||---------------%------
-------------------||----|--%--||-||%|-----------%-------------%---%-|--|-|---||----|-%|------||-----%|||---|-%----||---------||-%------%%-----|------
%%%%%%%%--------%--||----|--|--||%||||---%--%---%|---------%---|---|-|-%|-|---||----|-||------||-----||||---|-|--%%||---------||-|------||-----|%-----
||||||||---XXXXX|XX||XXXX|X-|X-|||||||XXX|XX|XXX||X-XXXX-X-|XXX|X-X|X|-||X|XXX||XXXX|XX|XXXXXX||X-XXX||||XXX|X|X-||||----XXXXX||X|-XXX-X||XXXXX||-XXX-