------------------------------------------------------------------------------------------------------------------------------------------------------
------------------------------------------------------------------------------------------------------------------------------------------------------
------------------------------------------------------------------------------------------------------------------------------------------------------
------------------------------------------------------------------------------------------------------------------------------------------------------
------------------------------------------------------------------------------------------------------------------------------------------------------
------------------------------------------------------------------------------------------------------------------------------------------------------
------------------------------------------------------------------------------------------------------------------------------------------------------
------------------------------------------------------------------------------------------------------------------------------------------------------
-------------------------------%---------------------------------------------------------------------%------------------------------------------------
-------------------------------|---------------------------------------------------------------------|------------------------------------------------
-------------------------------|-------------%-------------------------------------------%-----------|----------------------------------------------%-
-----------C-------------------|-------------|-%----------%----------------------------%-|-----------|---------------------%%----------F------------|-
---------%---%---------%---%---|--%----------|-|----------|--%------------------------%|-|-----%-----|--%-%----------------||----------%-----%------|-
---------|---|---------|---|--%|--|--%-%-----%-|----%g----|--|%-----%---%%------------||-|-%---|%%%--|%-|#|---%------------||----------|-----|------|-
%%%%%%%%%|%--|--%----%-|---|--||--|%-|-|-----|%|----|-----|-%||--%--|%--||--------%---||-|-|--%||||%-||-|%|---|%-----------||---%-----%|---%%|------|-
|||||||||||X-XXX|XXXX|-|X-X|XX||XX||-|X|-----|||XX-X|XXXXXXX|||XX|XX||XX||XXXXXX-X|-XX||X|-|XX||||||X||X|||-X-||--X-XXXXXX-XXXXX|-XX-X|XXX-||XXXXXXX|X