------------------------------------------------------------------------------------------------------------------------------------------------------
------------------------------------------------------------------------------------------------------------------------------------------------------
------------------------------------------------------------------------------------------------------------------------------------------------------
------------------------------------------------------------------------------------------------------------------------------------------------------
------------------------------------------------------------------------------------------------------------------------------------------------------
------------------------------------------------------------------------------------------------------------------------------------------------------
------------------------------------------------------------------------------------------------------------------------------------------------------
-------------C----------------------------------------------------------------------------------------------------------------------------%-----------
------------------------------------------------------------------------------------------------------------------------------------------|-----------
-------------------------------------------------------------------------------------------------------------g----------------------------|-----------
-------------------------------------------------------------------------------------------------------------------%----------------------|-----------
-------------%---------g-------------%----------------------%-------------g%-------------------g----------%------%-|----------------------|-----------
-------------|--%%--%----------------|-----%----------------|----%-------%-|--------%-----%----|-----%----|------|-|%-%------%--%-------%-|--%-----%%-
----------%--|--||%%|------%%%-------|S----|--------------%%|-%--|-------|%|--------|-----|--%%|-----|----%------|-||-|------|--|-------|-|--|%--%-||%
%%%%%%%%--|--|--|||||------|||------%|----%|%---------%%--|||-|--|---%-%-|||----%%--|----%|--|||--%%%|----|%-----|-||-|------|--|------%|%|--||--|-|||
||||||||XX|-X|XX|||||XXX--X|||-XX-XX||X-XX|||XXXXXXXXX||--|X|X|XX|-XX|X|-|XXXXX-||XX|XXXX||--||XX-||||-XXX||X--XX|X||X|XXXXXX|XX|XX-XXX||||XX||-X|X|||