------------------------------------------------------------------------------------------------------------------------------------------------------
------------------------------------------------------------------------------------------------------------------------------------------------------
------------------------------------------------#-----------------------------------------------------------------------------------------------------
------------------------------------------------#-----------------------------------------------------------------------------------------------------
------------------------------------------------#-----------------------------------------------------------------------------------------------------
------------------------------------------------%------------------------------------%----------------------------------------------------------------
------------------------------------------------|------------------------------------|----------------------------------------------------------------
-----------------------------------%--------%---|------------------------------------|----------------------------------------------------------------
-----------------------------------|--------|---|------------------------------------|--------------%-------------------------------------------------
-----------------------------------|--------|---|------------------------------------|--------------|---------------------%---------------------------
-----------------------------------|--------|---|--------------------t---------------|--------------|---------------------|---------------------------
--------------%--------------------|--------|---|--------------------t---------------|--------------|---------------------|-----------------%--%------
--------------|--%%----------------|-------%|---|----%-%-------------t---------------|--------------|--%------------------|-%---%-%---------|%-|------
---------%----|--||--%-------%-----|-------||---|----|-|---------%-%-%%-%------------|----%---------|--|--%----------%%-%-|-|---|-|---------%|-|------
%%%%%%%%-|----|%-||--|---%%--|-----|-------||---|----|-|%-%-%%%--|-|-||-|------------|----|--------%|--|--|%-%%------||-|-|%|--%|-|-----%-%%||-|%%--%-
||||||||X|XXXX||X||--|XXX||--|XXXXX|--XXXXX||XXX|XXX-|X||X|X|||-X|X|X||X|---XXXXXXXXX|XXXX|--X-XXXX||XX|-X||X||XXXX-XX|XX-|||XX||X|XXXX-|-||X|X|||XX|-