------------------------------------------------------------------------------------------------------------------------------------------------------
------------------------------------------------------------------------------------------------------------------------------------------------------
------------------------------------------------------------------------------------------------------------------------------------------------------
------------------------------------------------------------------------------------------------------------------------------------------------------
------------------------------------------------------------------------------------------------------------------------------%-----------------------
----------------------------------------------------------------------------------------------------------------%-------------|-----------------------
----------------------------------------------------------------------------------------------------------------|-------------|-----------------------
----------------------------------------------------------------------------------------------------------------|-------------|-----------------------
----------------------------------------------------------------------------------------------------------------|-------------|-----------------------
------------------------------------------%--------%------------%---------------------%%------------------------|-------------|-----------------------
-------------------%%---------------------|----%-%-|------------|-------------%-------||----------------------%-|-----------%-|-----------------------
-------------------||--%------%-----------|----|-|-|%-----------|-------------|-------||----------------------|-|-----------|-|-----%-----%-----------
-------------------||-%|---%-%|---%-%%%---|----|-|-||---%-%-%--%|-------------|%-----%||--------------%--%----|-%-----------|-|-----|-----|-%---%-----
-----------%---%---||-||---|-||---|-|||--%|----|-|-||---|-|-|--||%------------||-----|||----%--------%|--|----|-|--------%--|%|%%-%-|-----|-|---|-----
%%%%%%%%%--|---|---||-||-%%|-||-%%|%|||--||----|-|-||---|-|-|-%|||--%---%-----||---%%|||-%--|--%----%||--|--%-|-|--------|%-|||||-|-%-----|%|---|-%---
|||||||||-X|X-X|-XX||-X|X|||X|XX|||||||-X||X-XX|X|X||XXX|X|X|X||||--|-XX|XXXXX||XX-||X||X|XX|XX|XX--|X|XX|--|X|-|-XXXXXXX||-|||||X|X|-XXXXX||-XX|X|XXX