------------------------------------------------------------------------------------------------------------------------------------------------------
------------------------------------------------------------------------------------------------------------------------------------------------------
------------------------------------------------------------------------------------------------------------------------------------------------------
------------------------------------------------------------------------------------------------------------------------------------------------------
------------------------------------------------------------------------------------------------------------------------------------------------------
------------------------------------------------------------------------------------------------------------------------------------------------------
------------------------------------------------------------------------------------------------------------------------------------------------------
------------------------------------------------------------------------------------------------------------------------------------------------------
------------------------------------------------------------------------------------------------%-----------------------------------------------------
------------------------------------------------------------------------------------%-----------|-----------------------------------------------------
----------%--------------------------------------------------------------------%----|----%------|-----------------------------------------------------
----------|--------------------------------------------------------------------|----|----|------|------%----------------------------------------------
----------|-----------%-%---------%---------------------%--------%-------------|-%--|----|----%-|------|---%%---%----------------------%%---------%---
----------|-----------|-|--%%-----|%----%-----------%-%-|-%----%-|-------------|%|-%|----|---%|-|------|---||---|----------------------||%%-------|---
%%%%%%%%%%|%-----%----|-|--||%%%--||----|%----------|-|-|-|--%-|-|---%------%%%|||-||--%-|---||-|--%---|---||---|%-------%-------%--%%-||||----%%-|---
||||||||||||XXX-X|X--X|X|XX|||||XX||XXXX||--XXXXXXXX|X|-|-|-X|-|X|XX-|XXXXXX||||X|X||--|-|XX-||-|--|-XXXXXX||XXX||XXXXXX-|XXXXXXX|--||X||||XXXX||X|XXX