------------------------------------------------------------------------------------------------------------------------------------------------------
------------------------------------------------------------------------------------------------------------------------------------------------------
------------------------------------------------------------------------------------------------------------------------------------------------------
------------------------------------------------------------------------------------------------------------------------------------------------------
-----------------------------%------------------------------------------------------------------------------------------------------------------------
-----------------------------|------------------------------------------------------------------------------------------------------------------------
-----------------------------|---------------------------------------------------------------------------------------------------------%--------------
-----------------------------|---------------------------------------------%-----------------------------------------------------------|--------------
-----------------------------|---------------------------------------------|-----------------------------------------------------------|--------------
-------------------------%---|---------------------------------------%-----|-----------------------------------------------------------|--------------
-------------------------|---|---------------------------------------|-----|----------------%------------------------------------------|--------------
-------------------------|---D---------------------------------------|-----|----------------|-----------------------------------t------|--------------
------------%----%---%--%|-------%%----------------------------%-----|-----|%--------%------|----%----%---%-%%----%%%-%-%-------T------|%-------------
--------%---|----|---|--||-------||%%%--%%%%%----------------%%|-----|-----||--------|%%%--%|----|%%--|---|%||----|||-|-|-%%%%%%%%%%---||-------%%----
%%%%%%%%|---|%---|---|--||%--%-%-|||||-%|||||-%--%----%------|||-----|%----||--------||||--||----|||--|-%-||||----|||-|-|%||||||||||---||%----%-||----
|||||||||X-X||XXX|XX-|-X|||-X|-|XX||||-||||||-|X-|XXXX|XXXXXX|||XX-XX||XXXX|XXXXXXX-X||||XX||XXXX|||X-|X|X||||XX--|||X|-X|||||||||||-XX|||XXXX|-||XXXX