------------------------------------------------------------------------------------------------------------------------------------------------------
------------------------------------------------------------------------------------------------------------------------------------------------------
------------------------------------------------------------------------------------------------------------------------------------------------------
------------------------------------------------------------------------------------------------------------------------------------------------------
------------------------------------------------------------------------------------------------------------------------------------------------------
------------------------------------------------------------------------------------------------------------------------------------------------------
------------------------------------------------------------------------------------------------------------------------------------------------------
-------------------------------------------------------------------------------D----------------------------------------------------------------%-----
------------------------------------------------------------------------------------------------------------------------------------------------|-----
-----------------------------------------------------------------------------------------------------%------------------------------------------|-----
----------------------------------------------------------%---------------------------C--------------|--%-----------------------------------%---|----%
----------------------------------------------------------|------------------------------------------|--|%-----------%-----------------%----|---|-%--|
----------------------%%-------------#---------%-%--------|-------------%%%------%%-%--------------%%|--||%-%---%%---|-%----%%-----%---|----|---|%|--|
---------------------%||%-----------%#---------|-|----%---|-----------%-|||%---%-||%|-----%--------|||%-|||-|%--||---|-|----||-----|---|----|-%-|||--|
%%%%%%%%%%%%--%%-%---||||%----------|%----%-%%-|%|----|---|-----------|-||||%--|-||||%%---|--%%----||||%|||%||%%||-%-|-|%%%-||-----|-%%|---%|-|-|||%%|
||||||||||||X-||X|XX-|||||XXXXXXXXXX||---X|X||X|||XXXX|XXX|X-X-XXX--XX|X|||||XX|X|X||||XXX|XX||XXXX|||||||||||||||X|XXX||||X||XXXXX|X|||--X||XXX||||||