------------------------------------------------------------------------------------------------------------------------------------------------------
------------------------------------------------------------------------------------------------------------------------------------------------------
------------------------------------------------------------------------------------------------------------------------------------------------------
------------------------------------------------------------------------------------------------------------------------------------------------------
------------------------------------------------------------------------------------------------------------------------------------------------------
------------------------------------------------------------------------------------------------------------------------------------------------------
------------------------------------------------------------------------------------------------------------------------------------------------------
------------------------------------------------------------------------------------------------------------------------------------------------------
------------------------------------------------------------------------------------------------------------------------------------------------------
-----------%------------------------------------------------------------------------------------------------------------------------------------------
-----------|----------------------------%------------------------------------------------------------------------------------------------------------%
-----------|---g------------------------|----------%-------------------------------------------%-----------------------------------------------------|
--------%%-|--------------------------%-|----------|%--------%%--------------------------------|-----%--%%%%--------%--%-----------%%----%------%----|
--------||%|-----%----%----%----------|-|----------||-%------||-------------%%%%--%%%-%%-------|-----|-%||||-------%|--|-----------||%%--|------|----|
%%%%%%%%||||%%---|----|----|-%%-------|-|----------||-|----%-||--%----------||||--|||-||-%-----|%----|-|||||-------||--|--------%--||||--|------|---%|
||||||||||||||XX-|XXXX|XXXX|X||-XXXXXX|-|XXXXXXXXXX||-|X-XX|X||XX|-XXXXXXXXX||||XX|||X||X|XXXX-||XXX-|XX||||--X-XXX||XX|XXXXXXX-|X-||||XX|---XXX|XXX||