------------------------------------------------------------------------------------------------------------------------------------------------------
------------------------------------------------------------------------------------------------------------------------------------------------------
------------------------------------------------------------------------------------------------------------------------------------------------------
------------------------------------------------------------------------------------------------------------------------------------------------------
-----------------------------------------------------------------------------------------------------------------------%------------------------------
-----------------------------------------------------------------------------------------------------------------------|------------------------------
------------------------------------------------%----------------------------------------------------------------------|------------------------------
-------------------------------------------%----|----------------------------------------------------------%-----------|------------------------------
-------------------------------------------|----|----------------------------------------------------------|-----------|------------------------------
-------------------------------------------|----|----------------------------------------------------------|-----------|------------------------------
---------------------------------------D---|----|-------------C-----------------------------------------%--|-----------|-%----------------------------
-------------------------------------------|----|---%------------------%------------------------------%-|--|-----------|-|----------------------------
---------------------%-----------%---------|----%---|-%-%--------------|------------------------------|-|--|-%------%--|-|--------%------%------------
---------------%%----|---%---%--%|-----%---%%---|---|-|-|--------------%-%-------------%---------%----|-|-%|-|------|--|-|----%--%|%%--%-|----%-------
%%%%%%%%----%--||----|---|---|--||%%%--|---||---|---|-|-|----%%---%----|%|----------%-%|--------%|%---|%|-||-|-%----|--|-|----|--||||--|-|----|-------
||||||||X-XX|XX||X-XX|XXX|X-X|XX|||||XX|XXX||XXX|-XX|X|X|-XXX||XXX|XXXXX||XXXXXXXXXX|X||X---X---|||-XX|||X||X|-|-XX-|XXXX|XXXX|XX||||--|X|-XXX|XXX-XXX