------------------------------------------------------------------------------------------------------------------------------------------------------
------------------------------------------------------------------------------------------------------------------------------------------------------
------------------------------------------------------------------------------------------------------------------------------------------------------
------------------------------------------------------------------------------------------------------------------------------------------------------
------------------------------------------------------------------------------------------------------------------------------------------------------
------------------------------------------------------------------------------------------------------------------------------------------------------
----------------------------------------------------------------------------------%--------------%----------------------------------------------------
----------------------------------------------------------------------------------|--------------|----------------------------------------------------
-------------------------------------------S------------------------------%-------|--------------|----------------------------------------------------
----------------------%-----------------%---------------------------------|-------|--------------|-------------------------------------------------%--
--------------------%-|-----------------|---------------------------------|-------|--------------|----------------------------------------------t--|--
------------%-------|%|-----------------|-------------------%-------------%-------|--------------|----------------------S-----------------------t--|--
-----------%|-%-----|||-----%-----------|--%------------%---|-------%--%--|-%-%---|----y---------%------%-----%-------------------------------%-t--|--
-----------||-|-----|||%----|----%-%----|--|---------%--|---|%------|-%|--|%|-|---|----%---------|------|-----|------%------------------------|-%--|-%
%%%%%%%%---||-|%----||||----|----|-|----|--|%--------|--|---||------|-||-%|||-|---|----|---------|---%--|-----|%%%---|--------%--%-----%------|-|--|-|
||||||||XXX||X||----||||XXXX|XXXX|X|----|XX||--X-----|XX|--X||XXXXX-|X||X|||XX|---|XXXX|XXXXXXX-X|XX-|XX|---XXX|||XXX|XXXXX-X-|X-|XXXX-|XXX-XX|X|XX|X|