------------------------------------------------------------------------------------------------------------------------------------------------------
------------------------------------------------------------------------------------------------------------------------------------------------------
------------------------------------------------------------------------------------------------------------------------------------------------------
------------------------------------------------------------------------------------------------------------------------------------------------------
------------------------------------------------------------------------------------------------------------------------------------------------------
------------------------------------------------------------------------------------------------------------------------------------------------------
------------------------------------------------------------------------------------------------------------------------------------------------------
------------------------------------------------------------------------------------------------------------------------------------------------------
------------------------------------------------------------------------------------------------------------------------------------------------------
---------------------------------------------------------t--------------------------------------------------------------------------------------------
----------%-----------------------%------------%---------t-----------------------------------------%--------------------------S-------------S---------
----------|-----------------------|------------|%--%-----t-------k---------------------------------|--------------------------------------------------
---------%|-------------%---------|------%%--%%||--|-----%----%--|--%--%---------------------------|-------------%------%-----------------------------
---------||-------%-----|---------|%-----||--||||--|-%---|----|--|--|--|%-----%%%%%%-%%%--------%--|%---%-----%%-|%-----|-----%----------%---%-%--%---
%%%%%%%%-||%%-%%--|-----|---------||-----||--||||--|-|---|----|--|--|--||-----||||||-|||---%---%|--||--%|---%-||-||-----|-----|--------%-|--%|-|%-|---
||||||||-||||X||XX|---XX|XXXXX-XXX||X-XX-||XX|||XXX|X|XX-|XXXX|XXXXX|XX||X-XXX||||||X|||XXX|XXX||XX||-X||XXX|-||X||XXX-X|XXXXX|--XXXXX-|XXXX||XX|X|X-X