------------------------------------------------------------------------------------------------------------------------------------------------------
------------------------------------------------------------------------------------------------------------------------------------------------------
------------------------------------------------------------------------------------------------------------------------------------------------------
------------------------------------------------------------------------------------------------------------------------------------------------------
------------------------------------------------------------------------------------------------------------------------------------------------------
------------------------------------------------------------------------------------------------------------------------------------------------------
------------------------------------------------------------------------------------------------------------------------------------------------------
------------------------------------------------------------------------------------------------------------------------------------------------------
-----------------------------------%--------%-------------------------------------------------------------%%------------------------------------------
-----------------------------------|--------|-------------------------------------------------------------||------------------------------------------
-----------------------------------|--------|-------------------------------------------------------------||------------------------------------------
-----------------------------------|--------|-------%-----------------------------------------------------||------------------------------------------
-----------%%--------%---%%--------|--%%%---|-------|--------%%----------------%-------%%-----------------||-----%-----------%-------------%----------
-----------||--------|r--||---%----|--|||%%-|-------|--------||----------------|-------||---%-----%-------||-%-%-|---------%%|------%---%%-|----------
%%%%%%%%---||%%%-----|---||---|%%--|--|||||-|-------|-%%-----||--------------%-|-%%%---||%%-|-----|-------||-|-|-|---------|||----%-|---||-|----%-----
||||||||XXX|||||XXXXX|X--||-XX|||XX|XX|||||X|-XXXXXX|X||XXXXX||-XXXX-X-XXXXXX|X|-|||XXX|X||X|X--XX|XXXXXXX||-|X|X|XXX--XXXX|||X-X-|X|X--||X|X-XX|-X--X