------------------------------------------------------------------------------------------------------------------------------------------------------
------------------------------------------------------------------------------------------------------------------------------------------------------
------------------------------------------------------------------------------------------------------------------------------------------------------
------------------------------------------------------------------------------------------------------------------------------------------------------
------------------------------------------------------------------------------------------------------------------------------------------------------
------------------------------------------------------------------------------------------------------------------------------------------------------
------------------------------------------------------------------------------------------------------------------------------------------------------
---------------------------------------------------------------------------------------S--------------------------------------------------------------
--------%--------------------------------------------%--------------%---------------------------------------------------------------------------------
--------|--------------------------------------------|--------------|-----------------------------------------------S-------------%-------------------
--------|--------------------------------------------|--------------|---------------------C---------------------------------------|-------------------
--------|---------%%---------------------------------|--------------|----%---------------S----------------------------------------|-------------------
--------|-%-------||-------------------%%-%%-------%-|%%%--#--%---%-|--%-|----------%%-------------------%--------%-%--------%----|--------%----------
--------|-|----%%%||-----%--%----------||-||-%--%--|-||||--%--|%%%|-|--|-|-%--%-%---||-%-----------------|--------|-|%%%%--%%|----|--------|----%-----
%%%%%%%%|-|%---|||||---%-|%%|----------||%||-|--|--|-||||--|--|||||%|%-|%|-|%%|-|%--||-|--%---%----------|--------|-|||||--|||----|%%%%-%--|---%|----%
|||||||||X||-XX|||XX-X-|X||||X---XXXX--|||||X|X-|XX|X||||XX|--||||||||X|||X||||X||XX||X|XX|X--|XXX-XXXXXX|-XX-X---|-|||||XX|||--XX|||||X|--|--X||-XX-|