------------------------------------------------------------------------------------------------------------------------------------------------------
------------------------------------------------------------------------------------------------------------------------------------------------------
------------------------------------------------------------------------------------------------------------------------------------------------------
------------------------------------------------------------------------------------------------------------------------------------------------------
------------------------------------------------------------------------------------------------------------------------------------------------------
------------------------------------------------------------------------------------------------------------------------------------------------------
------------------------------------------------------------------------------------------------------------------------------------------------------
------------------------------------------------------------------------------------------------------------------------------------------------------
-----------------------------------------------------------------------------------------------------------------------g-------S----------------------
------------------------------------------------------------------------------------------------------------------------------------------------------
------------------------------------------------------------------------------------------------------------------------------------------------------
---------------------------------------------------------------%----------------------------------------%---------------------------------------------
-------------------%%%-%%-%-------%---%%------------------%----|--%-------------------------%-----------|-%-------------------S%---%--%-------%-------
---------------%---|||-||-|-------|%%%||---------%---%----|----|%-|------%----%-%%%%%%-----%|-----------|-|------%------%--%%--|%%-|--|-------|-------
%%%%%%%%-------|-%-|||-||-|-%%%---||||||---------|---|%---|---%||-|-%%---|----|-||||||-----||-----------|%|------|------|%-||--|||-|--|----%--|------%
||||||||----X--|X|X|||X||X|X|||XX-||||||XX----XXX|XXX||XX-|XXX|||X|X||XXX|--XX|-||X|||X----||XX---XXXXXX|||XXXXXX|XXX---||X||XX|||X|XX|XXXX|XX|XXXXXX|