------------------------------------------------------------------------------------------------------------------------------------------------------
------------------------------------------------------------------------------------------------------------------------------------------------------
------------------------------------------------------------------------------------------------------------------------------------------------------
------------------------------------------------------------------------------------------------------------------------------------------------------
--------------------------------------------------------------------------------------------------------D---------------------------------------------
------------------------------------------------------------------------------------------------------------------------------------------------------
-------------D----------------------------------------------------------------------------------------------------------------------------------------
------------------------------------------------------------------------------------------------------------------------------------------------------
------------------------------------------------------------------------------------------------------------------------------------------------------
-----------------------t-----------------------------------%----------------------------------%---------D---------------------------------------------
-----------------------t-----------%-----------------------|-%--------------------------------|-------------------------------------------------------
-----------------------t-----------|---------------S-------|-|--------------------------------|-------------------------------------------------------
--------%----%---------%%---------%|----------------%--%---|-|%-----%-----%----%-------%-----%|---------------%--%-----%%%%-%----%------------%%--%---
--------|%%--|--------%||------2--||-----------%%---|--|--%|-||-----|--F--|----|-------|-----||--------------%|--|-----||||-|----|---%-----%--||--|---
%%%%%%%%|||--|-----%%%|||---------||--%--%--%--||-%-|--|--||-||-----|--%-%|-%--|%%%----|-----||-----%-----%--||-%|----%||||%|--%-|-%-|-----|--||--|---
|||||||||||XX|X--XX||||X|XXXXX-XXX||XX|XX|--|--||X|X|XXX--||X||-XXXX|XX|X||X|-X||||XXXX|XX--X||-X-XX|-XXXX|--||X||XXX-||||X||XX|-|X|X|XXXXX|X-||XX|XXX