------------------------------------------------------------------------------------------------------------------------------------------------------
------------------------------------------------------------------------------------------------------------------------------------------------------
------------------------------------------------------------------------------------------------------------------------------------------------------
------------------------------------------------------------------------------------------------------------------------------------------------------
------------------------------------------------------------------------------------------------------------------------------------------------------
---------------------------------------------------------------------------------------------------------------------------%--------------------------
---------------------------------------------------------------------------------------------------------------------------|--------------------------
---------------------------------------------------------------------------------------------------------------------------|---------------------%----
----------------%----------------------------------------------------------------------------------------------------------|---------------------|----
----------------|-------------------------------------------------%------------------%-------------------------------------|---------------------|--%-
----------------|----------------------------------%-----------%--|------------------|-------------------------------------|---------------------|--|-
-------------%--|--------------------------------%%|-----------|--|------------------|-------------------------------------|---------------------%--|-
----------%--|--|-%%%-%--%-----------------------|||-----------|--|--------%---------|-----------------------------%-------%%--------%-----------|--|-
----------|--%--|-|||-|%-|----------%-------%--%%|||-%-----%%--|--F--------|---------|---------------------%-------|-------||--%---%-|-----------|--|-
%%%%%%%%--|--|-%|-|||-||-|----------|-------|--|||||%|--%-%||--|%-%%---%%-%|---------|---------%%%---------|-------|-------||--|-%-|-|------%----|--|-
||||||||XX|XXXX||X|||-||X|XXXXX-XXXX|XXXXXXX|XX|X|||||XX|X|||XX||-||-X-||X||XXXXXXXXX|-XXX-X-XX|||X--XXXXX-|X-XXXXX|XXXXX-X|XXX|X|X|X|X-XXXX|XXXX|XX|X