------------------------------------------------------------------------------------------------------------------------------------------------------
------------------------------------------------------------------------------------------------------------------------------------------------------
------------------------------------------------------------------------------------------------------------------------------------------------------
------------------------------------------------------------------------------------------------------------------------------------------------------
------------------------------------------------------------------------------------------------------------------------------------------------------
---------------------------------D--------------------------------------------------------------------------------------------------------------------
------------------------------------------------------------------------------------------------------------------------------------------------------
----------------------------------------------------------------------------------------------------------%-------------------------------------------
----------------------------------------------------------------------------------------------------------|-------------------------------------------
------------------------------------------------------------------%---------------------------%-----------|-------------------------------%-----------
----------------------S-------------------------------------------|---------------------------|-----------|----------------------%--------|-----------
---------------------------------%--------------------------%%----|---------------------------|-----------|----------------------|--------|-%----g----
----------------------------%%--%|------%---------%-----%---||%%--|%--------------------------|------%--%%|----------------------|---%----|-|---------
--------%-------------y-----||%-||------|---------|-%%--|-%-||||--||----%-----------------%%--|------|--|||-%%-%%-%-----%--------|%--|----|-|%--g-----
%%%%%%%%|%-%%---%-----%%----|||-||-%---%|%----%---|-||--|-|-||||%-||----|-----------------||--|------|--|||-||%||-|%%%-%|--------||--|%---|-||--------
||||||||||-||XX-|XXXXX||X--X|||X||X|XXX|X|XXXX|X-X|X||-X|XXX|||X|-||XX--|XXXXXXXXX--X-XXXX||XX|XXXXXX|X-|||-|||||X||||X||XX-X-XXX||XX||X--|X||XXXXXXXX