------------------------------------------------------------------------------------------------------------------------------------------------------
------------------------------------------------------------------------------------------------------------------------------------------------------
------------------------------------------------------------------------------------------------------------------------------------------------------
------------------------------------------------------------------------------------------------------------------------------------------------------
------------------------------------------------------------------------------------------------------------------------------------------------------
------------------------------------------------------------------------------------------------------------------------------------------------------
---------------------------%--------------------------------------------------------------------------------------------------------------------------
---------------------------|--------------------------------------------------------------------------------------------------------------------------
---------------------------|--------------------------------------------------------------------------------------------------------------------------
---------------------------|--------------------------------------------------------------------------------------------------------------------------
---------------------------|-----------------------------%--------------------------------------------------------------------------------------------
-----------%---------------|----------------U------------|--------------------------------------------------------------------%%-------------------%--
-----------|-----------%---|-----------------------------|---------%-%----------%----%-----%----------------%-----------------||----%-%------%----%|--
-----------|-----------|%%-|-----------------------%-----|---------|%|----%-----|----|----%|--------------%-|%----------------||----|-|------|--%-||--
%%%%%%%%---|----%------|||-|%----------------%%%---|-----|---------|||----|-----|-%--|%---||--%--%--------|-||-----%----------||----|%|--%--%|--|-||--
||||||||X--XXX-X|X-XX-X|||X||XXX-XXXX-XXX-XXX|||--X|XXXXX|XXXXXXXXX|||X--X|XXXXX|X|XX||X--||--|XX|XXXXXXXX|X||XXXXX|XXXXXX-XXXXXXXXX|||--|XX||XX|X||XX