------------------------------------------------------------------------------------------------------------------------------------------------------
------------------------------------------------------------------------------------------------------------------------------------------------------
------------------------------------------------------------------------------------------------------------------------------------------------------
------------------------------------------------------------------------------------------------------------------------------------------------------
------------------------------------------------------------------------------------------------------------------------------------------------------
------------------------------------------------------------------------------------------------------------------------------------------------------
------------------------------------------------------------------------------------------------------------------------------------------------------
-------------------------------------------------------------------------------------------------------------------------------------%----------------
---------------------------%---------------------------------------------------------------------------------------------------------|----------------
----------%---%------------|--------------------%------------------------------------------------------------------------------------|----------------
----------|---|------------|--------------------|----%-------------------------------------------------------------------------------|----------------
----------|---|------S-----|--------------------|--t-|---------------------------------------------%------------%--------------------|%---------------
----------|---|---%--------|-%%-----%--%----%---|-%t-|--------%%-------------------------%---%-----|%------%----|---%%---------------||---%-%---%%-%--
----------|---|-%-|--------%-||-----|--|S---|---|-|%-|----%---||%----------%-------------|---|-----||------|----|---||-----------%%--||---|-|---||%|--
%%%%%%%%%%|%-%|-|%|%-------|-||-----|-%|----|--%|-||-|----|---|||-------%--|---%---%-----|---|%----||-%%%--|----|%--||%-%--------||--||--%|-|---||||-%
||||||||||||X||X||||-XX-XXX|XX|X--XX|-||XXXX|XX||X||-|X-XX|-XX||XXXXXX-X|--|---|X-X|--XXX|X--||XXXX||X|||XXXXXXXX|--X||X|XXXXXXXX||XX||XX||X|XXX||||X|