------------------------------------------------------------------------------------------------------------------------------------------------------
------------------------------------------------------------------------------------------------------------------------------------------------------
------------------------------------------------------------------------------------------------------------------------------------------------------
------------------------------------------------------------------------------------------------------------------------------------------------------
------------------------------------------------------------------------------------------------------------------------------------------------------
------------------------------------------------------------------------------------------------------------------------------------------------------
---------------------------------------------------------%--------------------------------------------------------------------------------------------
---------------------------------------------------------|--------------------------------------------------------------------------------------------
---------------------------------------------------------|--------------------------------------------------------------------------------------------
-----------------------%-----%---------------------------|--------------------------------------------------------------------------------------------
-----------------------|-----|---------------------------S--------t-----------------------------------------------------------------------------------
-----------------------|-%---|------------------------------------t---%-------------------------------------------------------------------------------
-----------------------|-|---|-------%---%--%-%-----%--------%----t---|------%--------------------%--%--%---------------%----------------%--%--%-%%---
------------------%%---|-|%--|--%-%%-|%%%|-%|-|-----|----%---|----%---|---%--|%---%------%-%------|--|-%|------#--------|-------------%%-|--|--|-||-%-
%%%%%%%%%%--------||-%-|-||--|--|-||-|||||-||-|-----|--%-|---|----|---|---|-%||-%-|------|-|------|--|-||-%-%-%%----%%--|--%-%%-------||-|--|%-|%||-|-
||||||||||XXXXXXXX||X|-|X||XX|XX|X||-|||||-||X|XXX--|-X|X|XXX|XXXX|XXXXXXX|X|||X|X|XXXXXX|X|XXX-XX|-F|-||X|-|X||XXXX||XX|-X|X||XXXXXXX||X|XX||X||||-|X