------------------------------------------------------------------------------------------------------------------------------------------------------
------------------------------------------------------------------------------------------------------------------------------------------------------
------------------------------------------------------------------------------------------------------------------------------------------------------
------------------------------------------------------------------------------------------------------------------------------------------------------
------------------------------------------------------------------------------------------------------------------------------------------------------
------------------------------------------------------------------------------------------------------------------------------------------------------
------------------------------------------------------------------------------------------------------------------------------------------------------
------------------------------------------------------------------------------------------------------------------------------------------------------
------------------------------------------------------------------------------------------------------------------------------------------------------
--------------------------------------------------------------------------------------------------------------------%---------------------------------
--------------------------D-----------------------------------------%-----------------------------------------------|---------------------------------
----------------%----------------------------------------------%----|--------------------------g------------------%-|-----------------%---------------
---------%-----%|-------------%---------%----------------------|-%--|----%---------------------%------------------|-|-----------%%----|---%-----------
---------|%----||---------%---|--------%|%---------%-----------%-|--|----|-----------%%%-------|------------%-%%--|-|-%--%%%%---||--%%|---|-----%-----
%%%%%%%%%||-%--||%-%------|--%|--%-----|||-------%-|-%-------%-|-|-%%%%%-|-----------|||--%%---|-----%------|-||--|-|-|--||||---||--|||-%-|-----|-----
|||||||||||X|XX|X|-|XXXXXX|XX||X-|XX-XX||XXXXXXXX|-|X|XXXXXX-|X|X|-|||||X|X--XXXX-X--|||-X||XXXXXXXXX|XXX-XX|-||-XXX|X|-X|XX|X-X||X-|||-|X|X----|X-XXX