------------------------------------------------------------------------------------------------------------------------------------------------------
------------------------------------------------------------------------------------------------------------------------------------------------------
------------------------------------------------------------------------------------------------------------------------------------------------------
------------------------------------------------------------------------------------------------------------------------------------------------------
-----------------------------------------------------------------------------------------------------------------------S------------------------------
------------------------------------------------------------------------------------------------------------------------------------------------------
------------------------------------------------------------------------------------------------------------------------------------------------------
-----------------------------------------------------------------------------------------------------------------------%------------------------------
-----------------------------------------------%-----------------------------------------------------------------------|------------------------------
----------------%------------------------------|-----------------------------------------------------------------------|---------%--------------------
----------------|--%---------------------------|-----------------------------------------------------------------------|---------|--------------------
-------------%--|--|---------------------------|-------------------------------%--------%------------------------------|---------|--------------------
----------%%-|--|--|------------------------%--|-----------%-------------------|--------|%-------%---------------------|------%--|-%%----%-%----------
----------||-|--|--|-%-----%----%-------%---|%-|--------%%-|%-----------%------|-------%||-------|%%%--%-----------%%-%%-----%|--|-||----|-|%---------
%%%%%%%%--||-|--|-%|%|-%---|%---|-%-%---|--%||-|-------%||%||-----------|%--%--|%---%--|||----%-%||||--|-----------||-||--%-%||-%|-||----|-||---%%---%
||||||||XX||-X--|X||||X|XXX||X--|X|X|XXX|XX|||X|XXXXXXX||||||X-XXXXXX--XX|--|XX||-X-|--|X|-XXX|X|||||XX|-XXXXXXXXXX||XX|XX|X|||-||X||-XXX|X||XXX||XXX|