------------------------------------------------------------------------------------------------------------------------------------------------------
------------------------------------------------------------------------------------------------------------------------------------------------------
------------------------------------------------------------------------------------------------------------------------------------------------------
------------------------------------------------------------------------------------------------------------------------------------------------------
------------------------------------------------------------------------------------------------------------------------------------------------------
------------------------------------------------------------------------------------------------------------------------------------------------------
------------------------------------------------------------------------------------------------------------------------------------------------------
------------------------------------------------------------------------------------------------------------------------------------------------------
----------------------------------%-------------------------------------------------------------------------------------------------------------------
----------------------------------|---%-----------------------------------------------------------------------------------------------------%---------
---------------------------%------|---|-----------------------------------------------------------------------------------------------------|-%-------
---------------------------|%---%-|---|-----------%----------------------------------%-------------------------------%C-----%%--------------|-|-------
----------------%----------||---|-%---|-----------|---------%-----------%------%----%|%%-------%--%------------------|------||-------%------|-|%------
----------%----%|----------%|---|-|---|-----------|---------|---%-----%%|%-----|-%%%||||-------|%-|--%----%----------|-----%||%--%--%|---%--|-||%-----
%%%%%%%%--|---%%|-------%--||---|%|%-%|-----------|-%-------|%--|%%%--||||-----|-|||||||----%--||-|-%|-%--|--%---%--%|----%||||--|--||---|--|%|||-----
||||||||-X|XXX|||XXXX-XX|XX|XXXX||||X||X--XXX--X--|X|XXXXXXX||X-||||XX||||XXXXX|X||||X||X---|X-X|-|X||X|-X|XX|XXX|XX||X-XX|||||XX|X-||XX-|XX|||||XXX--