------------------------------------------------------------------------------------------------------------------------------------------------------
------------------------------------------------------------------------------------------------------------------------------------------------------
------------------------------------------------------------------------------------------------------------------------------------------------------
------------------------------------------------------------------------------------------------------------------------------------------------------
------------------------------------------------------------------------------------------------------------------------------------------------------
------------------------------------------------------------------------------------------------------------------------------------------------------
------------------------------------------------------------------------------------------------------------------------------------------------------
--------------------------------------------------------------------------------------------------------------------------------------%---------------
--------------------------------------------------------------------------------------------------------------------------------------|---------------
-----------------------------------------------------------------------------------------------------%--------------------------------|---------------
----------------------------------------------------------------------------------------------%------|--------------------------------|---------------
-----------------------------------%-------------------------%%-----------------------S-------|------|----%-----%%--------------------%---------------
---------%-------------%%--%-------|------------%--%---------||-%------------------%---%------|------|-%--|-%---||------------------%-|%----------%%-%
---------|-----------%%||--|--%%---|--%---------|-%|---------||-|--------%----%--%-|---|%G----|------|-|--|-|---||------------%--%%-|%||%-------%-||-|
%%%%%%%%-|-----------||||--|--||-%-|-%|%%----%%%|%||%%%------||-|---%---%|---%|--|-|---||%----|-%----|-|--|-|---||------------|--||%|||||-------|-||-|
||||||||X|-XX-XX-XXXX|X||XX|X-||X|X|X||||XXX-|||||X||||-XXXXXX|X|XXX|-XX||XXX||X-|-|XXX|||XXXX|X|XXXX|X|-X|X|X--||XXXXXXXXXXXX|XX||||||||XX--XXX|XX|-|