------------------------------------------------------------------------------------------------------------------------------------------------------
------------------------------------------------------------------------------------------------------------------------------------------------------
------------------------------------------------------------------------------------------------------------------------------------------------------
------------------------------------------------------------------------------------------------------------------------------------------------------
------------------------------------------------------------------------------------------------------------------------------------------------------
-------------------------------------D----------------------------------------------------------------------------------------------------------------
------------------------------------------------------------------------------------------------------------------------------------------------------
------------------------------------------------------------------------------------------------------------------------------------------------------
---------------------------------------------------------------------------------------------------------------------------%--------------------------
--------------------------------------------------------------------------------------%------------------------------------|--------------------------
-------------------------g--%---------------------------------------------------------|------------------------------------|--------------------------
----------------------%-----|-------%%------------------------------------------------|------------------------------------|--------------------------
----------------------|---%-|-------||----------------------------------%---%---------|---%-%%-------%-%%----%-------------|------------%--------%--%%
----------------------|---|%|%------||-S-----------%------------------%-|---|-%-------|---|-||------%|-||%%-%|------%%-----|----%%------|--------|--||
%%%%%%%%---%%--------%|--%||||------||-------------|-----%%%%----%----|%|---|-|------%|---|-||------||-||||-||%----%||----%|----||------|------%%|--||
||||||||XXX||XXX-XXXX|XXX|||||X-X-XXX|XXXXXXXXXXXXX|XXXXX||||XXXX|XX-X|||-XX|-|X--X-X||-XX|-||XXXXX-||X||||X|||XXXX||XXXXX||--XX||XXXXX-|XXXX--|||XX||