------------------------------------------------------------------------------------------------------------------------------------------------------
------------------------------------------------------------------------------------------------------------------------------------------------------
------------------------------------------------------------------------------------------------------------------------------------------------------
------------------------------------------------------------------------------------------------------------------------------------------------------
------------------------------------------------------------------------------------------------------------------------------------------------------
-------------------------------------------------------S----------------------------------------------------------------------------------------------
-------------------------------------------------%------------------------%---------------------------------------------------------------------------
-------------------------------------------------|------------------------|---------------------------------------------------------------------------
-------------------------------------------------|------------------------|---------------------------------------------------------------------------
-------------------------------------------------|-----%------------------|---------------------------------------------------------------------------
----------------------%--------------------------|-----|------------------|------------%-------------------------------------------%------------------
-----------%----------|--------------------------|-----|------------------|------------|---------------------------%---------------|-%--------g-------
-----------|--%----%--|%------------------------%|--%--|---%--------------|-----%---%--|%-%----%-%---%---%---%-----|------%%%---%--|-|%---------------
-----------|--|----|--||------------------------||--|--|---|--------------|--%--|---|--||-|%---|-|---|---|---|-----|------|||---|--|-||-------------%-
%%%%%%%%%--|--|----|-%||----%-------------------||--|%-|---|--------------|--|--|---|-%||-||---|-|---|%%%|%--|-----|-%----|||---|--|%||---------%---|%
|||||||||XXXX-|---X|X|||XXXX|XXXXXXXXXXX-XXXX--X||XX||X|X--|XX-XXX-X--XXXX|XX|-X|XXX|-|||-|XX-X|X|-XX||||||XX|--X-X|X|-XXXX||X-X|--||||XXXXXXXX-|X-XX|