------------------------------------------------------------------------------------------------------------------------------------------------------
------------------------------------------------------------------------------------------------------------------------------------------------------
------------------------------------------------------------------------------------------------------------------------------------------------------
------------------------------------------------------------------------------------------------------------------------------------------------------
------------------------------------------------------------------------------------------------------------------------------------------------------
------------------------------------------------------------------------------------------------------------------------------------------------------
------------------------------------------------------------------------------------------------------------------------------------------------------
-------------------------------------------------------------------------------------------%----------------------------------------------------------
-------------------------------------------------------------------------------------------|----------------------------------%------------------%----
--------------------------------------%----------------------------------------------------|----------------------------------|------------------|----
--------------------------------------|--------------------------------------%-------------|------g---------------------------|------------------|----
--------------------------------------|--------------------------------------|-------------|----------------------------------|------------------|----
----------------------------%---------|------%-----------%-------------------%----%--------|----------%-%---------%--%----%%%-|-----%-----%------|----
---------------------%-----%|--g---%-%|-----%|----%--%%--|----%----%---%-%%--|-%--|-%--%-%-|%-%-------|-|------%--|--|%---|||-|-----|--%--|----%%|-%--
%%%%%%%%%------------|-----||-%-%%-|%||-----||----|--||%-|----|----|--%|-||--|-|--|-|--|-|-||%|-------|-|%%----|%-|--||%--|||-|%%---|%%|--|----|||%|--
|||||||||XXXXXXXXXXXX|XX-XX||X|X||-||X|XXXXX||XXXX|XX|||X|X--X|XXXX|XX||-||X-|X|X-|X|XX|X|X||||XX--XXX|X|||XXXX||-|XX|||XX|||X|||XXX||||XX|-XX-|||||XX