------------------------------------------------------------------------------------------------------------------------------------------------------
------------------------------------------------------------------------------------------------------------------------------------------------------
------------------------------------------------------------------------------------------------------------------------------------------------------
------------------------------------------------------------------------------------------------------------------------------------------------------
------------------------------------------------------------------------------------------------------------------------------------------------------
------------------------------------------------------------------------------------------------------------------------------------------------------
------------------------------------------------------------------------------------------------------------------------------------------------------
------------------------------------------------------------------------------------------------------------------------------------------------------
-----------------------------------------------------------------------------------------------------S------------------------------------------------
------------------------------------------------------------------------------------------------------------------------------------------------------
-------------%----------------------%-----------------------------------------------t-----S---%------------------------%------------------------------
-------------|----------------------|%----------------------%----------------%---%--t----S---%|-----%------------------|------------------------------
-------------|---------------------%||-------------%--------|%%--------------|---|-%t--------||--%--|%-----------------|---------------------------%--
------------%|-----%-----------%---|||-------------|%-------|||--%-----------|---|-|%-----%--||--|--||---------%%--%---|--%--%----------------%----|--
%%%%%%%%----||-----|%%------%--|---|||-%-%-%-------||--%----|||-%|-%----%--%%|%-%|-||%%-%-|--||%-|--||-------%%||--|---|--|--|----------------|----|--
||||||||XXXX||XXXXX|||XX--XX|XX|XXXX||X|X|X|XXXXXXXX|XX|--XX|||X||X|XX-X|--||||X||X||||X|X|XX|||X|X-X|XX-XXXX||||--|XXX|XX|--X-XX-XXXXXXXXXXXX|-X-X|XX