------------------------------------------------------------------------------------------------------------------------------------------------------
------------------------------------------------------------------------------------------------------------------------------------------------------
------------------------------------------------------------------------------------------------------------------------------------------------------
------------------------------------------------------------------------------------------------------------------------------------------------------
------------------------------------------------------------------------------------------------------------------------------------------------------
-------------------------------------------------------------------------------------------------------t----------------------------------------------
-------------------------------------------------------------------------------------------------------t----------------------------------------------
-------------------------------------------------------------------------------------------------------t----------------------------------------------
------------D----------r-------------------------------------------------------------------------------%---%------------------------------------------
---------------------%-------%-------------------------------------------------------------------------|---|------------------------------------------
--------------------%|-%-----|-------------------------------------------------------------%-----------|---|-------------------------------------%%---
---------%--%-------||-|-----|------------%----------------------%-------------------------|----------%|---|-----------------------%-------------||---
---------|--|---%---||%|----%|-------%----|----%---%--%-%--------|-------%--%%%-%----------|%---------||---|-------%%%---%---------|-------------||---
---------|--|--%|--%||||----||#------|----|---%|---|--|-|--------|-%-----|--|||-|--%---%%--||----%----||---|-------|||---|-----%-%-|---------%---||--%
%%%%%%%%-|--|--||--|||||----||%--%---|---%|---||%--|--|-|%-------|-|%----|--|||-|--|--%%|--||----|----||---|-------|||%--|---%-|-|%|--%%-----|---||--|
||||||||X|XX|XX||XX|||||XX--|||XX|--X|XXX||XXX|||XX|XX|X||X-XXXX-|X||XXXX|XX|||-|XX|--|||XX||XXXX|X-XX||X-X|XXXXXXX||||XX|X--|-|-X||XX||XXX-X|X-X||XX|