------------------------------------------------------------------------------------------------------------------------------------------------------
------------------------------------------------------------------------------------------------------------------------------------------------------
------------------------------------------------------------------------------------------------------------------------------------------------------
------------------------------------------------------------------------------------------------------------------------------------------------------
------------------------------------------------------------------------------------------------------------------------------------------------------
---------------------------------------------------------------------------------------------------------------------------------------------------t--
---------------------------------------------------------------------------------------------------------------------------------------------------t--
------------------------------%-----------------%---------------------------------------------------------------------------------%----------------t--
------------------------------|-----------------|---------------------------------------------------------------%-----------------|----------------%--
------------------------------|-----------------|---------------------------------------------------------------|-----------------|----------------|--
--------------------------%---|-----------------|---------%-----------------------------------------------------|-----------------|----------------|--
---------%--%-------------|---|-----------------|--K------|-----------S----------------%------------------------|-----------------|-----------%----|--
---------|%-|-------------|---|-----%%-------%--|--%------|----------------------------|--#---------------------%-%-%%U----%---%-%|%----------|%%-%|--
---------||-|----%--%%---%|%%-|--%--||-------|%-|--|--%---|-%--------------------------|--%----%-----%--%--%---%|-|-||----%|---|-|||----------|||-||--
%%%%%%%%-||-|%--%|--||---||||-|--|--||---%---||-|%-|--|---|-|-----------%%----%---%----|--|----|-----|-%|--|---||%|-||----||---|-|||----------|||-||%-
||||||||X||-X|X-|XXX||XX-||||X|XX|XX||-XX|XX-||X||-|XX|XXX|XX-XXXXXXXXXX||-XXX|X-X|X---|XX|XXXX|---X-|-||XX|XXX||||X||X--X||XXX|-|||XXXXXXXXXX|||X|||X