------------------------------------------------------------------------------------------------------------------------------------------------------
------------------------------------------------------------------------------------------------------------------------------------------------------
------------------------------------------------------------------------------------------------------------------------------------------------------
------------------------------------------------------------------------------------------------------------------------------------------------------
------------------------------------------------------------------------------------------------------------------------------------------------------
-----------------S------------------------------------------------------------------------------------------------------------------------------------
------------------------------------------------------------------------------------------------------------------------------------------------------
------------------------------------------------------------------------------------------------------------------------------------------------------
---------%----------------------------------------------------------------------------------------------------------------------------------------S---
---------|-------------------------------------------------------%%--%--------------------------------------------------------------------------------
---------|-------------------------------------------------------||--|--------------------------------------------------------------------------------
---------|-------------------------------------------------------||--|----------%-------------------%-------------------%-----------------------------
---------|------%-----%--%%-%%------------------------%----%%%---||--|%--------%|%%%----------------|-------------------|--%--%%%----%-----%%-----%--%
---------|------|%----|--||-||-------%%---%%%%%%------|S%--|||---||--||--%-----|||||%------%------%-|--------%----------|--|--|||%---|--%--||-----|-%|
%%%%%%%%-|%%----||----|--||-||%-%%%%-||---||||||------|-|-%|||---||%-||--|-%--%||||||------|------|-|-------%|%-%---%-%-|--|--||||---|--|--||%--%%|-||
||||||||-|||XXXXX|----|XX||-|||-||||X||XXX||||||X--X-XXX|X||||XXX|||X||XX|-|--|||XXX|XXXX--|XX-XXX|-|XXXXXXX|||X|---|X|X|XX|XX||||XXX|XX|X-|||XX|||X||