------------------------------------------------------------------------------------------------------------------------------------------------------
------------------------------------------------------------------------------------------------------------------------------------------------------
------------------------------------------------------------------------------------------------------------------------------------------------------
------------------------------------------------------------------------------------------------------------------------------------------------------
------------------------------------------------------------------------------------------------------------------------------------------------------
------------------------------------------------------------------------------------------------------------------------------------------------------
------------------------------------------------------------------------------------------------------------------------------------------------------
-------------------------------%------------------------------------------------------------------------------------------------------------------%---
-------------------------------|------------------------------------------------------------------------------------------------------------------|---
-------------------------------|------------------------------------------------------------------------------------------------------------------|---
-------------------------------|-----------------%%------------%------------------------t---------------------------------------------------------|---
-------------------------------|-----------------||-t----------|------------------------t--------------%------------------------------------------|---
----------%--%%----------------|%----------%-----||-t------t---|------%%--%---%---------t----%%--%-----|---------%%--%%%%------%%----%%%-%---%---%|---
----------|--||-%%-------------||-----%%--%|%----||-%-%%-%-t---|---%--||--|---%%--------%----||--|-----|---------||-%||||--%---||----|||-|---|---||---
%%%%%%%%--|--||%||---%-------%%||-----||--|||----||-|%||-|-t--%|---|--||--|-%-||--------|%---||%%|--%--|----%----||-|||||--|---||----|||-|%--|-%%||---
||||||||XX|XX|||||XXX|-XXXXX-||||XXXXX||XX|||-XXX||X||||X|XXXX||XXX|XX||X-|X|XX|X----XXX||X--|||||XX|X-|XXXX|X---||X|||||XX|-XX||XXX-|||X||--|X||||XXX