------------------------------------------------------------------------------------------------------------------------------------------------------
------------------------------------------------------------------------------------------------------------------------------------------------------
------------------------------------------------------------------------------------------------------------------------------------------------------
------------------------------------------------------------------------------------------------------------------------------------------------------
------------------------------------------------------------------------------------------------------------------------------------------------------
------------------------------------------------------------------------------------------------------------------------------------------------------
------------------------------------------------------------------------------------------------------------------------------------------------------
------------------------%-------------------------------------------------------%---------------------------------------------------------------------
------------------------|-------------------------------------------------------|----------------------%----------------%-----------------------------
------------------------|-------------------------------------------------------|----------------------|----------------|-----------------------------
---------------------%--|----%--------------------------------------------------|----------------------|----------------|-----------------------------
---------%-----------|%-|%--%|-%----------------------------------------%-------|----------------------|----------------|-----------------------------
--------%|-----------||-||--||-|---%%-------------------%%--%%-%-%-%%---|-------|----%%-------------%--|%---------------|-----------------------------
--------||-%-------#-||-||--||-|---||%------%-----------||--||-|-|-||---|-------|----||--%-----%----|--||------------%--|--%%-------------------------
%%%%%%%%||-|-----%%%-%|-||%-||%|--%|||-----%|%%---------||--||-|-|-||%--|%%-----|----||%%|--%%-|----|--%|-------%----|--|--||---%--%%-%---%--%------%-
||||||||||XX-XXX-|||X|XX|X|-||||-X|||XXXX--||||-XXXX-XX-||XX||X|X|-|||XX|||XXXXX|XXXX|||||X-||X|--XX|--|XXX-XXXX|XXXX|XX|XX||X--|--||X|XXX|X-|XXXXXX|X