------------------------------------------------------------------------------------------------------------------------------------------------------
------------------------------------------------------------------------------------------------------------------------------------------------------
------------------------------------------------------------------------------------------------------------------------------------------------------
------------------------------------------------------------------------------------------------------------------------------------------------------
------------------------------------------------------------------------------------------------------------------------------------------------------
------------------------------------------------------------------------------------------------------------------------------------------------------
------------------------------------------------------------------------------------------------------------------------------------------------------
-----------------------------------------------%------------------------------------------------------------------------------------------------------
-----------------------------------------------|----------------------------------------------------------------%%------------------------------------
-----------------------------------------------|-----------------------%----------------------------------------||------------------------------------
------------------------------------%----%-----|-----------------------|----------------------------------------||------------------------------------
------------------%-----------------|----|%--%-|-----------------------|-------------%--------------------------||------------------------------------
---------%%---%--%|----%%%%%%-----%%|--%%||--|-|--%-----%-----%-%--%---|--------%%---|------%-----------------%-||-------------------------%----------
---------||--%|--||---%||||||---%-|||--||||--|-|--|-----|-----|-|--|---|--------||-%-|---%--|-----------------|-||-------------------------|----%%----
%%%%%%%%-||--||--||---|||||||---|-|||--||||--|%%--|%%---|%----|-|--|%%%|--------||-|-|---|--|---%%------------|-||--------------%--%-------|---%||----
||||||||-||-X||X-||XX-|||||XXXXX|XX||X-|||XXX|||-X|||X-X||X--X|X|XX|||||XX-X-XXX||X|X|-X-|XX|XXX||XX-XX--XXXXX|-||-XXXXXXXXXXXXX|XX|XX-XXXX|XXX|||XXXX