------------------------------------------------------------------------------------------------------------------------------------------------------
------------------------------------------------------------------------------------------------------------------------------------------------------
------------------------------------------------------------------------------------------------------------------------------------------------------
------------------------------------------------------------------------------------------------------------------------------------------------------
------------------------------------------------------------------------------------------------------------------------------------------------------
------------------------------------------------------------------------------------------------------------------------------------------------------
---------------------------------------------------------------------------------------------------%--------%-----------------------------------------
---------------------------------------------%-----------------------------------------------------|--------|-----------------------------------------
---------------------------------------------|-----------------------------------------------------|--------|--%--------------------------------------
---------------------------------------------|---------D-------------------------------------------|--------|--|-------------------------%------------
----------------%----------------------------|-----------------------------------------------------|--------|--|-----%-------------------|------------
--------------%-|----------------------------|---------%-------------------------------------------|--------|--|-----|-------------------%---------%--
--------------|-|--%-------------------------|----%%---|--%---%-------------------------%-------%-%|--------|--|--%--|-%%--%-------------|------%--|--
--------------|-|%%|---------------%%%---%#--%----||%--|-%|%--|------%--%---------------|-%-----|-||--%----%|--|--|--|-||--|%%------%----|------|--|--
%%%%%%%%------|-||||%--%%----%-----|||%--|%--|--%-|||--|%|||%-|%%----|--|-%%%-%-------%%|-|-----|-||%%|--%%||--|%-|%%|-||--|||------|%---|------|--|--
||||||||XXXXXX|-|||||--||XXXX|XXXXX||||XX||XX|X-|-|||XX||||||-|||XXXX|--|X|||X|XXXXX-X|||XXX---X|X|||||XX||||-X||X||||X||--|||XXX-XXX|-XX|XXXX-X|-X|X-