------------------------------------------------------------------------------------------------------------------------------------------------------
------------------------------------------------------------------------------------------------------------------------------------------------------
------------------------------------------------------------------------------------------------------------------------------------------------------
------------------------------------------------------------------------------------------------------------------------------------------------------
------------------------------------------------------------------------------------------------------------------------------------------------------
------------------------------------------------------------------------------------------------------------------------------------------------------
-----------------------D-----------------------------------------------------------------g------------------------------------------------------------
-----------------------------------------%---------------------%-------------------------%------------------------------------------------------------
-----------------------------------------|---------------------|-------------------------|------------------------------------------------------------
-----------------------------------------|---------------------|-------------------------|---------------------------%--------------------------------
-----------------------------------%-----|---------------------|----------------%--------|----------------%----------|-%------------------------------
-----------------------------------|-----|---------------------|-----C----------|--------|%---------------|----------|-|------------%-----------------
-------------%%----%%--%-----------|-----|-%----------%%--%%%--|-%-----%%-----%-|--------||%--------------|------%---|-|%----------%|---%----%%---%%--
-------------||----||--|---%%---%%-|-----|%|--%--%----||--|||-%|%|%----||-%---|-|--------|||-----%-----%-%|------|-%-|-||----------||---|----||%--||--
%%%%%%%%%-%-%||----||--|---||%%%||%|-----|||--|--|%%--||--|||-|||||-%--||-|---|-|%---X--%|||-----|-----|-||--%---|-|-|-||--%---%---||%--|----|||-%||%-
|||||||||X|X|X|XXXX||-X|XXX|||||||||XXX-X|||XX|--|||XX||--|||X|||X|X|XX||-X-XX|X||XXXXXX||||XXXXX|-XXXX|X||--|-XX|X|X|X||XX|XXX|XXX|||X-|XXXX|||-||||-