------------------------------------------------------------------------------------------------------------------------------------------------------
------------------------------------------------------------------------------------------------------------------------------------------------------
------------------------------------------------------------------------------------------------------------------------------------------------------
------------------------------------------------------------------------------------------------------------------------------------------------------
------------------------------------------------------------------------------------------------------------------------------------------------------
------------------------------------------------------------------------------------------------------------------------------------------------------
------------------------------------------------------------------------------------------------------------------------------------------------------
--------------------------------------------------%----------------S----------------------------------------------------------------------------------
--------------------------------------------------|-----------------%---------------------------------------------------------------------------------
--------------------------------------------------|--------------%--|---------------------------------------------------------------------------------
--------------------------------------------------|--D-----------|--|-----------%---------------------------------------%------t----------------------
----------------------------------%---------------|--------------|--|-----------|-----------------k---------------------|------t----------------------
--------------------%%-------%----|--%%-%---------|-%----%%------|-%|-----------|---------------------------------------|------t--------%-------%-----
--------------------||-------|-%--|--||-|---------|-|%---||------|%||-----------|----%-------%%%---%---------------%---%|%%%---t--------|---%---|-----
%%%%%%%%------------||------%|%|--|%-||-|%----%---|-||---||------||||--%-%%%%---%----|--%----|||---|------%--------|---|||||---%-----%--|-%-|---|-----
||||||||XXXXX-XXXXXX||X---XX|||XXX||-||X||XXXX|-X-|-||XXX||X----X||||X-|X||||XX-|XXX-XXX|X---|||XXX|X--XXX|X-XX-XXX|XXX|||||-XX|XXXXX|XX|X|X|XX-|XXXXX