------------------------------------------------------------------------------------------------------------------------------------------------------
------------------------------------------------------------------------------------------------------------------------------------------------------
------------------------------------------------------------------------------------------------------------------------------------------------------
------------------------------------------------------------------------------------------------------------------------------------------------------
------------------------------------------------------------------------------------------------------------------------S-----------------------------
------------------------------------------------------------------------------------------------------------------------------------------------------
------------------------------------------------------------------------------------------------------------------------------------------------------
-------------------------------------------------------------------------------S----------------------------------------------------------------------
------------------------------------------------------------------------------------------------------------------------------------------------------
------------------------------------------------------------------------------------------------------------------------------------------------------
--------------------------S---%------------------------------------------------%----------------------------------------%---------------------------%-
----------------------%-------|-%-------------------------------------%--------|---%------------------------------------|---------------------------|-
-------------------%--|-%%----|-|----%-------------%%%%-%%------------|--------|-%-|--------------------------------%---|--%---%%-%--%---%%-----%%-%|-
----------%--------|--|-||----|-|----|%------------||||-||-%--------r-|--------|-|-|----------------%---------------|---|--|---||-|--|---||-----||-||-
%%%%%%%%--|--------|--|-||%---|-|%--%||%%---%%-----||||-||-|----------|%%------|-|-|-%--------------|--%%-------%---|---|--|---||%|--|-%-||-----||-||-
||||||||XX|-X-X-XX-XXX|-|||XXX|X||XX|||||X-X||--X-X||||-||X|XXXXXXXX-X|||XXXX-X|XX-XX|XXX--XX---X-XX|X-||XX--X--|XXX|XX-|--|XXX||||XX|X|X||XXXXX||X||X