------------------------------------------------------------------------------------------------------------------------------------------------------
------------------------------------------------------------------------------------------------------------------------------------------------------
------------------------------------------------------------------------------------------------------------------------------------------------------
------------------------------------------------------------------------------------------------------------------------------------------------------
------------------------------------------------------------------------------------------------------------------------------------------------------
------------------------------------------------------------------------------------------------------------------------------------------------------
--------------------------------------------------------------------%-------------S-------------------------------------------------------------------
--------------------------------------------------------------------|---------------------------------------------------------------------------------
------------------------%-------------------------------------------|---------------------------------------------------------------------------------
------------------------|-%-----------------------------------------|---------------------------------------------------------------------------------
------------------------|-|-----------------------%-----------------|-------------%-------------------------------------------------------------------
------------------------|-|-----------------------|-----------------|-------------|-------------------------------------%-----------------------------
-----------------------%|-|---%---------%---------|%-%--------------%--%----------|--%-----%---%-------------%%%--------|----------------------2------
---------------%%--%---||%|---|--------%|---------||K|--------%%---%|--|-------%--|--|---%-|---|-------------|||----%---|--------------%-----%--------
%%%%%%%%%------||--|---||||--%|%-------||%--------||%|----%--%||---||--|----%--|--|--|---|-|---|---------%---|||----|---|-----%%-------|-----|---%-%-%
|||||||||X--XXX||X-|XXX||||-X|||XXXXXX-|X|XXXXXXXX||||XXXX|-X|||-X-||X-|XXXX|-X|X-|XX|XXX|-|--X|XXXXXX--X|XXX|||--XX|X--X-XX--||XXXXXX-X--X-X|-XX|X|X|