------------------------------------------------------------------------------------------------------------------------------------------------------
------------------------------------------------------------------------------------------------------------------------------------------------------
------------------------------------------------------------------------------------------------------------------------------------------------------
------------------------------------------------------------------------------------------------------------------------------------------------------
------------------------------------------------------------------------------------------------------------------------------------------------------
------------------------------------------------------------------------------------------------------------------------------------------------------
----------------------------------------------------------------------------------------------------------------------D-------------------------------
-----------------S------------------------------------------------------------%-----------------------------------------------------------------------
------------------------------------------------------------------------------|-----------------------------------------------------------------------
-----------%-----S------------------------------------------------------------|---------------------------------------------------t-------------------
-----------|t-------%%--------------------------------------------------------|---------------------------------------------------t-----------------D-
-----------|t%------||--------------------------------------------------------|-----------------------------------------------%---t-------------------
---------%-|t|%-----||---------------%--%-----%-------------------------------|%-------------%-%-------------%--------%-------|---%-------------------
---------|-|t||-%%--||-----%---%-%---|--|-----|%----------%--%----------------||---%---------|-|-------------|---%%--%|-------|---|---------%-----%-%%
%%%%%%%%-|-|%||-||-%||-----|---|-|%--|--|%%%--||----------|-%|------%---------||---|---------|-|-%------%%---|---||--||%------|---|-----%%%-|--%--|-||
||||||||-|-||X|X||X|||XX-XX|X--|X||XXX-X||||XX||-XXXXXXXX-|X|XXXXXXX|XXX-X-XXX||XXX|XXX-X-XXX|X|X|XX-X--||XXX|-XX||XX|||XXXXXXXX-X|XXXXX|||X|-X|--|X||