------------------------------------------------------------------------------------------------------------------------------------------------------
------------------------------------------------------------------------------------------------------------------------------------------------------
------------------------------------------------------------------------------------------------------------------------------------------------------
------------------------------------------------------------------------------------------------------------------------------------------------------
------------------------------------------------------------------------------------------------------------------------------------------------------
------------------------------------------------------------------------------------------------------------------------------------------------------
---------------------------------------------------------------------------%-------%-------------------------------------------------%----------------
---------------------------------------------------------------------------|-------|-------------------------------------------------|----------------
------------------------------------------------------%--------------------|-------|-------------------------------------------------|----------------
------------------------------------------------------|--------------------|-------|----------%-------------------------------%------|----------------
------------------------------------------------------|--------------------|-------|----------|-------------------------------|------|%----%-------%--
------------------------------------------------------|--------------------|-------|----------|--%---%----%%--------%---------|------||---%|-------|--
--------%%------%---------------G------%----%%--------|---------------%----|-%-%-%%|----------|--|%%-|----||----%---|---------|------||---||-------|%-
--------||------|--%%%%%--------%------|----||--%-----|------------%--|----|-|-|-|||-----%----|--|||%|----||----|---%---------|------||--%||-------||-
%%%%%%%%||-%----|--|||||-----%--|---%--|----||--|-----|%-----------|-%|-%%-%%|%|-|||-----|----|--|||||---%||--%%|%--|--%-%%---|------||--|||-------||-
||||||||||-|X-XX|XX|||||--XX-|XX|-XX|XX|X-XX||XX|-XXXX||X-XXX-XXXX-|X||X||-|||||X|X|XXXXX|XXX-|XX|XX||---|||X-||||XX|XX|X||XXX|XXX---||X-|X|XX-XXXX||-