------------------------------------------------------------------------------------------------------------------------------------------------------
------------------------------------------------------------------------------------------------------------------------------------------------------
------------------------------------------------------------------------------------------------------------------------------------------------------
------------------------------------------------------------------------------------------------------------------------------------------------------
------------------------------------------------------------------------------------------------------------------------------------------------------
--------------------------------------------------------------------------------------------------------------------------D---------------------------
------------------------------------------------------------------------------------------------------------------------------------------------------
------------------------------------------------------------------------------------------------------------------------------------------------------
------------------------------------------------------------------------------------------------------------------------------------------------------
---------------------------------------------%--------------------------------------------------------------------------------------------------------
-------------------%-------------------------|--------------------------------------------------------------------------------------------------------
-----------------%-|-%-----------------------|-----------------------------------%--%-------------------------------------%------------------------%-%
-----------------|-|-|-----------------------|-%-------%----------------%----%---|--|-----%--%%-%---%---%-%%%---%--%------|-%----%----%------------|-|
-----------------|-|-|----------%%%--%-%-%%--|%|-------|%------%----%---|%---|---|%-|---%-|--||-|---|---|%|||---|--|----%-|-|----|----|------------|-|
%%%%%%%%%--------|-|-|-%--------|||--|%|-||--|||-----%-||------|-%%%|--%||---|---||-|---|-|%%||%|%%-|%--|||||---|-%|----|%|-|----|%---|-%%%--------|-|
|||||||||XXX-XXXXXX|XX-|-XX-X-XX|||XX|||X||XX|||X-X--|X||-XXXXX|-||||XX|||XXX|XXXX|XXXXX|X|||||||||-||XX|||||XXX|X||X-XX|||X|-X--||--X|X|||X-XXXXX-XX|