------------------------------------------------------------------------------------------------------------------------------------------------------
------------------------------------------------------------------------------------------------------------------------------------------------------
------------------------------------------------------------------------------------------------------------------------------------------------------
------------------------------------------------------------------------------------------------------------------------------------------------------
------------------------------------------------------------------------------------------------------------------------------------------------------
-----------#------------------------------------------------------------------------------------------------------------------------------------------
-----------#------------------------------------------------------------------------------------------------------------------------------------------
-----------%------------------------------------------------------------------------------------------------------------------------------------------
-----------|-----------------------------------------------------------------------------------------------------%------------------------------------
-----------|----------------------------------------------------------------------%------------------------------|------------------------------------
-----------|----------------------------------------------------------------------|--------------------%---------|--%-----------------------%---------
-----------|---------------------------------------------%-%----------------------|---------%----------|---------|--|-----------------------|---------
---------%-|---%------------%%----%---------------%------|-|---%----------%---%---|-----%---|----------|---------|--|------------%----------|---------
---------|-|%--|--%---------||----|------%-----%%-|------|-|---|%-%-------|%--|%-%|-----|-%-|--%-------|----%----|--|------%-----|-----%----|%--------
%%%%%%%%-|%||--|-%|---------||----|--%---|-%---||-|------|-|%%-||-|-%---%%||--||-||-----|-|-|--|--%----|----|----|--|------|-%---|----%|----||----%-%%
||||||||X||||XXXX||-XXX-X-XX||X-XX|XX|---|X|XXX||-X-XXXXX|-|||X|X-|X|-XX||||X-||-||XXXXX|X|X|X-|-X|XXXX|---X|XXXX|XX|X-XX-X|-|X-XXXXX-||-XXX||XXXX|X||