------------------------------------------------------------------------------------------------------------------------------------------------------
------------------------------------------------------------------------------------------------------------------------------------------------------
------------------------------------------------------------------------------------------------------------------------------------------------------
------------------------------------------------------------------------------------------------------------------------------------------------------
------------------------------------------------------------------------------------------------------------------------------------------------------
------------------------------------------------------------------------------------------------------------------------------------------------------
------------------------------------------------------------------------------------------------------------------------------------------------------
------------------------------------------------------------------------------------------------------------------------------------------------------
------------------------------------------------------------------------------------------------------------------------------------------------------
---------------------------------------%--------------------------------------------------------------------------------------------------------------
---------------------------------------|---------------------------------------------------------------------------------------------%----------------
----------g-----------%----------------|--------------------------------------------------S------------------------------------------|----------------
--------%-------------|-%--%-%----%%---|%------------------------------%%%------------------------%%--%-------%---%---------------%--|-%%--%---%--%---
--------|----------%--|-|--|-|----||%--||------------------%----%%----#|||%--%--%%%-%----%--%--%--||%-|-----%-|--%|%---%------%%%-|--|-||--|---|-%|%--
%%%%%%%%|%-%-%--%-r|--|%|%-|-|%---|||--||-------%--%-------|-%-%||%---#||||--|--|||-|----|%-|--|--|||-|---%-|-|--|||--%|----%-|||-|--|%||--|---|-|||--
||||||||||X|X|-X|XXXXX||||X|X||-XX|||XX||XXX---X|--|XXXXX-X|X|X||||XXXX||||-X|X-|||X|XX--||X|--|XX|||-|XXX|X|X|XXX||XX||X--X|X|||XXXX||XXXX|--X|X|||XX