------------------------------------------------------------------------------------------------------------------------------------------------------
------------------------------------------------------------------------------------------------------------------------------------------------------
------------------------------------------------------------------------------------------------------------------------------------------------------
------------------------------------------------------------------------------------------------------------------------------------------------------
------------------------------------------------------------------------------------------------------------------------------------------------------
------------------------------------------------------------------------------------------------------------------------------------------------------
------------------------------------------------------------------------------------------------------------------------------------------------------
------------------------------------------------------------------------------------------------------------------------------------------------------
----------------------------------------------------------------------------------%---------------%---------------------------------------------------
------------------------------------------------------------%---------------------|---------------|---------------------------------------------------
------------------------------------------------------------|---------------------|---------------|----------------------S----------------------------
--------------------%---------------------------------------|---------------%-%---|---------------|----------%-----------------------------------%----
--------------------|%%--%-%%---%--%--%--------%-----%--%%--|---%-----------|-|---|--%%%%--------%%---%-----%%-----------------------%%%---------|-%-%
-------------%%---%-|||--|-||---|--|--|-----%--|%%---|%-||--|---|--------%--|-|---|--||||--------||---|-----||-----------%-----%---%%|||---------|-|-|
%%%%%%%%-%%--||---|%|||%-|%|%---|--|-%|--%-%|%-|||---||-||--|---|--------|--|-|---|--||||-%------||---|-----||-----------|-----|%--|||||--%------|-|-|
||||||||-||XX||XXX||X|||X||||XXX|X-|-||XX|X|||-|||XXX||-||XX|XXX|XXXX---X|XX|X|XXX|XX||||X|X-XXX-||-X-|X---X||XXX---XXXXX|XXXXX||XX|XX||-X|-XXXX-|X|X|