------------------------------------------------------------------------------------------------------------------------------------------------------
------------------------------------------------------------------------------------------------------------------------------------------------------
------------------------------------------------------------------------------------------------------------------------------------------------------
------------------------------------------------------------------------------------------------------------------------------------------------------
------------------------------------------------------------------------------------------------------------------------------------------------------
------------------------------------------------------------------------------------------------------------------------------------------------------
------------------------------------------------------------------------------------------------------------------------------------------------------
------------------------------------------------------------------------------------------------------------------------------------------------------
------------------------------------------------------------------------------------------------------------------------------------------------------
------------------------------------------------------------%----------------------------------------------------T------------------------------------
------------------------------------------------------------|---------------------------%------------------------t---------g--------------------------
---------------------------%--------------------------------|--%-----------------------%|------------------------t---------|--------------------------
--------%%--%%-------%-----|%------------%-----%%---C----%--|--|----%-----------%------||-%%-------%%----------%%%%-%%-----|%---------%-----%-----%--%
--------||--||-------|-----||%-----------|-----||%---%%--|-%|%-|----|----%------|------||-||-------||---------%||||-||-----||---------|-----|-----|--|
%%%%%%%%||--||-------|---%%|||-----------|-----|||---||--|-|||-|--%%|%---|------|------||-||-------||---------|||||-||---%-%|%----%---|-----|--%--|--|
||||||||||XX||XXX-X-X|XX-|||||-XXX-XXXXX-|XXXXXX||XXX||XX|-|||X|X-||||-XX|-X-XXX|-XXX-X||X|XXXXXX--||X-XXXXXXX|||||X||---|X|||-X--|X-X|XXXX-|XX|-X|--|