------------------------------------------------------------------------------------------------------------------------------------------------------
------------------------------------------------------------------------------------------------------------------------------------------------------
------------------------------------------------------------------------------------------------------------------------------------------------------
------------------------------------------------------------------------------------------------------------------------------------------------------
---------%------------------------------------------------------S-------------------------------------------------------------------------------------
---------|--------------------------------------------------------------------------------------------------------------------------------------------
---------|--------------------------------------------------------------------------------------------------------------------------------------------
---------|--------------------------------------------------------------------------------------------------------------------------------------------
---------|--------------------------------%-------------------------------------------------------------------------------------------------------%---
---------|--------------------------------|-------------------------------------------------------------------------------------------------------|---
---------|--------------------------------|-----------------------%-------------------------------------------------------------------------------|-%-
---------|-----%--------------------------|---------------------%-|-----------------------%-----------------------S-------------------%-----------|-|-
---------|-----|%-------%-----------------|------------------%--|-%--------%--%------%----|--------------%%---------------%-----------|-----------|-|-
---------|-----%|-%-----|-----------------|------------%--%--|--|K|----%%--|%-|-----%|----|-%---%%-----%%||----------%----|---%-------|---%-------|-|-
%%%%%%%%-|-----||-|-%---|-------%---------|--%---------|--|%-|--|%|--%-||%%||-|%----||----|#|---||-%%--||||%----%%---|----|---|---%---|%--|-------|-|-
||||||||X|XXXXX||X|X|XXX|X--XX--|XX---XXXX|XX|-XXXXXX-X|X-X|X|XX|||XX|X||||||-X|X-XX||X---|X|XXX||X||XX||XX|XXXX||X-X|XXXX|---|-XX|X-X||-XXXX-XX-X|-|X