------------------------------------------------------------------------------------------------------------------------------------------------------
------------------------------------------------------------------------------------------------------------------------------------------------------
------------------------------------------------------------------------------------------------------------------------------------------------------
------------------------------------------------------------------------------------------------------------------------------------------------------
------------------------------------------------------------------------------------------------------------------------------------------------------
------------------------%-----------------------------------------------------------------------------------------------------------------------------
------------------------|-----------------%-----------------------------------------------------------------------------------------------------------
------------------------|-----------------|-----------------------------------------------------------------------------------------------------------
------------%-----------|-----------------|----------------------------------S------------------------%-----------------------------------------------
------------|-----------|-----------------|-----------------------------------------------------------|-----------------------------------------------
------------|------C----|-----------------|-----------------------------------%-----------------------|-----------------------------------------------
------------|-----------|-----------------|--------------K-------------------%|-----------------------|-----------------------------------------------
------------|-----%--%%-|------------%%---|-%%---%%%----%%------------%-----t||---%------%%%---------%|-%-----%------%----------%------------%--------
------------|-----|--||-|%%----------||-%-|-||---|||----||t-----------|-----t||-%-|F%----|||-%-------||-|-----|------|--%-------|------------|--%--%%-
%%%%%%%%%%--|-----|%-||-|||-----%---%||-|-|%||---|||----||t%%%---%--%-|---%-%||-|-|%|--%-|||-|--%----||-|----%|-----%|--|-------|---%-%%-----|--|--||%
||||||||||X-|-XXX-||X||X|||XX-XX|X-X|||X|X||||-XX|||X---||X|||XXX|XX|X|XXX|-|||X|X|||-X|X|||X|-X|---X|XX|XXXX||--XXX|XXX|-XX-XXX|XXX|-||XXXXX|XX|--|||