------------------------------------------------------------------------------------------------------------------------------------------------------
------------------------------------------------------------------------------------------------------------------------------------------------------
------------------------------------------------------------------------------------------------------------------------------------------------------
------------------------------------------------------------------------------------------------------------------------------------------------------
------------------------------------------------------------------------------------------------------------------------------------------------------
-----------------%----------------------------------------------------------------------%-------------------------------------------------------------
-----------------|----------------------------------------------------------------------|-------------------------------------------------------------
-----------------|----------------------------------------------------------------------|-------------------------------------------------------------
-----------------|----------------------------------------------------------------------|-------------------------------------------------------------
-----------------|----g-----------------------D-----------------------------------------|-------%-----------------------------------------------------
-----------------|-----------------------St-------%%-------------%--%-------------------|-------|-----------------------------------------------------
-----------------|--K---------------------t----C--||-------------|--|----%--%----%------|-------|--------------%---%%-----------------------------%---
-----------------%-%%--%-------------%%%--t-------||-%-----------|--|----|--|--%-|----%-|------%|%-------------|---||---%--%%-%-%--------%#-------|---
-----------------|-||-%|--%----------|||--%---%---||-|----%-%----|-%|---%|%%|--|-|----|%|%-----|||-----%-------|---||---|--||-|-|------%-|%------%|--%
%%%%%%%%--%------|-||%||--|-----%-%--|||-%|---|---||%|----|-|----|%||--%|||||%%|-|----||||%----|||-----|-------|---||---|-%||-|%|------|%||------||--|
||||||||X-|-----X|-|||||-X|-XXX-|X|XX|||X||XXX|XXX||||XX--|X|XXXX||||--|||||X|||X|XXXX|||||-XXX|||X---X|X-XXXXXX-XXXXXX-|X|||-|||XX-XXX||||--XX-X||XX|