------------------------------------------------------------------------------------------------------------------------------------------------------
------------------------------------------------------------------------------------------------------------------------------------------------------
------------------------------------------------------------------------------------------------------------------------------------------------------
------------------------------------------------------------------------------------------------------------------------------------------------------
------------------------------------------------------------------------------------------------------------------------------------------------------
---------------------%--------------------------------------------------------------------------------------------------------------------------------
---------------------|--%-----------------------------------------------------------------------------------------------------------------------------
---------------------|--|-----------------------------------------------------------------------------------------------------------------------------
---------------------|--|-----------------------------------------------------------------------------------------------------------------------------
---------------------|--|------------------------------------------------------------------------------------------------------%-----------%----------
---------------------|--|-%S----%---------------------------------------------g------------------------------------------------|-----------|----------
---------------------|--|-|--%--|----%-----S--g--------------------------------------------------------------------------------|-----%%----|----------
------------------%--|--|-|--|%-|---%|%-----------%--%%%%%-----%%%-%%%-------%---%%%--%-------------%---%-%-----%--------------|-%---||%---|%%------%%
------------------|--|--|-|%-||-|---|||---%-%-----|--|||||-----|||%|||-%--%--|---|||--|-----%--%----|---|-|-----|-----%--------|-|---|||--%|||--%---||
%%%%%%%%--------%%|%-|--|-||-||-|---|||-%%|-|-----|--|||||-----|||||||-|--|--|%--|||--|-----|--|-%--|%%%|-|-%---|-----|-%--%---|-|---|||--||||--|%--||
||||||||---X---X||||X|XX|-||XX|-|XXX|X|X|||X|XXXX-|XX|||||XX-XX|||||||X|-X|XX||X-|||-X|X--XX|XX|X|XX||||X-|X|-XX|XXXXX|-|XX|-XX|XX--X|X|X-||||-X||--||