------------------------------------------------------------------------------------------------------------------------------------------------------
------------------------------------------------------------------------------------------------------------------------------------------------------
------------------------------------------------------------------------------------------------------------------------------------------------------
------------------------------------------------------------------------------------------------------------------------------------------------------
--------------------------------------------------------------------------------------------------------------------%---------------------------------
--------------------------------------------------------------------------------------------------------------------|---------------------------------
------------------------------------------------------------%-------------------------------------------------------|---------------------------------
------------------------------------------------------------|------------------%-------------------------%----------|---------------------------------
------------------------------------------------------------|------------------|--%----------------------|----------|---------------------------------
---------%--------------------------------------------------|------------%-----|--|----------------------|----------D---------------------------------
---------|-----S--------%----------------------------------%|------------|-----|--|----------------------|--------------------------------------------
---------|------%-------|----------------------------------||------------|-----|--|----------------------|--g-----------------------------------------
---------|------|-----%-|-------%---%------%---------------||---%----%%--|-----|--|-----------------%-%-%|-------------%-----%----------%-------------
---------|%---%-|-----|-|-------|---|------|--------%------||---|----||--|%----%--|-%-%%-----------%|-|-||--%--------%%|%----|--S%----%-|%--%-%%-%----
%%%%%%%%%||---|%|-----|-|-------|---|--%%%-|---%--%%|------||%--|----||%-||%---|--|-|%||-----%-----||-|-||--|----%---||||%%--|---|%%-%|-||--|-||-|----
|||||||||||X-X||XXXXXX|X|XXX-XXX|XX-|X-|||X|XXX|XX|||XXXXXX|||XX|-XXXXX|X|X|XXX|XX|X||||XXX-X|X-X--|XX|-||X-|X-XX|X-X|||X||XX|--X|||X||X||XX|X||XX----