------------------------------------------------------------------------------------------------------------------------------------------------------
------------------------------------------------------------------------------------------------------------------------------------------------------
------------------------------------------------------------------------------------------------------------------------------------------------------
------------------------------------------------------------------------------------------------------------------------------------------------------
------------------------------------------------------------------------------------------------------------------------------------------------------
------------------------------------------------------------------------------------------------------------------------------------------------------
--------------------------------------------------------------------------------------------------------------%---------------------------------------
--------------------------------------------------------------------------------------------------------------|---------------------------------------
---------------------------------------------------------------C---------------%------------------------------|---------------------------------------
-------------------------------------------------------------------------------|--%---------------------------|---------------------------------------
------------------------------------%----------%---------------r---------------|--|%-------------------%------|---------------------------------------
------------------------------------|----------|---------------%--------------%|--||--%----------------|------|--------------------%--------S---------
---------%-------------%S---%--%---%|----------|----------%-%--|%-%-----------|S--||--|%---%%%----%%---|%-----|%--%%%-----%-%---%%-|%----%-----------%
---------|------%-%----|---%|--|---||----%%-%--|-%----%---|-|--||-|------%----|---||--||---|||----||---||-----||--|||-----|-|---||-||----|-%---------|
%%%%%%%%-|%----%|-|----|-%-||--|%%-||-%--||-|--|-|----|---|-|--||-|------|----|---||--||--%|||----||--%||-----||--|||%----|-|---||-||--%-|%|----%%%--|
||||||||X||XXXX||-|XXXX|X|-||XX|||XX|-|X-||X|XX|X|-XXX|XXXX-|XX|XX|XXXXXX|XX-X|S-X||X-|XXX||||X---||XX|||XXX--|XXX||||XXXX|X|-XXX|XX|X-|X|||XXXX|||XX|