------------------------------------------------------------------------------------------------------------------------------------------------------
------------------------------------------------------------------------------------------------------------------------------------------------------
------------------------------------------------------------------------------------------------------------------------------------------------------
------------------------------------------------------------------------------------------------------------------------------------------------------
------------------------------------------------------------------------------------------------------------------------------------------------------
------------------------------------------------------------------------------------------------------------------------------------------------------
------------------------------------------------------------------------------------------------------------------------------------------------------
---------------------------------------------------------------------------------------g------------%-%-----------------------------------------------
--------------------------------------------------------------------------------------%|------------|-|-----------------%-----------------------------
----------%---------------------------------------------------------------------------||------------|-|-----------------|-----------------------------
----------|-----------------------%-------------------------------------------%%------||------------|-|-----------------|-------%--%------------------
----------|-----------------------|-----------------------------------------%-||----%-|%------------|-|-----------------|-------|--|------------------
----------|------------------%%---|%%-%%--%%-%%--%----------------%----%----|-||----|%||----%-------|-|--%-----%-----%--|-------|--|%-%--------%-%---%
----------|------%%-----%----||---|||-||--||-||-%|-----%-------%%-|----|--%-|%||-%--||||%---|-----%%%%|--|----%|%---%|--|-------|--||-|--%%----|-|%--|
%%%%%%%%-%|-----%||-%---|----||---|||-||--||-||-||-----|%--%%--||%|----|--|%||||-|--|||||---|-%--X|||||--|----|||---||--|-------|--||-|--||---%|-||--|
||||||||X|XXXXXX|||-|X--|XXXX||--X|||X|X-X||X||-||X-XXX||XX||XXX|||XXXX|XX||||||X|XX|||||---|-|-XX|||||XX|-X-X|||-XX||XX|-XXXXXX|XX||-|X-||XXX||X||XX|