------------------------------------------------------------------------------------------------------------------------------------------------------
------------------------------------------------------------------------------------------------------------------------------------------------------
------------------------------------------------------------------------------------------------------------------------------------------------------
------------------------------------------------------------------------------------------------------------------------------------------------------
------------------------------------------------------------------------------------------------------------------------------------------------------
------------------------------------------------------------------------------------------------------%-----------------------------------------------
------------------------------------------------------------------------------------------------------|-----------------------------------------------
------------------------------------------------------------------------------------------------------|-----------------------------------------------
------------------------------------------------------------------------------------------------------|-----------------------------------------------
------------------------------------------------------------------------------------------------------|-------------------------------------------%---
------------------------------------------------------------%-----------------------------------------|-------------------------------%-----------|---
------------------------%-----------------------------------|------------%----%-----------------------|------------------------------%|-----------|---
---------%---%%----%----|---%%---%---%%--%----%-------------|-%----------|--%-|----%------------------|---%----%%----------------%---||%-%------%-|%-%
---------|---||----|----|-%-||---|---||--|--%-|%---------%-%|-|----------|--|%|%%%-|-%--#%-------%%---|---|----||---%----%---%---|---|||-|------|-||-|
%%%%%%%%-|%--||----|---%|-|-||--%|---||--|--|-||%----%%-%|-||-|%-------%%|--||||||-|-|--%|-------||---|---|%---||---|----|%--|%--|---|||-|------|-||-|
||||||||X||XX||XXXXX-XX||X|X||X-||-XX||-X|XXXX|||-X--||X||X||X||XXXXXXX|||XX||||||-|-|--||--XXXXX||XXX|-XX||-XX||XXX|X-XXX|XX||XX|XXX|||X|X-XX-X|X||X|