------------------------------------------------------------------------------------------------------------------------------------------------------
------------------------------------------------------------------------------------------------------------------------------------------------------
------------------------------------------------------------------------------------------------------------------------------------------------------
------------------------------------------------------------------------------------------------------------------------------------------------------
------------------------------------------------------------------------------------------------------------------------------------------------------
------------------------------------------------------------------------------------------------------------------------------------------------------
------------------------------------------------------------------------------------------------------------------------------------------------------
------------------------------------------------------------------------------------------------------------------------------------------------------
------------------------------------------------------------------------------------------------------------------------------------------------------
------------------------------------------------------------------%-----------------------------------------------------------------------------------
------------------------------------------------------------------|-------------%----------------------------%--------------------%-------------------
-----------------------%------------------------------------------|-------------|----------------------------|------%-------------|-------------------
----------%----------%%|------%%-----%%%-%%--%%-%%--------------%-|%%-----%%----|----%-%---------------------|-----%|----%--------|%------------------
--------%-|------%---|||%%----||-----|||-||--||-||---%---%%-%---|-|||-----||----|---%|-|%----%%----%--%-%%%%%|%----||----|-%%%-%--||-----%%-%-%---%-%%
%%%%%%%%|-|------|---|||||----||%%---|||-||--||-||-%-|%--||-|---|-|||-----||----|---||-||--%-||--%-|--|%|||||||--%-||----|-|||-|--||-----||%|-|---|-||
|||||||||X|X-XXXX|X-X||X|XXX--||||X--|||X||XX||-||X|X||--||-|XXX|X|||XXXXX||XXXX|XXX|XX|XX-|X||XX|-|--|||||||||XX|X|X--XX|X|||X|X-||XX--X||||X|-XX|-||