------------------------------------------------------------------------------------------------------------------------------------------------------
------------------------------------------------------------------------------------------------------------------------------------------------------
------------------------------------------------------------------------------------------------------------------------------------------------------
------------------------------------------------------------------------------------------------------------------------------------------------------
--------------------------------------------------------------------------------------------------------------------------------t---------------------
--------------------------------------------------------------------------------------------------------------------------------T---------------------
---------------------------------------------------------------------------------------------------------D----------------------t---------------------
--------------------------------------------------------------------------------------------------------------------------------%---------------------
--------------------------------------------------------------------------------------------------------------------------------|---------------------
-------------------------------------------------------------T-------------------------------U----------------------------------|-------t-------------
-------------------------------------------------------------t------------------------------------------------------------------|-------t-------------
--------------------%----%--------------------------------%--t------------------------------%---------------------------%-------|-------t-------------
--------------------|%---|-----------------------------%--|--%---%-----------------%g-------|---%-%------%--------------|-------|----#--%%------------
----------------%---||---|---------%-------%-----------|--|--|---|------%----------|-g----%-|%--|-|------|----%---%-----|-------|-%--%--||%-------%---
%%%%%%%%-%----%-|--%||%--|-%-------|-------|--------%%-|--|--|---|-%%---|----------|%-----|-||--|-|--%---|----|---|-----|-------|-|%-|%-|||%-----%|---
||||||||X|-XXX|X|--|X||XX|X|XXXXXXX|XXXXX--|XX-XXXX-||X|XX|XXXXXXXX||---|XXXXXXX-XX||X----|-||-X|X|X-|XXX|XXXX|XXX|XXXXX|X-XXX-X|X||-||-||||XXXX-||XXX