------------------------------------------------------------------------------------------------------------------------------------------------------
------------------------------------------------------------------------------------------------------------------------------------------------------
------------------------------------------------------------------------------------------------------------------------------------------------------
------------------------------------------------------------------------------------------------------------------------------------------------------
------------------------------------------------------------------------------------------------------------------------------------------------------
------------------------------------------------------------------------------------------------------------------------------------------------------
------------------------------------------------------------------------------------------------------------------------------------------------------
------------------------------------------------------------------------------------------------------------------------------------------------------
-------------------------------------------------------------------------------------------------------------------------------%----------------------
---------%---------------------------------------------------%-----------------------------------------------------------------|----------------------
--------%|------%--------------------------------------------|-----------------------------------------------------------------|----------------------
--------||------|--------------%%------%-----------%---------|-----%-----------------%--------------------%--------------------|----------------------
--------||---%--|--------------||-----%|-----------|----%--%-|-----|---------------%-|---------%----------|------------------%-|--------------------%-
--------||---|--|------%----%%-||-----||---------%%|---%|--|-|-----|--------------%|-|---------|----------|%-----------------|-|%------%-%-%%-------|%
%%%%%%%%||-%-|%-|----%%|----||-||%----||--%--%%--|||---||--|%|%----|-%--%------%--||-|%------%-|----------||---%-------------|%||------|%|-||---%%%%||
||||||||||X|-||X|-XX-|||XXXX||X|||-X--||-X|--||X-|||X--|XXX||||XXXX|-|XX|XXXXXX|X-||XX|-XXXXX|X|XXXX-XXXXXX|-XX|XXX-XXXXXX-XX||||XXXX-X|||X||X-X||||||