------------------------------------------------------------------------------------------------------------------------------------------------------
------------------------------------------------------------------------------------------------------------------------------------------------------
------------------------------------------------------------------------------------------------------------------------------------------------------
------------------------------------------------------------------------------------------------------------------------------------------------------
------------------------------------------------------------------------------------------------------------------------------------------------------
------------------------------------------------------------------------------------------------------------------------------------------------------
---------------------------------------------------------------------%--------------------------------------------------------------------------------
---------t--------------------------------------------------%--------|--------------------------------------------------------------------------------
---------T--------------------------------------------------|------%-|--------------------------------------------------------------------------------
---------%--------------------------------------------------|------|-|---------------------------%----------------------------------------------------
---------|------%-------------------------------------------|------|-|---------------------------|--------%-------------------------------------------
---------|S-----|-------------------------------------------%----%-|-|-----------------%-%-------|--------|-------------------------------------------
---------|------|----------------------%--------%-----------|%---|-|-%%---------%------|-|-------|------%%|--%-%-------%--%---------%----%-----%%-----
---------|------|%---%--%%%------------|-%------|---%%%---%-||---|-|-||---------|------|-|--%%---|------|||--|%|---%---|--|--------%|----|-----||-----
%%%%%%%%%|----%-||---|--|%|-%--%---%%--|-|----%-|-%%|||---|-||--%|-|%||-------%%|---%--|-|--||---|------|||--|||---|--%|-%|%---%%--||%---|%----||-%--%
||||||||||XXXX|X||XXX|--|||X|XX|XXX||XXXX|X-XX|-|X|||||XXX|X||XX|XX||||XXXX-XX|||XXX|--|-|XX||XXX|XXXX-X|||XX|||-X-|X-||X|||X--||XX|||--X||-XXX||X|X-|