------------------------------------------------------------------------------------------------------------------------------------------------------
------------------------------------------------------------------------------------------------------------------------------------------------------
------------------------------------------------------------------------------------------------------------------------------------------------------
------------------------------------------------------------------------------------------------------------------------------------------------------
------------------------------------------------------------------------------------------------------------------------------------------------------
------------------------------------------------------------------------------------------------------------------------------------------------------
------------------------------------------------------------------------------------------------------------------------------------------------------
------------------------------------------------------------------------------------------------------------------------------------------------------
----------------------------------------------------------------------------------------------%-------------------------------------------------------
------------------------------------------------------------------%g--------------------------|-------------------------------------------------------
-----------------------------------------------%----------------%-||---------------------S----|----------------------------------------%--------------
-----------%S----------------------------------|C---------------|-||--------------------------|----------------------------------------|--------------
-----------|---------%---%----%%--%-----------%|-%--------------|-||%---------------%----%----|-----------G------------%-%%------------|--------------
-----------|----%----|---|----||--|-----------||-|%------%------|-|%|----------%%---|-%--|%--%|-----------%--%---------|-||---%--------|----%---%-g---
%%%%%%%%-%%|----|%---|---|-%--||--|%-%--%%%---||-||------|------|-|||%%%%------||---|-|--||--||-----------|--|---------|%||--%|-%%%----|%---|-%%|--%--
||||||||X|||X-XX||-XXXXXX|-|XX||XX||X|XX|||-XX||X||XXXXX-|XX--XX|X|||||||-XXXX-||XXX|X|XX||XX||XXXXXXXX-XX|-X|XX-XXXXX-||||XX||X|||XXXX||X--|X||XXX|--