------------------------------------------------------------------------------------------------------------------------------------------------------
------------------------------------------------------------------------------------------------------------------------------------------------------
------------------------------------------------------------------------------------------------------------------------------------------------------
------------------------------------------------------------------------------------------------------------------------------------------------------
------------------------------------------------------------------------------------------------------------------------------------------------------
------------------------------------------------------------------------------------------------------------------------------------------------------
--------------------------------------------------%--------------------------------------------%------------------------------------------------------
--------------------------------------------------|--------------%-----------------------------|------------------------------------------------------
--------------------------------------------------|--------------|-----------------------------|------------------------------------------------------
------------------------S-------------------------|--------------|%----------------------------|------------------------------------------------------
------------------------g-------------------------|--------------||-----------------------%----|%-----------------------------------------------------
-----------------------------C--------------------|--------------||------%-%--------------|----||---------------------------------%--%---------S------
-------------------------%--------%---------------|--------------||------|-|---%------%%--|----||---------------------------------|--|----------------
-------------------%-----|--------|-%-------%---%-|-----%---%----|%------|-|---|-----%||--|---%||-%%%----%------%-----------------|--|---------%%-----
%%%%%%%%%%--%%--%--|----%|------%-|-|--%----|---|-|-----|---|----||%--%%-|-|-%%|-----|||--%---|||-|||----|------|-------%---------|--|-%-%-%---||-----
||||||||||--||X-|XX|XX-X||-XXXX-|-|X|XX|XXXX|XXX|-|XX-XX|-XX|----|||XX||-|XXX|||-XX--X||X-|XXX|||X|||X--X|XXXXXXXXXXXXXX|XXXXXXXXX|XX|X|X|-|--X||-XXXX