------------------------------------------------------------------------------------------------------------------------------------------------------
------------------------------------------------------------------------------------------------------------------------------------------------------
------------------------------------------------------------------------------------------------------------------------------------------------------
------------------------------------------------------------------------------------------------------------------------------------------------------
------------------------------------------------------------------------------------------------------------------------------------------------------
-----------------------------------------------%------------------------------------------------------------------------------------------------------
-----------------------------------------------|---------------------------------------------%--------------------------------------------------------
-----------------------------------------------|---------------------------------------------|--------------------------------------------------------
-----------------------------------------------|---------------------------------------------|--------------------------------------------------------
-----------------------------------------------|---------------------------------------------|-----------------------------------t--------%--%-----%--
-------------S------------------%--------------|---------------------------------------------|-----------------S-----------------t--------|--|-----|--
-------------k------------------|--------------|---------------------------------------------|-------------------%----%--%-------t--------|--|-----|--
--------%-S---------------------|----------%---|---------------------%----------%%-----------|-------------------|----|--|-------%%-------|--|-----|--
--------|------------%----------|----------|---|----%----------------|----------||-----------|-------------------|-%--|--|-------||-------|--|-----|--
%%%%%%%%|-----%%---%-|----------|%------%-%|-%-|--%-|%%--%--------%%-|-----%----||---------%-|---%-%%-------%--%-|-|--|--%---%---||------%|--|%%%-%|%-
|||||||||XXX-X||XXX|XX--------XX||XX-XX-|X||X|-|XX|X|||--|--XXXXXX||-|--XXX|----||X--XXXXXX|-|XXX|X||--XXXXX|--|-|X|XX|-X|X-X|-XX||XXXXXX||XX||||X|||-