------------------------------------------------------------------------------------------------------------------------------------------------------
------------------------------------------------------------------------------------------------------------------------------------------------------
------------------------------------------------------------------------------------------------------------------------------------------------------
------------------------------------------------------------------------------------------------------------------------------------------------------
------------------------------------------------------------------------------------------------------------------------------------------------------
------------------------------------------------------------------------------------------------------------------------------------------------------
------------------S-----------------------------------------------------------------------------------------------------------------------------------
------------------------------------------------------------------------------------------------------------------------------------------------------
----------------------------------------------------------------------------------------------------------------------%-------------------------------
----------------------------------------------------------------------------------------------------------------------|-------------------------------
------------------%-----------------------------------%%--------------------------------------------------------------|----------%--------------------
------------------|-----------------------------------||----------------------------%-----------------------------%---|--%-------|%-------------------
---------%--%-----|--------------------%-%------%%----||---------%-----%-%-------%--|---------------------------%-|-%-|%-|-------||-------%----%--%---
---------|--|-%--%|-----------------%%%|-|------||--%-||---------|--%--|-|-------|--|-----%--------------%%%--%-|-|-|-||-|-------||%----%-|----|--|---
%%%%%%%%-|--|-|--||----%%%%----%%%--||||%|----%-||--|%||--%------|%-|--|-|%--%---|-%|-----|%---%---------|||--|-|-|-|%%|%|%%-----|||%---|-|--%-|--|---
||||||||X|XX|X|XX||X--X||||X--X|||XX||||||XXXX|-||XX||||X-|XXXXXX||-XXX|X||XX|--X|X||XXXXX||X-X|XXXXXXXXX|||XX|-|-XX||||||||XX---|X||---|X|XX|X|XX|--X