------------------------------------------------------------------------------------------------------------------------------------------------------
------------------------------------------------------------------------------------------------------------------------------------------------------
------------------------------------------------------------------------------------------------------------------------------------------------------
------------------------------------------------------------------------------------------------------------------------------------------------------
------------------------------------------------------------------------------------------------------------------------------------------------------
---------------------------------------------------------------------------------------------------------#--------------------------------------------
---------------------------------------------------------------------------------------------------------%--------------------------------------------
---------------------------------------------------------------------------------------------------------|--------------------------------------------
---------------------------------------------------------------------------------------------------------|--------------------------------------------
---------------------------------------------------------------------------------------------------------|--------------------------------------------
---------------------------------------------------------------------------------------------------%-----|--------------------------------------------
-----------------------------------------------------------------%---------------------------------|-----|-------%C-----------------------------------
-------------------%--------------------------------------%------|----------%----------------------|%----|------%|-%%%%------------%----------%-------
-------------------|-----%----------------%-----%--%-%%%--|------|----%-----|------%%--------------||----%----%-||-||||--------%---|---%------|-%-----
%%%%%%%%%%-%-------|--%--|%%-%-%%%-%-%----|----%|--|-|||--|------|----|-----|------||---%---%------||-%%-|----|-||-||||--------|%%%|---|-%%--%|-|-%---
||||||||||X|XXXX-XX|XX|XX|||-|-|||-|-|X-XX|--XX||--|X|||XX|XXXXXXXXXXX|XX---XX--XXX||XXX|XX-|---X-X||-||-|XXXX|X||X||||--XXXXXX|||||-XX|X||XX||X|X|XX-