------------------------------------------------------------------------------------------------------------------------------------------------------
------------------------------------------------------------------------------------------------------------------------------------------------------
------------------------------------------------------------------------------------------------------------------------------------------------------
------------------------------------------------------------------------------------------------------------------------------------------------------
------------------------------------------------------------------------------------------------------------------------------------------------------
------------------------------------------------------------------------------------------------------------------------------------------------------
------------------------------------------------------------------------------------------------------------------------------------------------------
-----------------------------------------------------------------------------------------------------%------------------------------------------------
-------------------------------------------------------------------%---------------------------------|-----D------------------------------------------
-------------------------------------------------------------------|-----%--------------------------%|------------------------------------------------
-------------------------------------------------------------------|-----|-------------------%-----%||-----------C--------------%---------------------
----------------------------%---------%----------------------------|-----|-------------------|-----|||-%------------------------|---------------------
--------------------%%------|--%-%----|---%-%-%------%%%--%%-------|-----|----%---%-%--------|-----|||%|---------------%--------|---%--%----%---------
---------%-----%%%--||------|--|G|---%|---|-|%|------|||%-||--%--%-|-----|%--%|%--|-|-------%|---%%|||||#%%-%-%--------|----%---|---%--|%---|%--------
%%%%%%%%-|----%|||--||%-----|-%|%|%--||---|-|||------||||-||--|--|-|%-%--||--|||--|-|-------||---|||||||#||%|%|%-%---%-|----|---|--%|%%||---||-%-%%%-%
||||||||X|XXXX||||XX|||XXXXX|X|||||XXX|-XX|X|||XX-XXX||||X||X-|X-|X||-|XX||XXXXXXX|X|XX--XX-||X--|||||||X|||||||X|X--|X|XXXX|XXX|XX||||||-XX||X|X|||-|