------------------------------------------------------------------------------------------------------------------------------------------------------
------------------------------------------------------------------------------------------------------------------------------------------------------
------------------------------------------------------------------------------------------------------------------------------------------------------
------------------------------------------------------------------------------------------------------------------------------------------------------
------------------------------------------------------------------------------------------------------------------------------------------------------
------------------------------------------------------------------------------------------------------------------------------------------------------
------------------------------------------------------------------------------------------------------------------------------------------------------
-------------------------------------%----------------------------------------------------------------------------------------------------------------
-------------------------------------|---------------------------%------------------------------------------------------------------------------------
-------------------------------------|-------------------------%-|------------------------------------------------%-----------------------------------
-----------------------------------%-|-------------------------|-|------------------------------------------------|----%------------------------------
--------------------------------C--|-|---%---------------------|%|------------------------------------------------|----|---------%------------------%-
-------------------%----------%----|-|---|-----%---------------|||--%-%------%----------U--------%-%%-----%%%-----|----|%--------|------------%-----|-
-------------------|----%-----|%---|-|---|%-%%-|-------------%%|||-%|%|------|---%----%----------|-||-----|||--%--|--%-||----%---|%-----------|%%---|-
%%%%%%%%--%%-------|--%%|-----||---|%|---||-||%|----%-%--%---|||||-||||-%--%-|%--|----|----------|-||-----|||--|--|--|-||----|--%||-----------|||---%-
||||||||XX||XXXXXXX|--|||-XXXX||XXX|||XX-||X||||---X|X|XX|XXX|||||X||||X|X-|X||XX|-X-X|XXXXXX-XXX|X||X-XXX|||X-|XX|--|X||XXXX|X-|||X-XXXXXX---|XX-XX|X