------------------------------------------------------------------------------------------------------------------------------------------------------
------------------------------------------------------------------------------------------------------------------------------------------------------
------------------------------------------------------------------------------------------------------------------------------------------------------
------------------------------------------------------------------------------------------------------------------------------------------------------
------------------------------------------------------------------------------------------------------------------------------------------------------
------------------------------------------------------------------------------------------------------------------------------------------------------
------------------------------------------------------------------------------------------------------------------------------------------------------
------------------------------------------------------------------------------------------------------------------------------------------------------
---------------------------------------------------------------------------------------%--------------------------------------------------------------
--------------------------%-%--------------------%-------------------------------------|--------------------------------------------------------------
--------------------------|-|--------------------|----------%--------------------------|--------------------------------------------------------------
------------%-----%-%--#--|-|--------------------|----------|--------------------------|------------------------------------%-------------------------
------------|-----|%|--%--|-|%-%%---------------%|--%----%--|--------------%%-------%-%|------------------%%--%----%-%%---%-|-----%%---%-----%%--%---%
-----------%|-----|||--|--|-||-||--%---%%%------||--|----|--|--------------||-------|-||%-%--------------%||--|---%|-||---|-|-----||---|-----||%-|%--|
%%%%%%%%---||--%%%|||--|-%|-||-||--|---|||----%%||--|%%-%|-%|%-----%------%||-%%----|%|||-|--------%----k|||--|---||-||---|-|-----||---|-----|||-||%-|
||||||||XXX||-X|||||XXX|X||X||X||XX|XXX|||XXXX||||XX|||-||X|||-XXX-|-XXXXX|||X||XXXXX||||X|XXX-XX-X|XX-XX|||XX|XXX||X||XXX|XXX-XXX||X-X|-XXXX|||-|||X|