------------------------------------------------------------------------------------------------------------------------------------------------------
------------------------------------------------------------------------------------------------------------------------------------------------------
------------------------------------------------------------------------------------------------------------------------------------------------------
------------------------------------------------------------------------------------------------------------------------------------------------------
---------------------------------------------------------------------------------------------------------------------------------------%--------------
---------------------------------------------------------------------------------------------------------------------------------------|--------------
---------------------------------------------------------------------------------------------------------------------------------------|--------------
---------------------------------------------------------------------------------------------------------------------------------------|--------------
---------------------------%----------------------------%------------------------------------------------------------------------------|--------------
---------------------------|----------------------------|------------------------------------------------------------------------------|-------------%
---------------------------|-----------------C----------|------------------------------------------------------------------------------|--------%----|
---------------------------|----------------------------|----------%-------------------------------------------------------------------|--------|----|
-------------%---%%----%---|-----------%----------------|----------|-%---------------%%--%%----%------------------------%%----%-%------|%-------|---%|
---------%%%%|---||%---|---|--------%--|----------------|---------%|-|------%--------||--||---%|--%---------------------||----|-|------||---%---|--%||
%%%%%%%%%|||||---|||--%|---|%------%|--|%%-%-%-------%%%|--%------||-|--%%%-|--%-----||--||---||--|---%%----------------||%%--|-|------||---|---|--|||
||||||||||||||XX-|||XX||XX-||XXXXXX|X-X|||X|X|-XXXXXX||||-X|XXXXXX|XX|--|||X|XX|-X-XX||XX||XXX||X-|XXX||XX---XXXXXXXXXX-||||XX|X|--XX--X|XXX|--X|X-X||