------------------------------------------------------------------------------------------------------------------------------------------------------
------------------------------------------------------------------------------------------------------------------------------------------------------
------------------------------------------------------------------------------------------------------------------------------------------------------
------------------------------------------------------------------------------------------------------------------------------------------------------
------------------------------------------------------------------------------------------------------------------------------------------------------
------------------------------------------------------------------------------------------------------------------------------------------------------
----------------------------------------------------------------------------------------------------%-------------------------------------------------
----------------------------------------------------------------------------------------------------|----------------%--------------------------------
----------------------------------------------------------------------------------------------------|----------------|--------------------------------
----------------------------------------------------------------------------------------------------|----------------|--------------------------------
----------------------------------------------------------------------------------------------------|----------------|------------%-------------------
-----------------------------------------------%--------------%-------------%-----------------------|----------------|------------|----U--------------
---------------------------%------%------------|--%-----------|--%----------|---------%--%--%%---%--|----------------|------------|---%-%-------------
------------------%--------|------|----%-------|--|-----------|-%|------%%--|-----t-%-|--|--||---|--|---------------%|------%%----|%--|-|----%--------
%%%%%%%%%%--------|----%%--|----%-|--%-|------%|%%|----%--%---|-||------||--|-----t-|-|-%|-%||---|--|-----%-%%------||---%--||-%--||--|-|----|--------
||||||||||XX---XXX|X--X||-X|---X|X|XX|X|XXX--X|||||X--X|XX|XXX|X||XXX-XX||--|----XXX|XXX|X-|||XXX|-X|XX-XX|X||---XXX||X-X|XX||X|XX||XX|X|XXXXXXXXXXXX-