------------------------------------------------------------------------------------------------------------------------------------------------------
------------------------------------------------------------------------------------------------------------------------------------------------------
------------------------------------------------------------------------------------------------------------------------------------------------------
------------------------------------------------------------------------------------------------------------------------------------------------------
------------------------------------------------------------------------------------------------------------------------------------------------------
------------------------------------------------------------------------------------------------------------------------------------------------------
-----------------------------------------t----------------------------------------------------------------------------------------------%-%-----------
-----------------------------------------t--------%--g----------------------------------------------------------------------------------|-|-----------
-----------------------------------------D--------|------------------------------------------------------------------------------k------|-|-----------
--------------------------------------------------|------------------------------------------------------------------------------%------|-|-----------
-----------------------%----------%---------------|-------------------------------------------------------------------------%----|------|-|-----------
--------%--------------|----------|----------%%%--|--%----------------------------------------------------------------------|----|------|-|-----------
--------|----%--------%|-%--------|------%---|||--|--|%%------------------%----------%--------------------------------------|----|------|-|-----------
--------|----|%----%-%||%|----%%%%|----%-|-%-|||%-%--|||-------%-%%---%---|---%----%-|----%%%%%--%--%-----------%-----%-----|----|------%%|-%-%-%-----
%%%%%%%%|%---||---%|-|||||----|||||%%--|-|-|-||||-|%%|||--%----|-||---|---|-%-|----|-|%%--|||||--|--|-----------|-%-%-|-%-%-|----|-----%|||-|-|-|-----
||||||||||XXX||XXX||-|||||--XX|||||||XX|X|X|XXXX|X||||||-X|X---|-||X--|X--|-|X|XX--|X|||--|||||--|--|X--X-X-XX--|-|X|X|X|X|X|XXXX|X-XXX||||X|X|X|X-XXX