------------------------------------------------------------------------------------------------------------------------------------------------------
------------------------------------------------------------------------------------------------------------------------------------------------------
------------------------------------------------------------------------------------------------------------------------------------------------------
------------------------------------------------------------------------------------------------------------------------------------------------------
------------------------------------------------------------------------------------------------------------------------------------------------------
------------------------------------------------------------------------------------------------------------------------------------------------------
------------------------------------------------------------------------------------------------------------------------------------------------------
------------------------------------------------------------------------------------------------------------------------------------------------------
------------------------------------------------------------------------------------------------------------------------------------------------------
-----------------------------------------------------------S------------------------------------------------------------------------------------------
----------------%-------------------------------%--------------------------------------------------------------------%---------------S----------------
----------------|--------------------------%----|--------------%--------S---------------%--%-------------------------|--------------------------------
----------------|---%%%-------------%----%-|----|----%%%%%-%---|----------------%-%-----|--|%---t-------%----------%-|-----%%%----%%---%-%%---%%------
---------------%|---|||-----------%%|----|-|----|----|||||-|---|%---------------|-|--%--|--||---t%------|-g----%---|%|-----|||----||---|-||---||------
%%%%%%%%-------||-%%|||%%---------|||----|-%---%|----|||||-|---||----%--%-----%-|%|%-|-%|%-||---%|%----%|------|-%-|||%----|||----||-%-|-||-%-||%---%%
||||||||XXXXXXX||X|||||||XXX--X---|||--XX|-|XXX||X-XX|||||X|XXX||----|--|XXXXX|X||||X|X|X|X||XXX|||XX-X||-XXXXX|X|-X|||XXX-|||XXXX||-|-|X||X|-|||XXX||