------------------------------------------------------------------------------------------------------------------------------------------------------
------------------------------------------------------------------------------------------------------------------------------------------------------
------------------------------------------------------------------------------------------------------------------------------------------------------
------------------------------------------------------------------------------------------------------------------------------------------------------
------------------------------------------------------------------------------------------------------------------------------------------------------
------------------------------------------------------------------------------------------------------------------------------------------------------
------------------------------------------------------------------------------------------------------------------------------------------------------
------------------------------------------------------------------------------------------------------------------------------------------------------
----------------------------%---------------------------------S---------------------------------------------------------------------------------------
----------------------------|-------------------------------------------------------------%-----------------------------------------------------------
---------------%------------|-------------------------------------------------------------|----------------------------------%------------------------
---------------|------------|--------%------------------------%---------------------------|-------%--------------------------|------------------------
----------%----|------------|%%%---%-|-S-%------------%-------|-----%-%--%%%%---------%---|-----%%|-------%-%--%-------%--%--|%-----------%----%------
----------|----|------------||||---|-|---|---%------%%|------%|--%--|-|--||||-%-------|---|-%---|||----%-%|%|--|-------|--|--||--%-%-----%|----|------
%%%%%%%%--|----|------------||||-%%|-|---|-%-|%-----|||---%%-||--|-%|-|--||||%|--%----|---|-|---|||---%|-||||--|-------|%%|%-||-%|-|-----||-%%%|------
||||||||XX|XX-X|XX---XXXX-XX||||X|||X|XXX|X|X||X-XX-|||-X-||X||XX|X||-XX-||||||--|XX-X|XXX|XXX-X||XXXX||X||X|XX|--XXXXX|||||X||-||-|--XXX||X||||XX--XX