------------------------------------------------------------------------------------------------------------------------------------------------------
------------------------------------------------------------------------------------------------------------------------------------------------------
------------------------------------------------------------------------------------------------------------------------------------------------------
------------------------------------------------------------------------------------------------------------------------------------------------------
-----------------------%------------------------------------------------------------------------------------------------------------------------------
-----------------------|------------------------------------------------------------------------------------------------------------------------------
-----------------------|------------------------------------------------------------------------------------------------------------------------------
-----------------------|------------------------------------------------------------------------------------------------------------------------------
-----------------------|-----------------------------------------------%------------------------------------------------------------------------------
-----------------------|-----------------------------------------------|------------------------------------------------------------------------------
-------------------%---|-----------------------------------------------|-----------------------%--------------S-----%---------------------------------
-------------------|---|----T----------------------------------------%-|-----------------------|--------------------|---------------------------------
---------%%--------|---|----t%-%-----%---%--%---%-%--%---------------|-%--%%-------------------|-%----%%%----------%|----------------------%--%-------
---------||-%%-%---|---|----t|-|-----|%--|--|-%%|-|--|--g------------|-|--||-------------------|-|----|||---------%||----%------%-%%%------|--|-------
%%%%%%%%%||-||-|---|%-%|---%%|-|-----||%-|--|-|||-|%-|---------------|-|--||-%----%%---------%%|-|----|||%%%-%%---|||----|---%%-|-|||%-----|%%|-------
|||||||||||X||X|XXX||X||XXX|||X|XXXXX|||-|XX|-|||X||X|XXXXX-XX-XXXXXXXX|-X||X|XXXX||XXXX----X|||X|--X-||||||X||X--XX|XXX-|XX-||X|X||||XXXXX||||XXX-X--