------------------------------------------------------------------------------------------------------------------------------------------------------
------------------------------------------------------------------------------------------------------------------------------------------------------
------------------------------------------------------------------------------------------------------------------------------------------------------
------------------------------------------------------------------------------------------------------------------------------------------------------
------------------------------------------------------------------------------------------------------------------------------------------------------
------------------------------------------------------------------------------------------------------------------------------------------------------
------------------------------------------------------------------------------------------------------------------------------------------------------
---------------------------%--------------------------------------------------------------------------%-----------------------------------------------
---------------------------|----------%---------------------------------------------------------------|-----------------------------------------------
---------------------------|----------|-------------------------------------------------------------%-|-----------------------------------------------
---------------------------|------%---|-----------------------%---------------#---------------------|-|-----------------------------------------------
---------%-----------------|------|--%|-----------------------|----%------%---#----------%-----S----|-|-----%-----------------------------------------
---------|-----------------|---%--|--||----------%------------|----|-----%|---%%%%---%---|----------|%|-----|----------------%%-------%---------------
---------|-------------%---|--%|--|%-||----------|----------%-|----|%----||---||||---|---%--%------%||%-----|----%-----------||------%|---------------
%%%%%%%%%|----%--------|-%%|--||--||-||--------%%|%---%%%-%-|-|-%--||%%--||---||||---|---|--|------||||-----|%%--|---%-------||----%-||-%%-%-%%-------
|||||||||XXXXX|X-XX-XX-|X|||-X||XX||X||-XX-XXXX||||XXX|||-|-|X|X|XXX|||XX||XX-||||-XX|XX-|-X|-XXXXX||||---X-|||XX|XXX|XXX--XX||XXX-|X||X||X|X||XXXX-XX