------------------------------------------------------------------------------------------------------------------------------------------------------
------------------------------------------------------------------------------------------------------------------------------------------------------
------------------------------------------------------------------------------------------------------------------------------------------------------
------------------------------------------------------------------------------------------------------------------------------------------------------
------------------------------------------------------------------------------------------------------------------------------------------------------
------------------------------------------------------------------------------------------------------------------------------------------------------
------------------------------------------------------------------------------------------------------------------------------%-----------------------
------------------------------------------------------------------------------------------------------------------------------|-----------------------
-------------%----------------------------------------------------------------------------------------------------------------|-%---------------------
-------------|-%---%-----------%----------------------------------------------------------------------------------------------|-|---------------------
-------------|-|---|------%----|--%---------------------------------------------------------------------------------%---------|-|---------------------
-------------|%|---|------|--%-|-U|k-------------------------------------------------------------------------%------|---------|-|----%----------------
-------------|||---|%-----|--|-|--|-----------------------------------%-----%--------%--------------%%-------|----%%|--------%|-|----|----------------
-------------|||--%||-%-%-|--|%|--|------%---%%%-%%----%------%-------|-----|-%--%%--|--------------||-%--%--|%---|||--------||-|----|%---------------
%%%%%%%%%%---|||--|||-|%|-|-%|||%-|---%--|-%%|||-||----|%-----|-----%%|-----|-|%-||--|-----------%-%||-|--|-%||---|||%-------||-|%%--||%%-%---------%-
||||||||||XXX|X|XX|||X|||X|-|||||X|XXX|XX|X|||||X||XXX-||-XXXX|XXXXX|||-XXXX|X||X||XX|XXXX--X-XXX|X|||X|XX|X|||XXX||||XXXXXXX||-|||XX||||-|XXXX-XXXX|X