------------------------------------------------------------------------------------------------------------------------------------------------------
------------------------------------------------------------------------------------------------------------------------------------------------------
------------------------------------------------------------------------------------------------------------------------------------------------------
------------------------------------------------------------------------------------------------------------------------------------------------------
------------------------------------------------------------------------------------------------------------------------------------------------------
----------------------------------------------------------------------------------------------------------------------------------------------%-------
----------------------------------------------------------------------------------------------------------------------------------------------|-------
----------------------------------------------------------------------------------------------------------------------------------------------|-------
----------------%---------------------------------------------------%-------------------------------------------------------------------------|-------
----------------|---------------------------------------------------|-------------------------------------------------------------------------|---t---
----------------|---------------------------------------------------|------------------------------------------------------------%------------|---t---
----------------|---------------------------------------------------|---------------------------------------------------------%%-|----g-------|---t---
----------------|--%---%------%---%-------------------------%-------%----------------%%-%----------------------%--------------||-|--------%---|---%---
----------------|--|-%-|------|---|----%%-%--%-------%-%----|-------|-----------%----||%|-%%%%----------%------|--------%-%%%-||-|------%-|---|---|%--
%%%%%%%%--------|--|-|-|------|---|----||-|-%|-%---%-|-|%--%|-------|----%-%-%--|----||||-||||----------|------|---%%---|-|||-||-|-%----|-|---|---||-%
||||||||--XX--XX|XXXX|X|XXX--X|XXX|XXXX||X|X||X|XXX|X|X||XX||XXXXXXX|XXXX|X|X|XX|X---|||XX||||--XXXX-XX-|XXXXXX|X--||-XX|X|||X||-|X|XXX-|X|XXX|XXX||X|