------------------------------------------------------------------------------------------------------------------------------------------------------
------------------------------------------------------------------------------------------------------------------------------------------------------
------------------------------------------------------------------------------------------------------------------------------------------------------
------------------------------------------------------------------------------------------------------------------------------------------------------
-----------------------------------------------------------------------D------------------------------------------------------------------------------
------------------------------------------------------------------------------------------------------------------------------------------------------
------------------------------------------------------------------------------------------------------------------------------------------------------
-------------------------------------------------------------------------------------------%----------------------------------------------------------
-------------------------------------------------------------------------------------------|-------------------------------------------------------%--
-----------------------------------------------------------------------D-------------------|---------------%-----------%---------------------------|--
----------------------------------------g--------------------------------------------------|--%------------|-----------|---------------------------|--
----------------------t--------------------%-----------------------------------------------|--|------------|-----------|-----------------%---------|--
----------------------T----------------%---|---%---%------%----%-------------%%------------|--|-----------%|-----------|---%-------%-----|%--------|-%
---------------%------t----%%--%%--%--%|---|---|---|------|-%--|-------------||---------%-%|--|%%%%%%%----||--%--------|---|%------|---%-||--------|-|
%%%%%%%%-%-%%--|-----%%----||--||--|--||%--|%-%|---|------|-|--|------%------||-%-------|-||--||||||||----||--|--------|---||----%-|---|-||%%------|-|
||||||||X|X||-X|XXXXX||-XX-||--||--|XX|||--||X||XXX|XXXXXX|-X--|--X-XX|XXX---X|X|XX--XX-|X||X-||||||||-XXX||XX|XXXX----|XXX||XXXX|X|X--X-X|||XXXXX-|-|