------------------------------------------------------------------------------------------------------------------------------------------------------
------------------------------------------------------------------------------------------------------------------------------------------------------
------------------------------------------------------------------------------------------------------------------------------------------------------
------------------------------------------------------------------------------------------------------------------------------------------------------
------------------------------------------------------------------------------------------------------------------------------------------------------
------------------------------------------------------------------------------------------------------------------------------------------------------
------------------------------------------------------------------------------------------------------------------------------------------------------
------------------------------------------------------------------------------------------------------------------------------------------------------
------------------------------------------------------------------------------------------------------------------------------------------------------
------------------------------------------------------------------------------------------------------------------------------------------------------
---------------%---------------------------------------%--------------------------------------------------------%-------------------------------------
---------------|---%-%------------%---------------%%---|-------------------------------------------------------%|------------U------------------------
---------------|---|-|-%--%----%--|---------------||---|---------%%------%-----%--------%%-----------%---------||%--------------%%%-------------%%----
---------------|--%|-%-|--|%---|--|---------------||%--|--%-%--%-||------|--%--|-%---%--||-----%%---%|-----%-%%%||-%------%----%|||-------------||%---
%%%%%%%%-------|--||-|%|--||---|%-|%------------%-|||-%|%-|%|%-|-||%-----|--|-%|-|--%|%%||---%%||---||-----|%|||||-|---%--|-%--||||----------%--|||--%
||||||||XXXXXXX|-XX|XX|XXXXXX--||XX|XXXXXXXXXXXX|X|||X|||-||X|X|X|||---XX|-X|X||-|-X||||||X-X||||XXX||XXXXX|||||||X|XXX|XX|-|X-X|||-XXXXXXX--|X-|||XX|