------------------------------------------------------------------------------------------------------------------------------------------------------
------------------------------------------------------------------------------------------------------------------------------------------------------
------------------------------------------------------------------------------------------------------------------------------------------------------
------------------------------------------------------------------------------------------------------------------------------------------------------
------------------------------------------------------------------------------------------------------------------------------------------------------
-----------------------------------------------------------------------------------------------------------------------------------------------S------
---------------------------------------------------------S--------------------------------------------------------------------------------------------
------------------------------------------------------------------%----------------------------------S------------------------------------------------
------------------------------------------------------------------|---------------------------------%------------------------------------------%------
------------------------------------------------------------------|---------------------------------|------------------------------------------|------
---------------------------------------------------------%--------|----%------%-------------%-------%------------%%----------------------------|------
---------------------------------k----------%------------|%-------|----|------|-------------|-------|%----------%||----------------------------|------
----------------%%-------%--%-----%---------|------------||-------|-%%-|--%---|---%------%%%|---%---||%%----%%--|||-%--------------%%%%%-%%----|%---%-
----------------||-------|--|-----|----%----|%-----------||-----%-|-||-|-%|---|---|%-----||||%%-|---||||--%-||--|||-|%%%-----%%----|||||-||----%|---|-
%%%%%%%%--%-----||-%-----|--|%----|----|---%||----%------||-----|-|-||-|-||--%|---||---%-||||||-|---||||--|-||%%|||%||||-%---||----|||||-||-%--||---|%
||||||||XX|XXXX-||X|XXXXX|--||-X-X|X-XX|-XX|||XXXX|XXXXXX|XXXXX-|X|-||X|-X|XX||XXX||X--|-||||||X|XXX||||-X|-||||||||||||X|X-X||XXX-|||||-||X|X-||-XX||