------------------------------------------------------------------------------------------------------------------------------------------------------
------------------------------------------------------------------------------------------------------------------------------------------------------
------------------------------------------------------------------------------------------------------------------------------------------------------
------------------------------------------------------------------------------------------------------------------------------------------------------
------------------------------------------------------------------------------------------------------%-----------------------------------------------
-----------------------------------------------------------------D------------------------------------|-----------------------------------------------
--------------------------------------------------------------------------------------%---------------|-----------------------------------------------
-----------------------D---------------------------------------------%----------------|---------------|----%------------------------------------------
---------------------------------------------------------------------|----------------|---------------|----|------------------------------------------
---------------------------------------------------------------------|----------------|---------------|----|------------------------%-----------------
-----------------------%---------------------------------------------|-----------%%---|---------------|----|------------------------|------T----------
-----------------------|---------------%-------------------------%---|-----------||---|---------------|----|------------------------|-%----t----------
-------------%%%-------k----------%----|%------------------------|---|-%---------||---|------%-----%-%|----%-----%---%-%%%---%----%-|-|-%--%%%--------
-------------|||%------|%---------|%---||---%-----%-------%------|---|-|-----%---||---|------|%----|-||----|-----|---|%|||---|----|-|%|K|--|||--%--%--
%%%%%%%%%----||||-%----||---------||%--||--%|-----|%----%-|------|---|-|-%---|---||---|-----%||--%-|-||----|-----|%--|||||--%|----|-|||%|--|||--|%-|--
|||||||||XXXX||||-|XXXX||XXXXXXXXX|||XXX|--||XXXX-||---X|X|-XX---|XXX|-|-|XXX|X-X||XXX|-XXXX|||XX|X|X||X--X|XXXXX||-X|X|||-X||--XX|X|||||XX|||XX||X|XX