------------------------------------------------------------------------------------------------------------------------------------------------------
------------------------------------------------------------------------------------------------------------------------------------------------------
------------------------------------------------------------------------------------------------------------------------------------------------------
------------------------------------------------------------------------------------------------------------------------------------------------------
------------------------------------------------------------------------------------------------------------------------------------------------------
----------------%-------------------------------------------------------------------------------------------------------------------------------------
----------------|------------------------------------------------------------------------------------%%-----------------------------------------------
----------------|------------------------------------------------------------------------------------||-------------%---------------------------------
----------------|------------------------------------------------------------------------------------||------------C|---------------------------------
----------------|-------------------------------------------%----------------------------------------||-------------|---------------------------------
----------------|----------------------------------%--------|--%-------------------------------------||---%--------r|---------------------------------
----------------|----------------------------------|--------|--|-------------------------------------||---|--%%---%%|---------------------------------
----------------|--%-%-----------------------------|-%----%-|--|---%-------%-----%-----------%-------||---|--||---|||-----------------%%%%-%---%------
----------------|--|-|--------------%--------------|-|----|%|%%|---|-------|%----|%-----%%---|-------||---|%-||-%-|||-----------------||||-|---|--%%--
%%%%%%%%%--%%%--|-%|-|--%%--------%-%%---------%---|-|----||||||-%%|-----%%||----||-----||---|-------||---||-||-|-|||-----%-----%-----||||-|%--|--||%-
|||||||||XX|||XX|-||X|--||-XXX-XXX|X||X-XX-XXXX|-XX|X|-XXX||||||-|||XX-XX||||X--X||-XX-X||XXX|XXXXXXX||XXX||X||X|X|||-XX--|-XXXX|-XXXX||||X||XX|XX|||X