------------------------------------------------------------------------------------------------------------------------------------------------------
------------------------------------------------------------------------------------------------------------------------------------------------------
------------------------------------------------------------------------------------------------------------------------------------------------------
------------------------------------------------------------------------------------------------------------------------------------------------------
------------------------------------------------------------------------------------------------------------------------------------------------------
------------------------------------------------------------------------------------------------------------------------------------------------------
------------------------------------------------------------------------------------------------------------------------------------------------%-----
------------------------------------------------------------------2----------------------------------------------------------------------------D|-----
------------------------------------------------------------------------------------------------------------------------------------------------|-----
------------------------------------------------------------------------------------------------------------------------------------------------|-----
----------------------------------%-----------------------------------%---------%---------------------------------------------------------------|-----
------------------------S---------|-----------------------------------|--------%|------%---%-----%----------%-----------------------------------|-----
--------%----%--------------------|------%------%--------------------%|-%------||------|---|-----|----------|---%-------------------------------|----%
--------|----|--------------------|------|%%--%-|---------------%-%--||-|------||------|---|----%|----------|---|----------%-------------------%|---%|
%%%%%%%%|%%--|--------%----%------|---%--|||%-|%|---------------|-|--||-|--%%--||--%%--|---|--%-||----------|--%|--%%%%--%-|%------%-----------||%--||
|||||||||||XX|XXXX--XX|XXXX|XXXXXX|XXX|XX||||X|||X---X--XX-X-XXX|X|XX||X|XX||XX||XX||-X|X-X|-X|X|X--XXXXXXX-|XX||XX||||--|X||XXXXXX|XXXX--XXXXX|||X-||