------------------------------------------------------------------------------------------------------------------------------------------------------
------------------------------------------------------------------------------------------------------------------------------------------------------
------------------------------------------------------------------------------------------------------------------------------------------------------
------------------------------------------------------------------------------------------------------------------------------------------------------
------------------------------------------------------------------------------------------------------------------------------------------------------
-------------------------------------------------------------%----------------------------------------------------------------------------------------
-------------------------------------------------------------|----------------------------------------------------------------------------------------
-------------------------------------------------------------|--------------------------------------------------------------------------%-------D-----
-------------------------------------------------------------|--------------------------------------------------------------------------|-------------
--------------------------------------%----------------------|--------------------------------------------------------------------------|------------%
--------------------------------------|----------------------|--------------------------------------------------------------------------|------------|
--------------------------------%-----|------%---------------|-------------------------------------------------------------------------%|------------|
--------------%-%-%-------------|-----|------|----%-----%%---|-%%-%%%-----%--%------%------------------------------------%---%------%-%||---%--------|
--------------|-|%|-------------|----%|%%%---|----|-----||---|-||-|||%%---|--|------|-----%-----------%------%----------%|%--|--%%%%|-|||%--|%%------|
%%%%%%%%----%%|-|||-%---%%%----%|----|||||-%-|----|----%||%%-|-||-|||||---|%%|%-----|---%%|-------%---|------|-%%-------|||--|--|||||-||||--|||--%%--|
||||||||--XX|||-|||X|X-X|||-XXX||XXXX|||||-|-|XXXX|XXXX|||||-|-||X|||||XX-|||||--XXXXXXX||XXXXXXXX|XXX|XXXX-XXX||X--X---||X-X|X-|||||X|X||-X|X|X-||-X|