------------------------------------------------------------------------------------------------------------------------------------------------------
------------------------------------------------------------------------------------------------------------------------------------------------------
------------------------------------------------------------------------------------------------------------------------------------------------------
------------------------------------------------------------------------------------------------------------------------------------------------------
------------------------------------------------------------------------------------------------------------------------------------------------------
------------------------------------------------------------------------------------------------------------------------------------------------------
------------------------------------------------------------------------------------------------------------------------------------------------------
----------------------------------------------------------------------------%-------------------------------------------------------------------------
---------------------------------------%------------------------------------|--------S--------------------------------------------------%-------------
---------------------------------------|------------------------------------|----------------------------------------------%------------|-------------
---------------------------------------|------------------------------------|--------#-------------------------------------|------------|-------------
---------------------------------%-----|-----%-----------------C-----------g|--------#-------------------------------------|------------|-------------
-----------------%%%--%%---------|%%---|---%-|-%-%----%--------------%----%-|--------#---------------%-----%--%-%----%-----|------------|--%----------
---------%-%--%--|||--||---------|||-%%|---|-|-|-|----|-----------%-%|----|-|--%----%%--------%------|-----|--|-|----|-----|--%---------|-%|---%------
%%%%%%%%%|-|-%|--|||--||---------|||-|||---|-|-|-|----|%--------%-|-||----|-|%-|---%||--------|------|-%%--|--|-|-%--|%--%-|--|---------|-||-%%|----%-
||||||||||-|X||XX|||XX||--XXX--X-X||X|||XXX|X|X|X|XXXX||XXXXXX-X|XXX||XXXX|X||X|XXX|||XXXXXXXX|X-XXX-|-||XX|XX|X|X|X-||XX|X|XX|XX-XXXXXX|XX|-|||----|X