------------------------------------------------------------------------------------------------------------------------------------------------------
------------------------------------------------------------------------------------------------------------------------------------------------------
------------------------------------------------------------------------------------------------------------------------------------------------------
------------------------------------------------------------------------------------------------------------------------------------------------------
------------------------------------------------------------------------------------------------------------------------------------------------------
------------------------------------------------------------------------------------------------------------------------------------------------------
------------------------------------------------------------------------------------------------------------------------------------------------------
------------------------------------------------------------------------------------------------------------------------------------------------------
------------------------------------------------------------------------------------------------------------------------------------------------------
------------------------------------------------------------------------------------------------------------------------------------------------------
--------------------------------------------------------------------------------------%---------------------------------------------------------------
--------------------------------------------------------------------------------------|--------------%-----------%---------------%--------------------
-----------------------------------%-----%--------%-----------------%-----%%%%--------|-%------------|---%%%-----|---------------|------%-----%-------
---------------------------------%-|---%%|---%----|-----%%-------%%-|--%--||||--------|-|------------|---|||-----|------%--------|----%-|-----|----%--
%%%%%%%%---------------%---------|-|---|||---|%---|-----||--%---%||-|--|--||||----%---|-|------------|---|||-----|------|--------|----|-|---%-|----|--
||||||||XX-XXXXXXXXXXXX|XXX--XXX-|-|-XX|||X-X||X-XX-XXXX||-X|XX-|XX-|XX|--||||XXXX|X-X|XXXXXXXXX---XX|-XX|||XXXX-|-XXXXX|-X-XXXXX|-X-X|-|X--|-|XXX-|--