------------------------------------------------------------------------------------------------------------------------------------------------------
------------------------------------------------------------------------------------------------------------------------------------------------------
------------------------------------------------------------------------------------------------------------------------------------------------------
------------------------------------------------------------------------------------------------------------------------------------------------------
------------------------------------------------------------------------------------------------------------------------------------------------------
------------------------------------------------------------------------------------------------------------------------------------------------------
-----------------------------------------------------------------------------------------------------------------------%------------------------------
---------------------------------------------------------------------------------%-------------------------------------|------------------------------
------------------------------------------------------------------%--------------|-----------------%----------C--------|------------------------------
--------------#---------------------------------------------------|--------------|--------%--------|-------------------|------------------------------
--------------#---------------------------------------------------|--------------|--------|--------|%------------------|------------------------------
--------------%---------------------------------------------------|--------------|----%---|-%------||------------------|------------------------------
--------------|-------%----------%%%-----------%-%---------------%|------------%-|----%%--|-|%-----||---------%--------|---%-----------%%-------%---%-
--------------|----%-%|----------|||--------%--|-|---------------||------------|-|--%-||--|-||--%--||---------|--%%----|---|-----------||-%%-%%%|--%|-
%%%%%%%%%---%%|%%%-|-||%--%------|||-----%--|--|-|---------------||%-%-%----%--|-|--|-||%%|-||--|--||---------|--||----|%--|%-%--------||-||-||||-%||-
|||||||||XXX||||||X|-|||-X|XXXXXXXX|---XX|XX|XX|X|X-X--XXXXXXXXXX|||X|-|---X|--|X|XX|X|X|||X||-X|-X||XXXXXXX-X|X-||-XXX||-X||X|XX-XXXXX||X||-||||X|X|-