------------------------------------------------------------------------------------------------------------------------------------------------------
------------------------------------------------------------------------------------------------------------------------------------------------------
------------------------------------------------------------------------------------------------------------------------------------------------------
------------------------------------------------------------------------------------------------------------------------------------------------------
------------------------------------------------------------------------------------------------------------------------------------------------------
---------------------------S--------------------------------------------------------------------------------------------------------------------------
--------------------------------------------------------------------------------------------------------------------S---------------------------------
---------------------------S--------------------------------------------------------------------------------------------------------------------------
---------------------------------------------S----------------------------------------------------------------------S-----------%---------------------
---------------------------------------------------------------------------------------------------------------%---------------%|---------------------
----------------------------------------------------------------------------%----------------------------------|-----------%---k|---------------------
--------------------2------%-----------------%------------------------------|%--%--k----%----------------------|-----------|---||--g------------------
---------%---------------%-|-%------%---%%-%-|%-%-------%---%----%%---------||--|---%%-%|%--%-------%-------%--|----%-%----|---||%%--------%%-----%---
---------%---------------|-|%|------|---||-|-||-|---%---|---|----||---------||--|-%-||-|||--|-------|-------|%%|%---|-|----|--%||||-%-%%%%-||-----|---
%%%%%%%%-|---------------|-|||------|---||-|-||-|---|---|---|----||----%----|%--|%|-||-|||--|%------|-%--%%%|||%|%--|-|---%|%%|%|||-|%||||-||---%-|%%-
||||||||X|-XXXXXXXXXXX-XX|-|||XXXXX-|X-X||-|-||-|X-X|XXX|-XX|XX--||XXXX|XX-X||-X|||X||X|||XX||XXXXXX|-|--|||||||||X-|X|X--|||||||||XX|||||X||XXX|-|||-