------------------------------------------------------------------------------------------------------------------------------------------------------
------------------------------------------------------------------------------------------------------------------------------------------------------
------------------------------------------------------------------------------------------------------------------------------------------------------
------------------------------------------------------------#-----------------------------------------------------------------------------------------
------------------------------------------------------------%------------------------------%----------------------------------------------------------
------------------------------------------------------------|------------------------------|----------------------------------------------------------
------------------------------------------------------------|------------------------------|----------------------------------------------------------
------------------------------------------------------------|------------------------------|----------------------------------------------------------
------------------------------------------------------------|------------------------------|----------------------------------------------------------
------------------------------------------------------------D------------------------------|-------------------------------------------%--------------
------------------%------------------------------------------------------------------------|-------------------------------------------|--%-----------
--------------%---|------%---------------%-------------------------------------------------|---------------------------------------g---|--|-----------
---------%-%--|---|------|-----%---------|----%----%--------------------------------%----%%|---%------%%-----%%%-----%%%-%%%--------%%-|--|----%---%--
---------|-|%-|---|------|-----|--%---%--y----|----|----%%-%--%---%--%%%------------|----|||---|----S%||%----|||-----|||-|||-----%--||-|--|----|%--|--
%%%%%%%%%|-||-|---|%-X%-%|-----|-%|---|--%---%|----|%---||-|--|---|--|||---------%-%|--%-|||---|-----||||---%|||-----|||-|||-----|--||%|--|----||--|-%
||||||||||X||XXX-X||XX|-||XXXXX|-|XXXX|-X|XXX||XXXX||XX-||X|XX|XXX|XX|||XXXXXX--X|X||--|X|||XXX|X-XXXX|||XXX||||X-X--|||X|||XXXXX|-X||||X-|XXXXX|X-|-|