------------------------------------------------------------------------------------------------------------------------------------------------------
------------------------------------------------------------------------------------------------------------------------------------------------------
------------------------------------------------------------------------------------------------------------------------------------------------------
------------------------------------------------------------------------------------------------------------------------------------------------------
------------------------------------------------------------------------------------------------------------------------------------------------------
---------------------------------------------------------------------------------------------------------------------------------------------------%--
----------------%----------------------------------------------------------------------------------------------------------------------------------|--
----------------|-------------------------------------------------------------------------------------------D--------------------------------------|--
----------------|----------------------------------------------------------------------------------------------------------------------------------|--
----------------|----------------------------------------------%-----------------------------------------------------------------------------------|--
----------------|--------------------------------------%-------|-----------%-----------------------------------------------------------------------|--
----------------|--------------------------------------|-------|-----------|-----------------------------------------------------------------------|--
----------------|-------------------%%-----------------|%%%%---|-----------|-----------%-------------------%--------------%--------%--------------%|--
-------------%-%%--------%%---------||--%----%--%--%%--|||||---|-----------|-----------|%-----------%----%%|-%%-%---%-----|--------|---%%----%%---||--
%%%%%%%%%----|-||---%--%-||---------||--|----|%%|--||--|||||%%-|-%%-%-----%|-%%%---%--%||%-%----%-%-|----|||-||%|---|-----|--------|---||--%-||---||--
|||||||||-XXX|X||XXX|XX|X||XXXXXXXXX||XX|XXXX||||--||XX|||||||X|X||X|XXX-X||X|||XXX|XX||||-|XXXX|-|X|-XXX|||-||||XXX|XXXXX|XXXXXXXX|XXX||--|X||-XX||-X