------------------------------------------------------------------------------------------------------------------------------------------------------
------------------------------------------------------------------------------------------------------------------------------------------------------
------------------------------------------------------------------------------------------------------------------------------------------------------
------------------------------------------------------------------------------------------------------------------------------------------------------
----------------------------------------------------------------------------------------------------------------------------------------%-------------
----------------------------------------------------------------------------------------------------------------------------------------|-------------
----------------------------------------------------------------------------------------------------------------------------------------|-------------
-------------------------------------------------------------------------------------------------------D--------------------------------|-------------
----------------------------------------------------------------------------------------------------------------------%-----------------|-------------
----------------------------------------------------------------------------------------------------------------------|%%---------------|-------------
-----------------------------------t---------------------------------------------------------------------------------%|||----%----------|---%---------
---------%--------%--------%-------t--------%------------------------------------------------------------------------||||----|----------|---|---------
---------|----%%--|-%%----%|-------t--------|------------------------%--------%%-%----%%--------------------------%--||||-%--|%--%------%---|--------%
---------|%%%%||--|-||----||---%%--%%-------|------%%-------------%%-|%----%--||-|----||%-------------------------|--||||-|%%||--|%-----|---|--------|
%%%%%%%%%|||||||--|-||----|%%%-||-%||--%%---|-%----||-------------||-||----|%-||-|----|||--%------%-------%--%%%--|--||||-|||||--||--%%-|---|--%--%--|
|||||||||X||||||X-|X||XXXX||||X||X|||XX||-XXXX|XXXX||--XXXX-XXXXXX||X||-XXX||X||X|XXXX|||XX|X--XXX|XX-X-XX|X-|||XX|--||||-|||||-X||XX||X|XXX|XX|XX|X-|