------------------------------------------------------------------------------------------------------------------------------------------------------
------------------------------------------------------------------------------------------------------------------------------------------------------
------------------------------------------------------------------------------------------------------------------------------------------------------
------------------------------------------------------------------------------------------------------------------------------------------------------
------------------------------------------------------------------------------------------------------------------------------------------------------
------------------------------------------------------------------------------------------------------------------------------------------------------
------------------------------------------------------------------------------------------------------------------------------------------------------
------------------------------------------------------------------------------------------------------------------------------------------------------
------------------------------------------------------------------------------------------------------------------------------------------------------
-----------------------------------------------%------------------------------------------------------------------------------------------------------
-----------------------------------------%-----|---------------------------%--------------------------------------------------------------------------
-----------------------------------------|-----|-------------K-S-----------|-----------------------------------------------------------%--------------
----------%-----------%-------%---------%|-%%--|----%%------%%-------------|-------------------------%--------------------%----%%%%--%%|------G-%%%--%
----------|-----------|-----%%|---%-----||-||-%|----||%-----||%------------|------%------------------|%----%-%------------|%---||||--|||---%--%%|||--|
%%%%%%%%--|%------%-%-|-----|||---|-----||%||-||-%--|||%%%-%|||------%-%---|----%%|--%%--------------||-%--|-|------------||---||||--|||---|--|||||--|
||||||||X-||X-XXX-|-|X|X--XX|||XXXXXXXXX|||||X||-|XX||||||X||||XXXXXX|X|XXX|X---|||XX||X-XXXXX-XX-X--||-|-X|X|XXXXXXXXXXX-|XXXX||||XX||XX-X|X-|||||--|