------------------------------------------------------------------------------------------------------------------------------------------------------
------------------------------------------------------------------------------------------------------------------------------------------------------
------------------------------------------------------------------------------------------------------------------------------------------------------
------------------------------------------------------------------------------------------------------------------------------------------------------
------------------------------------------------------------------------------------------------------------------------------------------------------
------------------------------------------------------------------------------------------------------------------------------------------------------
--------------------------------------------------------------------------------------------------------------------------------------t---------------
-----------------------------D--------------------%-----------------------------------------------------------------------------------t---------------
--------------------------------------------------|---------------------%----------------------------------------------%--------------%---------------
---------------------------------------------%----|---------------------|----------------------------------------------|--------------|---------------
-------------------------------%-------S-----|%--%|---------------------|----------------------------------------------|--------------|---------%-----
--------------%--------------%-|-------------||--||---------------------|------%-%------------------%----------------2-|S%----%-------|-%-------|-----
--------------|---%-------%--|-|----------%--||--||------%%%------------|-%---%|-|---%--------------|------------------|-|%---|-------|-|-------|--%--
--------------|---|-%%--%-|--|%|-%--------|%-||%-|%--g%%%|||------------|-|---||-|---|-----%%-------|-----%-----%------|-%|---|-------|-|-----%-|--|--
%%%%%%%%---%--|---|%||--|-|-%|||-|%--%%%--||-|||%||---||||||%--%-%-%---%|-|--%||-|-%%|-----||%------|-----|-----|%-----|-||--%|-------|-|%%-%%|-|--|%-
||||||||-XX|XX|XXX||||XX|X|X||||-||XX|||X-||X||||||XXX|||||||-X|X|X|XXX||X|XX|||X|X|||XXXXX|||XXXXXX|XX-XXXXXXXX||XX-XX|XX|XX||-XXXXX-|XX||X|||X|XX||X