------------------------------------------------------------------------------------------------------------------------------------------------------
------------------------------------------------------------------------------------------------------------------------------------------------------
------------------------------------------------------------------------------------------------------------------------------------------------------
------------------------------------------------------------------------------------------------------------------------------------------------------
------------------------------------------------------------------------------------------------------------------------------------------------------
------------------------------------------------------------------S-----------------------------------------------------------------------------------
--------------------------------------------------------------D---------------------------------------------------------------------------------------
---------------------------------------------%----------------------------------%---------------------------------------------------------------------
---------------------------------------------|----------------------------------|---------------------------------------------------------------------
-----------------------------------%---------|-t---------------S--%----%--------|------------------%------------------------------------C-------------
----------T------------------------|---------|-t---------------k--|----|--------|------------------|---------------%----------------------------------
---------%t------%-----------------|---------|-t------------------|----|--------|----%------------%|---%-----------|--------------------g---------%---
---------|t--%---|--%%---------%---|---------|-t--%---------------|----|--------|----|------%%%t%-||%%-|%----%-----|-%%----------%-------------%%-|---
---------|t--|%--|-%||--------%|%-%%%%%%%%---|-%--|--------%--%---|----|-------%|----|%%---%|||t|%||||-||--%-|%-%--|-||-%---%----|%-%%---------||%|---
%%%%%%%%-|%--||%-|-|||------%-|||-||||||||---|%|--|--------|--|%%-|%%--|-------||----|||---||||%||%|||-||--|-||%|--|-||-|---|----||%||---%-----||||-%-
||||||||X||XX|||X|-|||X-XXXX|X|||-||||||||---|||XX|--------|-X|||-X||XX|XX-XXXX||-XX-|||--X|||||||||||X||XX|X||||XX|X||X|--X|----|||||X-X|XXXX-||||-|X