------------------------------------------------------------------------------------------------------------------------------------------------------
------------------------------------------------------------------------------------------------------------------------------------------------------
------------------------------------------------------------------------------------------------------------------------------------------------------
------------------------------------------------------------------------------------------------------------------------------------------------------
------------------------------------------------------------------------------------------------------------------------------------------------------
-------------------------------------------------------------------------------------------------------------------------------------S----------------
------------------------------------------------------------------------------------------------------------------------------------------------------
------------------------------------------------------------------------------------------------------------------------------------------------------
-------------------------------------------------------------------%----------------S-----------------------------------------------------------------
-------------------------------------------------------------------|----------------------------------------------------------------------------------
----------------------------------------------%--------------------|---------------------------------------------------------------------------C------
---------------------------------------%--%-%-|-----%--------------|-----------------------------------------------------------------%----------------
---------%-----------------%%%--%----%-|--|%|-|-----|--------------|----------------%-----%----%-------%%----------%--------%--------|-----%%%--------
---------|-----------------|||%%|----|-|-%|||-|-----|------%-%%----|---%-------%---%|-----|---%|%----%-||--------%-|--------|--------|-----|||-%------
%%%%%%%%%|%--%%-%----%-----||||||--%-|-|%||||-|-----|------|-||---%|---|--%---%|---||----%|---|||--%-|-||--%-----|-|----%%--|%-%-%---|-----|||%|%-----
|||||||||||X-||X|X---|X-XX-||||||XX|X|X||||||X|XXX--XXXX---|-||X-X||-XX|--|XX-||XXX||XXXX||XX-|||XX|X|-||XX|XX-XX|X|X---||X-||-|X|XXX|X----||||||--XXX