------------------------------------------------------------------------------------------------------------------------------------------------------
------------------------------------------------------------------------------------------------------------------------------------------------------
------------------------------------------------------------------------------------------------------------------------------------------------------
------------------------------------------------------------------------------------------------------------------------------------------------------
------------------------------------------------------------------------------------------------------------------------------------------------------
------------------------------------------------------------------------------------------------------------------------------------------------------
------------------------------------------------------------------------------------------------------------------------------------------------------
------------------------------------------------------------------------------------------------------------------------------------------------------
------------------------------------------------------------------------------------------------------------------------------------------------------
----------------------------------t-------------------------------------------------------------------------------------------------------------------
----------------------------------t-----------------------------------------------%-------------------------------------------------------------------
----------------------------------t-----------------------------------------------|----%--%%--%-------------------------------------------------------
----------------------------------%%-%-%----------%---%-----------------------%---|----|--||--|------%%------%--%2--%--%%-----%-----------------%-----
--------------%----------------%--||%|-|----------|--%|------------%-----%----|---|----|-%||--|-----%||------|--|---|--||-%---|--------------%%-|-----
%%%%%%%%%%----|----%%----------|--||||-|-%-------%|--||----------%-|-%%--|----|-%-|----|-|||%%|-----|||------|--|---|--||-|--%|-%------------||%|-----
||||||||||XXXX|-X-X||XXX---XXXX|XXX|||X|-|X-X-XXX||X-||XXXXXX--XX|X|X||XX|-XX-|X|X|-XXXX-X|||||XXXXX|||XXXX-X|XX|XXX|XX||X|XX||X|XX--XXXXXX-X||||XXX-X