------------------------------------------------------------------------------------------------------------------------------------------------------
------------------------------------------------------------------------------------------------------------------------------------------------------
------------------------------------------------------------------------------------------------------------------------------------------------------
------------------------------------------------------------------------------------------------------------------------------------------------------
------------------------------------------------------------------------------------------------------------------------------------------------------
------------------------------------------------------------------------------------------------------------------------------------------------------
------------------------------------------------------------------------------------------------------------------------------------------------------
------------------------------------------------------------------------------------------------------------------------------------------------------
---------------------%----------------------------------D------------------------------------------%--------------------------------------------------
---------------------|-----------------------------------------------------------------------------|--------------------------------------------------
---------------------|-------------------------------------------------%---------------------------|--------------------------------------------------
---------------------|-----%-------------------------------------------|---------------------------|--------------------------------------------%-----
--------------%%%----%--%--|%-------------%-----%%------%------%-------|--------------------%------|---%------%-------%-%-%%----------%C--%-%%%-|-----
--------------|||%%--|--|%-||-------------|#----||-----%|%--%%-|--%%---|%------------------%|------|---|------|-------|%|-||---%----%%|---|%|||-|-%-%-
%%%%%%%%------|||||--|--||-||--%---%----%-|%--%-||-----|||--||-|-%||-%%||-%---------%%-----||------|%%-|--%---|%------|||-||-%-|-%%%|||---|||||%|-|-|-
||||||||XXXXXX|||||XX|X-||-||XX|XXX|--XX|X||--|X||-XX--|||X-||-X-|||X||||X|XXXXXXXXX||XXXXX||--XXX-|||X|-X|X--||XXX---X||X||-|X|X||||||X--||||||X-|X|-