------------------------------------------------------------------------------------------------------------------------------------------------------
------------------------------------------------------------------------------------------------------------------------------------------------------
------------------------------------------------------------------------------------------------------------------------------------------------------
------------------------------------------------------------------------------------------------------------------------------------------------------
------------------------------------------------------------------------------------------------------------------------------------------------------
--------------------------%---------------------------------------------------------------------------------------------------------------------------
--------------------------|---------------------------------------------------------------------------------------------------------------------------
-------------%---%--------|---------------------------------------------------------------------------------------------------------------------------
-------------|---|--------|---------------------------------------------------------------------------------------------------------------------------
-------------|---|--------|--------------------------------------%------------------------------------------------------------------------------------
-------------|---|--------|-%-----------%------------------------|------------------------------------------------------------------------------------
-------------|---|--------|-|--%--------|------------------------|---------g--------------------------------------------------------------------------
--------%----|---|--------|-|-%|---%%---|-%%------%--------------|----%%-----------------%----------------%---------%----%-----------%--%-%%--%-----%%
--------|----%---|-%-%----|-|-||%--||---|-||------|------------%-|----||%-%-----%--------|----%%%---------|---------|----|%--------%-|--|-||--|-----||
%%%%%%%%|--%-|---|-|-|%---|-|-|||%%||---|-||---%--|--------%-%-|-|----|||-|-%---|--------|----|||------%--|---------|----||-----%--|-|--|-||-%|-%---||
|||||||||XX|X|XXX|X|X||XX-|X|X|||||||-XX|X||XXX|-X|XXXXXXXX|X|-|X|XXXX|||X|-|X--X-XXXX-XX|XXXX|||XXXXXX|X-|XXXX-----|XXXX||-XX--|XX|X|XX|X||X||X|X-X||