------------------------------------------------------------------------------------------------------------------------------------------------------
------------------------------------------------------------------------------------------------------------------------------------------------------
------------------------------------------------------------------------------------------------------------------------------------------------------
------------------------------------------------------------------------------------------------------------------------------------------------------
------------------------------------------------------------------------------------------------------------------------------------------------------
------------------------------------------------------------------------------------------------------------------------------------------------------
------------------------------------------------------------------------------------------------------------------------------------------------------
-------------t---------------------------------%------------------------------------------------------------------------------------------------------
-------------t---------------------------------|------------------------------------------------------------------g-----------------------------------
-------------%---------------------------------|----------------------------------------------------------------------------------%---------%---------
-------------|-----------------t---------------|--%-------------------------S----------%--------------------------%---------------|---------|---------
-------------|-----------------t---------------|--|----------------------------C----%--|--------------------------|--%------------|-----%---|---------
-------------|---------%-------t%-----------%--|--%----%%-----%-%-------------%-----|--|-----%-------%--%----%%---|--%-----%------|---%-|---|---------
-------------|---%-%---|-%-----t|-----------|--|--|----||-----|%|--%-%--------|-%---|--|-----|%------|--|----||---|--|-----|------|---|%%%--|-----%---
%%%%%%%%%-%--|---|%|---|-|---%%%|%%--%%%----|--|%%|%---||-%--%|||--|-|----%%%-|-|%--|--|-----||------|--|----||---|%-|----%|----%-|%--||||%-|-----|---
|||||||||-|X-|--X|||--X|X|XXX||||||XX|||XXXX|-X|||||X--||-|XX||||-X|X|X-X-|||X|XX|XX|--|XXXXX||XXXXXX|XX|XXXX||XXX||XXXXXX|XXXX-|X||XXX||||X|XXXX-|XX-