------------------------------------------------------------------------------------------------------------------------------------------------------
------------------------------------------------------------------------------------------------------------------------------------------------------
------------------------------------------------------------------------------------------------------------------------------------------------------
------------------------------------------------------------------------------------------------------------------------------------------------------
------------------------------------------------------------------------------------------------------------------------------------------------------
------------------------------------------------------------------------------------------------------------------------------------------------------
------------------------------------------------------------------------------------------------------------------------------------------------------
-----------------------------------------t------------------------------------------------------------------------------------------------------------
-----------------------------------------t-%----------------------------------------------------------------------------------------------------------
-----------------------------------------t-|----------------------------------------------------------------------------------------------------------
-----------------------------------------%-|---------g----------------------------------------------t--------------------%----------------------------
---------------------------------------%-|-|--C-------------%---------------------------------------t--------------------|--%------%------------------
---------------%---------------%-------|-|%|-----%%%-%---%--|-----%%%-----%--%----------------------t-%%%----------------|--|------|--%---------------
--------------%|%------------%-|-%---%-|-|||-----|||-|---|--|-----|||-----|--|--%-%-%%%%%---%-------t%|||---------------%|%-|------|%-|-%---%---%----%
%%%%%%%%------|||----%%------|-|-|---|-|-|||-%---|||%|---|%%|--%--|||-----|--|--|-|-|||||---|-------%||||---------%%-%--|||-|------||-|-|---|-%-|--%-|
||||||||X-XXXX|||XXXX||XXXXXX|X|X|X--|X|X|||-|XX-|||||XXX||||XX|XX|||XX-XX|X-|X-|-|X||X||-XX|XXX---X|||||X-XXXXX--||X|X-|||X|XXXX-X||X|X|---|X|X|X-|X|