------------------------------------------------------------------------------------------------------------------------------------------------------
------------------------------------------------------------------------------------------------------------------------------------------------------
------------------------------------------------------------------------------------------------------------------------------------------------------
------------------------------------------------------------------------------------------------------------------------------------------------------
--------------------------------------------------%---------------------------------------------------------------------------------------------------
--------------------------------------------------|---------%----------------------------------------%------------------------------------------------
--------------------------------------------------|---------|----------------------------------------|------------------------------------------------
--------------------------------------------------|---------|----------------------------------------|------------------------------------------------
--------------------------------------------------|---------|----------------------------------------|------------------------------------------------
--------------------------------------------------|-----%---|---------------%------------------------|------------------------------------------------
--------------------------------------------------|-----|---|---------------|-------%----------------|------------------------------------------------
-------------------------------%------------------|-----|---|---------------|-------|----------------|-----------------%---------%--------------------
------------------------%----%-|--------------%-%-C-----|---|------%-%%-----|------%|--%--%-%--------|----%-%----------|---------|---%--%%%---%-%--%--
------------------------|----|-|--%--%--%---%%|-|---%---%%--%%-----|-||-----|------||--|--|-|%-----%-%----|-|--------%%|-------%%|---|--|||---|-|%-|--
%%%%%%%%---------------%|%---|-%--|-%|%-|---|||-|---|---||-%||-----|-||-----|------||%-|--|-||---%%|-|---%|-|%------%||%-%----%|||---|-%|||%--|-||-|--
||||||||XXX--XXXXXXXXXX|||-XX|X|XX|X|||X|XXX|||-|-XX|XXX||X|||XXXXX|X||-XXXX|XXXXXX|||X|XXXX||X-X|||X|XXX|XX||-X-XXX||||X|XXXX||||XXX|X|||||-X|X||-|XX