------------------------------------------------------------------------------------------------------------------------------------------------------
------------------------------------------------------------------------------------------------------------------------------------------------------
------------------------------------------------------------------------------------------------------------------------------------------------------
------------------------------------------------------------------------------------------------------------------------------------------------------
------------------------------------------------------------------------------------------------------------------------------------------------------
------------------------------------------------------------------------------------------------------------------------------------------------------
----------------------------------------------------------------------------------------------------------%-------------------------------------------
----------------------------------------------------------------------------------------------------------|-------------------------------------------
----------------------------------------------------------------------------------------------------------k-------------------------------------------
-----------------------------------t%---------------------------------------------------------------------|-------------------------------------------
-----------------------------------t|---------------------------------------------------------------------|-------------------------------------------
-----------------------------------t|----%---------------------------%------------%----------------------%|-#------%-------------------%--------------
-------------%----------------%%---%|----|--------%%%%-------%-------|---%--------|----------------------||-#-----%|-------%-----%---%-|%%------%-----
------------%|---%----%%-%----||---||----|----%-%-||||-------|-------|---|--------|-------------%%%-%----||-%%----||-------|-%---|---|-|||------|-----
%%%%%%%%----||%--|----||-|-%-%||---||----|%---|-|-||||-------|-------|---|-------%|-------------|||-|----||-||---%||-%-----|-|---|---|-|||%----%|-----
||||||||XXX-|||-X|XXXX||-|X|-|XXX--X|XXXX||XXX|X|X||||XX-XXXX|XX-XX-X|XX-|XX--XXX||XXXX-XXXXXX-X|||X|XXXX||-||XXX||X-|--XX-|-|---|-X-|X||||--XX||-XX-X