------------------------------------------------------------------------------------------------------------------------------------------------------
------------------------------------------------------------------------------------------------------------------------------------------------------
------------------------------------------------------------------------------------------------------------------------------------------------------
------------------------------------------------------------------------------------------------------------------------------------------------------
------------------------------------------------------------------------------------------------------------------------------------------------------
------------------------------------------------------------------------------------------------------------------------------------------------------
------------------------------------------------------------------------------------------------------------------------------------------------------
------------------------------------------------------------------------------------------------------------------------------------------------------
------------------------------------------------------------------------------------------------------------------------------------------------------
------------------------------------------------------------------------------------------------------------------------------------------------------
-----------------------------------------------------------------------------------------------------------------------------------------%--------%---
--------------------------------------%-------#-------------------------%--------------------------------------------------------k---%-%-|--------|---
---------------%%%-------------%%-----|-------%-%--%----%--------------%|------%%-----------%-----%----------------------%-----------|-|-|----%---|%--
----------g%---|||------%------||-----|%------|-|--|----|-%%-----------||-----%||-----------|--%--|-------------%--%-----|-%-%--%-%-%|-|-|%---|%--||--
%%%%%%%%-%-|-%-|||------|-----%||-----||--%---|-|-%|---%|%||-----------||-----|||--%%%--%---|--|--|------------%|%-|-%---|-|-|--|-|-||-|-||%--||--||--
||||||||-|X|X|X|||XXXXXX|-XX-X|||XXXXX||XX|---|-|X||XXX|||X|XXX--XXX---||-XXXX|||X-|||-X|---|XX|XX|X--X-XXXXX--|||X|X|XXX|X|X|XX|X|X||X|X|||--||XX||--