------------------------------------------------------------------------------------------------------------------------------------------------------
------------------------------------------------------------------------------------------------------------------------------------------------------
------------------------------------------------------------------------------------------------------------------------------------------------------
------------------------------------------------------------------------------------------------------------------------------------------------------
------------------------------------------------------------------------------------------------------------------------------------------------------
---------------------------------------------------------------------------------------------------------------------------------------------------D--
------------------------------------------------------------------------------------------------------------------------------------------------------
-----------------------------------------------------------------------------------------------------------------------------------------------S------
------------------------------------------------------------------------------------------------------------------------------------------------------
--------%--------------------------------------------------------------------------------------------------------------------%-----------------S------
--------|--------------------------------------------------------------------------------------------------------------------|----------------------%-
--------|-----------S%-----%--%---%-------------------------%---------%---%--------------------------------------------------|---------------------%|-
--------|------------|-----|--|---|---------%-%------%------|---%---%-%---|%-#---%%-------------------%--------%------%------|--------%-%----------||%
--------|------------|-----|--|---|--%%-----|-|------|------|---|%%-|%|---||%%---||--%----%--%-%%%----|--%--%%-|-%%--%|%--%-%|--------|-|------%---|||
%%%%%%%%|-%-------%%-|-----|--|-%-|--||-----|-|--%---|------|-%-|||-|||---||||%--||--|----|--|%|||%%--|--|%-||-|%||--|||--|%||--------|%|------|--%|||
|||||||||-|-XXXX--||XX---XX|X-|X|X|-X||XX-XX|X|X-|-XX|XXX---|-|X|||-|||XXX|||||XX||-X|XXXX|--|||||||-X|XX||X||X||||--|||-XX|||XXX-XXXX|||--XXX-|-X||||