------------------------------------------------------------------------------------------------------------------------------------------------------
------------------------------------------------------------------------------------------------------------------------------------------------------
------------------------------------------------------------------------------------------------------------------------------------------------------
------------------------------------------------------------------------------------------------------------------------------------------------------
------------------------------------------------------------------------------------------------------------------------------------------------------
------------------S-----------------------------------------------------------------------------------------------------------------------------------
------------------------------------------------------------------------------------------------------------------------------------------------------
------------------------------------------------------------------------------------------------------------------------------------------------------
------------------------------------------------------------------------------------------------------------------------------------------------------
----------%-------%--------------------------------------%--------------------------------------------------------------------------------------------
----------|-------|%-------------------------------------|---%--------------------------------------------------------------%----------g--------------
----------|-------||------%------------------------------|---|---------%----------------------------------------------------|-------------------------
----------|%%%%%--||------|------------------%%%%--%%----|--%|---------|-%-----%--%--%%-------%----------------%-%--%%---%--|-----------%%%-------%---
----------||||||%-||%%----|--------%------%%%||||-%||----|-%||--------%|-|-----|-%|--||---%---|%---------------|%|--||-%-|-%|%%%------%-|||-%-----|%--
%%%%%%%%--|||||||-||||----|---%----|------|||||||-|||----|-|||----%---||-|--%%%|-||--||---|%%-||%%-%%----------|||-g||-|-|-|||||------|%|||-|%%%--||--
||||||||--|||||||X||||XXXX|X-X|XXXX|----XX|||||||X|||XXXX|X|X|--XX|---||X|XX||||-||--||X-X|||X||||X||--XXX-----|||XX||-|-|X|||||X-X--X|||||-||||--||X-