------------------------------------------------------------------------------------------------------------------------------------------------------
------------------------------------------------------------------------------------------------------------------------------------------------------
------------------------------------------------------------------------------------------------------------------------------------------------------
------------------------------------------------------------------------------------------------------------------------------------------------------
------------------------------------------------------------------------------------------------------------------------------------------------------
------------------------------------------------------------------------------------------------------------------------------------------------------
-----------------------------------------------------------------------------------------------------------------------%------------------------------
-----------------------------------------------------------------------------------------------------------------------|----%-------------------------
-----------------------------------------------------------------------------------------------------------------------|----|-------------------------
-----------------------------------------------------------------------------------------------------------------------|----|-------------------------
-------------------------------------------------%---------------------------------------------------------------------|----|------------------------C
-------------------------------------------------|----------------------%-------------%--------------------------------|----|--%----------------------
-------------------------------%%----------------|----------------------|-------------|------------------------%-------|----|--|-----------%---%------
-------------------------%-----||-----------%----|%----%%#--------------|---------%---|--------------%-%-%----%|-------|----|--%-------%%--|---|-----%
%%%%%%%%----------%%-----|%---%||%-%%%%%%---|----||---%||%-----------%--|-----%%-%|---%-------%---%--|-|%|----||---%---|----|--|-------||--|---|-----|
||||||||XXXXX---XX||-XXX-||X--||||X||||||XXX|XXXX||XXX|XX|XXXXXXXXX--|XX|XX---||X||XXX|XXX-XXX|XX-|--|X|||XXXX||XXX|XXX|XXXX|XX|X-XXXXX||XX|XXX|XXXXX|