------------------------------------------------------------------------------------------------------------------------------------------------------
------------------------------------------------------------------------------------------------------------------------------------------------------
------------------------------------------------------------------------------------------------------------------------------------------------------
------------------------------------------------------------------------------------------------------------------------------------------------------
------------------------------------------------------------------------------------------------------------------------------------------------------
------------------------------------------------------------------------------------------------------------------------------------------------------
------------------------------------------------------------------------------------------------------------------------------------------------------
-----------------------------------------------------------------------------------%------------------------------------------------------------------
-----------------------------------------------------------------------------------|------------------------------------------------%-----------------
-----------------------------------------------------------------------------------|------------------------------------------------|-----------------
-------------------------------------------------------------------%---%-----------|------------------------------------------------|-----------%-----
---------------------------------------%---------------------------|---|-----------|----%%-%----------------------------------------|-----------|-----
------------------------------%----%---|-------%#----%-------------|---|-%-%-------|----||-|%---------------------%---%-------------|-----------|-----
-----------------%---%%-------|%---|%--|-------|%--%%|----%--------|---|-|-|%------%----||-||---------------------|---|----g--------|-----------|-----
%%%%%%%%---------|---||%%--%--||---||--|-------||-%|||----|---%----|%%-|%|-||---%--|--%-||-||-------------%------%|---|%----%-------|-%----%--%%|----%
||||||||XXXXXXXXX|XXX||||-X|X-||---||--XXXXXXXX||-||||XXXX|-X-|--XX|||X|||X||XXX|-X|XX|X||XX|-X-X-XX-X-XXX|X-----||XXX||X---|XXXXXX-|X|XXXX|--|||XXXX|