------------------------------------------------------------------------------------------------------------------------------------------------------
------------------------------------------------------------------------------------------------------------------------------------------------------
------------------------------------------------------------------------------------------------------------------------------------------------------
------------------------------------------------------------------------------------------------------------------------------------------------------
------------------------------------------------------------------------------------------------------------------------------------------------------
--------------------------------------------------------------------------------------------------K---------------------------------------------------
------------------------------------------------------------------------------------------------------------%-----------------------------------------
--------------------------------------------------------------------------------------------------%---------|-----------------------------------------
--------------------------------------------------------------------------------------------------|---------|-----------------------------------------
--------------------------------------------%-----------------------------------------------------|---------|-----------------------------------------
-------------------------%-------------%----|-------------------------------------g---------------|---------|---------------------------------------%-
--------------%----------|-------------|----|---------------------------------%-------------------|-----%---|-----------------%---------------------|-
-------------%|----------|-------------%----|---------%--%-%--%---------------|---------%%--------|-----|---|---------%%--%---|-----------------%---|-
--------%----||--%-------|-------------|---%%%--------|--|-|-%|%--%--%-----%--|-----%---||--------|%----|%--|---------||--|---|------------%----|---|-
%%%%%%%%|-%--||%-|-----%-|------------%|---|||------%%|--|-|-|||--|%-|-----|%-|%----|-%-||--------||%---||--|---------||%-|-%-|--------%%--|----|%--|-
|||||||||X|XXXX|X|XXXXX|X|-XXXXXXXXXX-||XX-X||--XXXX|||--XX|X|||-X||X|XXX-X||X||---X|X|X||--XXXXXX|X|XX-X|XX|XX-XX---X|||-|X|-|XXX-X--X||-X|XXXX||--|X