------------------------------------------------------------------------------------------------------------------------------------------------------
------------------------------------------------------------------------------------------------------------------------------------------------------
------------------------------------------------------------------------------------------------------------------------------------------------------
------------------------------------------------------------------------------------------------------------------------------------------------------
------------------------------------------------------------------------------------------------------------------------------------------------------
------------------------------------------------------------------------------------------------------------------------------------------------------
------------------------------------------------------------------------------------------------------------------------------------------------------
-----------------------------------------------%------------------------------------------------------------------------------------------------------
-----------------------------------------------|--------------------------------------%---------------------------------------------------------------
-----------------------------------------------|--------------------------------------|---------------------------------------------------------------
-----------------------------------------------|--------------------------------------|----%----------------------------------------------------------
-----------------------------------------------|--------------------------------------|----|----------------------------------------------------------
----------%--------------------------------%---|-------%---------%-------%%-----------|----|%%%-------------------------%-%%----%%-%--%%--------------
----------|-------------------%------------|-%%|-------|---------|--%----||-----------|---%||||-%-%---------------------|-||----||-|-%||-%-------%-%--
%%%%%%%%-%|------%------%-----|-----------%|-|||-------|%---%----|--|----||----%%-----|---|||||-|-|--------------------%|-||-%--||-|-|||-|-------|-|--
||||||||X||XXX-XX|XXXXX-|XXX-X|XXXXX-XX-XX||X|||XX---XX||--X|XXXX|XX|XXXXX|XXXX||XXXXX|---|||||X|X|-XX---XXXXXXXXXXXX-X||XX|X|X-||X|X|||-|------X|X|XX