------------------------------------------------------------------------------------------------------------------------------------------------------
------------------------------------------------------------------------------------------------------------------------------------------------------
------------------------------------------------------------------------------------------------------------------------------------------------------
------------------------------------------------------------------------------------------------------------------------------------------------------
------------------------------------------------------------------------------------------------------------------------------------------------------
------------------------------------------------------------------------------------------------------------------------------------------------------
------------------------------------------------------------------------------------------------------------------------------------------------------
------------------------------------------------------------------------------------------------------------------------------------------------------
------------------------------------------------------------------------------------------------------------------------------------------------------
--------------------------------------------------------------------%---------------------------------------------------------------------------------
-------------------------------------------------------------%------|------------------------------------------------------%--------------------------
----------------%-------%%-------------------%---------------|------|---------------------%----------------------%%--------|--------------------------
--------------%-|------%||--------%%---------|-----------%%--|------|-------%--%%%------%%|----%-----%------C-%--||--------|-------------%-----------%
--------------|-|------|||--------||----%%---|--%%-------||--|------%%%---%-|--|||%-%---|||----|-----|--------|--||%-------|-------------|----%-%%-%-|
%%%%%%%%%-----|%|--%---||%%---%%--||----||%-%|--||--%----||--|------|||--%|-|--||||-|---|||----|-----|-------%|--|||---%%--|------------%|-%%-|-||-|-|
|||||||||XXXXX|||XX|---||||XXX||XX|X-XXX|||X|XXX||XX|-XXX||XX|XXXXXX||X-X||X|-X||||X|XXX|||XXXX|XX-XX|X--XXXX||XX|||X--||XX|XXX-XX-XXXXX||X||-|X||-|X|