------------------------------------------------------------------------------------------------------------------------------------------------------
------------------------------------------------------------------------------------------------------------------------------------------------------
------------------------------------------------------------------------------------------------------------------------------------------------------
------------------------------------------------------------------------------------------------------------------------------------------------------
------------------------------------------------------------------------------------------------------------------------------------------------------
------------------------------------------------------------------------------------------------------------------------------------------------------
-----------------------------------------------------------------------------------------------------S-------------------------%----------------------
-------------------------------------------------------------------------------------------------------------------------------|----------------------
-------------------------------------------------------------------------------------------------------------------------------|----------------------
--------------------------------------------------%----------------------------------------------------------------------------|----------------------
-------------------------------------------%------|--------------------------------------------------%-------------------------|-----------%----------
----------------------------------------%--|------|--------------------------------------------------|-------------%--%-----%--|----%------|----------
------------%--%------S-%------%--------|--|------|---F%-------------------------------------%-------|--%--%--%-%--|--|-----|--|----|--%---|----------
--------%---|--|-----%--|-----%|---%----|--|------|---%|---%------------------%--%------%----|--%----|--|--|--|-|--|%-|----%|-%|-%%-|--|--%|----------
%%%%%%%%|--%|--|-%%%-|--|----%||---|---%|--|---%--|-%%||---|%%-------%-%%%----|--|------|-X--|--|----|--|-%|%-|-|--||-|----||-||-||-|%-|%-||-%-----%%-
|||||||||-X||XX|X|||-|XXXX---|||--X|-X-|XXX|XX-|X-|-||||XXX|||XXXXXXX|-|||---X|XXXXXXXX-|XX-X|XX|XX-X|--|X|||X|X|XXX|-X-XX-||X||X||X||X||XX|X|X---X||X