------------------------------------------------------------------------------------------------------------------------------------------------------
------------------------------------------------------------------------------------------------------------------------------------------------------
------------------------------------------------------------------------------------------------------------------------------------------------------
------------------------------------------------------------------------------------------------------------------------------------------------------
------------------------------------------------------------------------------------------------------------------------------------------------------
------------------------------------------------------------------------------------------------------------------------------------------------------
------------------------------------------------------------------------------------------------------------------------------------------------------
------------------------------------------------------------------------------------------------------------------------------------------------------
---------------------------------------t--------------r----------------------------------------------------------------------S------------------------
----------%------%---------------------t----------------%---------------------------------------------------------------------------------------------
----------|------|---------------------t--g-----------%-|-------------------------%---------------------------------------------------g-----------%---
----------|------|---------------------%--------------|-|-------------------------|------%--%-----%-----------%-----------------------|----%------|---
----------|--%--%|-------%---%---U---%-|-------%%%----|-|--%---%------------%%----|------|--%-----|-----------|--------------%%-%----%|-%--|------|---
---------%|--|%-||-------|-%-|-------|-|-------|||%---|-|-%|%--|------------||--%-|%-----|-%|-----|-------%-%-|%%------------||-|----||-|--|------|---
%%%%%%%%%||--||-||-------|-|-|--%---%|-|%-%----||||---|%|-|||--|-%%--%%-----||--|-||---%-|-||-----|-%%----|-|-|||-%----------||-|-%%-|%-|--|---%-%|---
|||||||||||XX||X||XXXXXXX|-|X|XX|XXX||X||X|X-XX||||--X|||X|||XX|X||XX||----X|XXX|-||XXX|X|X|X--XXX|X||XXX-|X|X|||X|XXXX-X--XX||-|X||-||X|--|X-X|X||X--