------------------------------------------------------------------------------------------------------------------------------------------------------
------------------------------------------------------------------------------------------------------------------------------------------------------
------------------------------------------------------------------------------------------------------------------------------------------------------
------------------------------------------------------------------------------------------------------------------------------------------------------
------------------------------------------------------------------------------------------------------------------------------------------------------
------------------------------------------------------------------------------------------------------------------------------------------------------
------------------------------------------------------------------------------------------------------------------------------------------------------
------------------------------------------------------------------------------------------------------------------------------------------------------
------------------------------------------------------------------------------------------------------------------------------------------------------
--------------------------------------------------------------------------------------------------------------%---------------------------------------
--------------------------------------------------------------------------------------------------------------|--------------------------------%%-----
-----------------------------------------------------------------------%------------%--------------------%----|--------------------------------||-----
-------------------------------------------------%----------------%--%-|--%-%-------|----------------%%-%|-%--|-----------------------%--------||-----
--------%%----%%---%---%--------#--%--%---------%|----------------|--|-|--|-|-------|-----------%----||-||-|--|---%%---%%%%C%--%----%%|--------||-----
%%%%%%%%||---%||---|-%-|-%-%%--%%--|--|-%%%%%---||-%-%----%%----%-|--|%|--|-|-------|%----%-----|----||-||%|--|---||---||||-|--|----|||-----%--||-----
||||||||||XXX|||-XX|X|X|X|X||X-||XX|XX|X|||||X-X||X|X|XXXX||---X|-|XX|||--|-|XX-XXX-||X-XX|X---X|-XXX||X|X|XXX|XXX||-X-||||X|XX|X-X-|||XXXXX|XX||XX-XX