------------------------------------------------------------------------------------------------------------------------------------------------------
------------------------------------------------------------------------------------------------------------------------------------------------------
------------------------------------------------------------------------------------------------------------------------------------------------------
------------------------------------------------------------------------------------------------------------------------------------------------------
------------------------------------------------------------------------------------------------------------------------------------------------------
---------------------------------------------------%--------------------------------------------------------------------------------------------------
---------------------------------------------------|--------------------------------------------------------------------------------------------------
---------------------------------------------------|--------------------------------------------------------------------------------------------------
---------------------------------------------------|--------------------------------------------------------------------------------------------------
--------------------------------------%------------|----%-------------------------------------------------------------%--%----------------------------
----------------%------------#--------|%-----------|----|-%%----------------------------------------------------------|--|----------------------------
----------------|------------#--------||--%--------|----|-||------------------------------------------%---------------|--|----------------------------
----------%-----|--%%-----%-%%%%------||--|--------|----|-||---------%--------------------------------|---------------|--|----------------------------
--------%-|-----|--||----%|-||||------%|--|-----%--|----|-||-%%-----%|---------------------------%%-%-|%--%-------%%-%|--|--------%----------%------%-
%%%%%%%%|-|--%--|--||----|%-||||------||--|-----|--|----|%||-||---%%||---%---%%----%---%%---%%%--||%|-||%%|-----%%||-||--|--------|%---------|------|%
|||||||||X|XX|XX|XX||XXXX||X||||XXXXXX||XX|XXXXX|--|XXX-||||-||XXX|||XX--|XX-||XX--|XXX||XXX|||X-||||-|||||X--XX||||-||--|XXXXXXX-||XXXXXXXXX|XXXXX-||