------------------------------------------------------------------------------------------------------------------------------------------------------
------------------------------------------------------------------------------------------------------------------------------------------------------
------------------------------------------------------------------------------------------------------------------------------------------------------
------------------------------------------------------------------------------------------------------------------------------------------------------
------------------------------------------------------------------------------------------------------------------------------------------------------
------------------------------------------------------------------------------------------------------------------------------------------------------
-----------------------------------------------------------------------------------------------------------------%------------------------------------
-----------------------------------------------------------------------------------------------------------------|------------------------------------
--------------------------------------------------%--------------------------------------------------------------|------------%----------------%------
--------------------------------------------------|-----------------------------------------g--------------------|-t----------|----------------|------
---------------------------------------%---------%|--------t-----------------------------------------------------|-t-%--------|----------------|------
----------------%------%%--------------|---------||--------t-----------------------------------------------------|-t-|--------|----------------|------
----------------|-%--%-||-----%------%-|----%----||-%---%--t-----%--%%%-%%-%%%%%---%-%----------%---%--%-%------%|-%-|%-------|-------%-%%-----|------
---------%------|-|%-|-||--%%-|----%-|-|--%-|----||-|---|--%----%|--|||-||-|||||---|%|---%%-----|--%|--|-|------||-|-||--%-%%-|%------|-||-----|------
%%%%%%%%-|--%---|-||-|-||X-||%|----|-|-|--|-|----||%|--%|%%|----||--|||-||-|||||-%-|||-%-||----%|-%||--|-|--%%--||%|%||--|-||%||------|%||---%-|-----%
||||||||X|XX|XXX|X||X|-||X-||||---X|-|X|XX|X|XXXX||||XX|||||XX-X||XX|||X||X|||||-|X|||X|-||--XX||-|||XX|X|XX||-X|||||||X-|-|||||--XXXX||||XXX|X|-X-XX|