------------------------------------------------------------------------------------------------------------------------------------------------------
------------------------------------------------------------------------------------------------------------------------------------------------------
------------------------------------------------------------------------------------------------------------------------------------------------------
------------------------------------------------------------------------------------------------------------------------------------------------------
------------------------------------------------------------------------------------------------------------------------------------------------------
---------------------------------------------------------D--------------------------------------------------------------------------------------------
----------------%-------------------------------------------------------------------------------------------------------------------------------------
----------------|-------------------------------------------------------------------------------------------------------------------------------------
----------------|----------------------------------------%--------------------------------------------------------------------------------------------
----------------|----------------------------------------|--------------------------------------------------------------------------------------------
----------------|-------------%%------t--------%---------|----------------------------%------------------------------------------------------------%--
----------%-----|-------------||------t--------|C--------|---------------------%-%----|------------------------------------------------------------|--
----------%%----|%--%---%--%--||-----%%--------|---------|%%-%%-%--------------|-|%---|------%------%%--%--------%------------%--------------%-----%%-
----------||-%--||%-|---|--|--||-----||---%----|---%%%%%-|||-||-|--------%-----|-||--%|------|----%-||--|--------|------------|-----%---%----|-----||-
%%%%%%%%--||-|--|||-|%--|--|%-||---%-||---|----|---|||||-|||-||-|-%%-----|-----|%||--||------|----|-||-%|%-----%-|--%----%-%--|%%---|---|----|%----||-
||||||||-XX|-XXX|||X||XX|XX||X||X-X|X||-XX|X-X-|X-X|||||X|||X||-|X||XXXXX|XXXXX||X|XX||XXX--X|X-XX|X||-|||-XXXX|X|XX|XXXX|X|XX|||XX-|XXX|XXXX||--XX||-