------------------------------------------------------------------------------------------------------------------------------------------------------
------------------------------------------------------------------------------------------------------------------------------------------------------
------------------------------------------------------------------------------------------------------------------------------------------------------
------------------------------------------------------------------------------------------------------------------------------------------------------
------------------------------------------------------------------------------------------------------------------------------------------------------
------------------------------------------------------------------------------------------------------------------------------------------------------
------------------------------------------------------------------------------------------------------------------------------------------------------
------------------------------------------------------------------------------------------------------------------------------------------------------
------------%---------------------------------------------%-------------------------------------------------------------------------------------------
------------|---------------------------------------------|-------------------------------------------------------------------------------------------
------------|---------------------------------------------|------------------------------------------------------------C------------------------------
------------|--%-----%------------------------------------|------------------------------------------------------------------------------------%------
-----------%|%-|--%--|---------------------------%%------%|-------------%%----%-------%%------%%%%%%--%---------%%%----r%%--%%------%-%%%-----%|-----#
-----------|||-|--|-%|-----%%-----%%-----%%-%----||------||%------%-----||--%-|-------||---%--||||||--|-------%-|||----%||--||------|-|||-----||-----#
%%%%%%%%%-%|||-|--|-||---%%||--%%-||--%%%||%|----||------|||------|-----||--|%|----%--||---|--||||||--|---%---|-|||----|||--||------|-|||--%-%||-%%--%
|||||||||-|||XX|XX|X||XXX||||--||X||--|||||||XX--||X--XX-|||X-XXXX|X--XX||XX||XXXXX|X-||XXX|X-||||||XX|XXX|XXX|X|||XXXX|||XX||XXXXXX|X|||-X|-|||-||--|