------------------------------------------------------------------------------------------------------------------------------------------------------
------------------------------------------------------------------------------------------------------------------------------------------------------
------------------------------------------------------------------------------------------------------------------------------------------------------
------------------------------------------------------------------------------------------------------------------------------------------------------
------------------------------------------------------------------------------------------------------------------------------------------------------
-------------------D--------t-------------------------------------------------------------------------------------------------------------------------
----------------------------t-------------------------------------------------------------------------------------------------------------------------
----------%-----------------%-------------------------------------------------------------------------------------------------------------------------
----------|-----------------|------------------------------------------------------------%------------------------------------------------------------
----------|------%----------|-----%------------------------------------------------------|--------S---------------------------------------------------
----------%------|---g------|-----|------%----------------------------------%------------|--------------------------------------%-%------------%------
----------|--%---|-%--------|-----|---%--|----------%-------%---------------|------------|-------%------------------------------|-|------------|------
----------|--|---|%|%--%%---|-----|---|--|----------|-------|----%%---------|----------G%|-------|---------#%-----%%%%-----%-%-%|-|------------|------
----------|--|--%||||--||---%%%---|---|--|----------|%-%----|----||---------|----------%||-------|%------%%%|----%||||----%%-|-||-|-----F-g----|------
%%%%%%%%--|--|--|||||%-||---|||---|---|--|-%-%-%----||-|%-%-|-%--||--%------|--%-------|||-------||------||||----|||||----|%-|-||-|-----%------|--%---
||||||||XX|XX|X-||||||X||XXX|||XX-|XXXXX-|-|X|-|X-XXX|X||X|X|X|XX||--|XXXXX-|XX|X------X||XXX--XX||XXXXX-|X||XXX-|||||X---X|-|X||X|--X-X|XXXXXX|XX|XXX