------------------------------------------------------------------------------------------------------------------------------------------------------
------------------------------------------------------------------------------------------------------------------------------------------------------
------------------------------------------------------------------------------------------------------------------------------------------------------
------------------------------------------------------------------------------------------------------------------------------------------------------
------------------------------------------------------------------------------------------------------------------------------------------------------
----------------------------------------------------------------------%-------------------------------------------------------------------------------
----------------------------------------------------------------------|------------------%------------------------------------------------------------
-----------------------------------------------D----------------------|------------------|------------------------------------------------------------
----------------------------------------------------------------------|---%---%----------|------------------------------------------------------------
----------------------------------------------------------------------|---|---|----------|------------------------------------------------------------
----------------------------------------------------%-----------------|---|---|----------|--------%---%-----------------------------------------------
---------------------------------------------%%%----|--------------g-%|---|---|-%--------|--------|---|------------------------------------%----------
-------------%----%--%-------------------%-2-|||--%-|--%-------%%----||---|---|-|--------|%%------|---|----%---------%--%%-%----%%-%-------|%-%2------
-------------|--%-|--|----------------g--|%--|||--|-|--|-------||----||%--|%%-|-|%----%--|||------|---|-%--|-%-------|--||-|%%--||-|-------%|-|------%
%%%%%%%%%%%--|%%|-|--|----%%-------------||--|||--|-|%-|-%----%||----|||-%|||-|-||----|%-|||-----%|---|-|%-|%|%------|--||-|||--||-|----%--||-|-----%|
|||||||||||X-||||X|XX|XX--||--XXX-X-XXXXX||XX|||-X|X||X|X|X---|||XXX-|||X||||X|X||XXXX||-|||----X||-X-|X||X||||-XXX-X|XX||X|||XX||X|XXX-|XXX|X|XX---||