------------------------------------------------------------------------------------------------------------------------------------------------------
------------------------------------------------------------------------------------------------------------------------------------------------------
------------------------------------------------------------------------------------------------------------------------------------------------------
------------------------------------------------------------------------------------------------------------------------------------------------------
------------------------------------------------------------------------------------------------------------------------------------------------------
----------------------------------------------------------------------------------------------------------------------------------%-------------------
----------------------------------------------------------------------------------------------------------------------------------|-------------------
----------------------------------------------------------------------------------------------------------------------------------|-------------------
----------------------------------------------------------------------------------------------------------------------------------|-------------------
-------------------g--------------------------------------------------------------------------------------------------------------|-------------------
-------------------|--------------------------------------------------------------------------------------------------------------|-------------%-----
------------------%|----------------------%------------------------------------------------------%--------------------------------|----%-------%|-----
-----------------%||----------------------|----------%%------------%---------%-----%-%%-%--%-----|-------%%---%------------------%|----|-------||-----
-----------------||%---%------%%----%-----|-------%%-||-----%%-----|-%%-----%|-%%--|-||-|--|-----|---%---||---|----------%-------|%--%-|-%%----||-----
%%%%%%%%---------|||--%|--%---||--%-|-----|%------||-||-%---||----%|-||%----||-||--|-||-|%%|%----|---|---||--%|-%----%---|-------||--|-|%||----||-%%%%
||||||||XXXXXXXX-|X|-X||XX|--XX|XX|XXXXXXX||-XXXXX||X||X|XX-||-X-X||X|||XXXX||XX|XX|X||X|||||X---|XXX|XX-||XX||X|-XXX|XXX|XXXXXXX||-X|-X|XXXX-XX|X||||