------------------------------------------------------------------------------------------------------------------------------------------------------
------------------------------------------------------------------------------------------------------------------------------------------------------
------------------------------------------------------------------------------------------------------------------------------------------------------
------------------------------------------------------------------------------------------------------------------------------------------------------
------------------------------------------------------------------------------------------------------------------------------------------------------
------------------------------------------------------------------------------------------------------------------------------------------------------
------------------------------------------------------------------------------------------------------------------------------------------------------
------------------------------------------------------------------------------------%------------------------------------S----------------------------
---------------------------%----U---------------------------------------------------|-----------------------------------------------------------------
---------------------------|--------------------------------------------------------|-----------------------------------------------------------------
---------------------------|--------------------------------------------------------|------------------------------------%----------------------------
---------------------------|--------------------------------------------------------|------------------------------------|-------%-----------------S--
-----------------%---------|----%-#-------------%------------------%----------------|----------%----%--------------%---C-|------%|%----------%%--%%--%
-----------------|---%-----|----|-#---%%--------|-------%-----%-%--|----------------|----------|----|---%----------|-----|------|||-U--------||--||--|
%%%%%%%%---%%%---|---|---%-|----|-%---||--------|-------|%--%-|-|--|------%---------|----------|----|---|----%-----|#----|---%%-|||-----%----||--||--|
||||||||---|||XXX|X-X|XX-|X|----|-|XX-||XXXXXX--|XXXXXX-||XX|XXX|--|XXXXXX|XXXXXXXXX|-XX-X--XX-|X--X|X--|XX--|XXXXX|XX-XX|---||X|||XX-X-|XXXXXXXXXXXX|