------------------------------------------------------------------------------------------------------------------------------------------------------
------------------------------------------------------------------------------------------------------------------------------------------------------
------------------------------------------------------------------------------------------------------------------------------------------------------
------------------------------------------------------------------------------------------------------------------------------------------------------
------------------------------------------------------------------------------------------------------------------------------------------------------
------------------------------------------------------------------------------------------------------------------------------------------------------
-------------------------------------------------------------------------------------------------------------%----------------------------------------
-------------------------------------------------------------------------------------------------------------|----------------------------------------
-------------------------------------------------------------------------------------------------------------|---%------------------------------------
---------------------%---------------------------------------------------------------------------------------|---|----------------------%-------------
---------------------|-------------------------------------------------S------%------------------------------|---|-------------%--------|-------------
---------------------|-----------------%------------%----------------%--------|-----------------------------%|--%|---%%%-%----%|--------|--------%----
-------------%-------|-----------------|------------|------%%%-----%-|--%-----|--%-%%%%-%%------------------||--||--%|||%|--%%||-%%--%--|--------|----
-------------|-------|--------%--------|---------%--|%-----|||-----|-|--|-----|--|-||||-||%--------%----%%-%||-%%|%-||||||--||||-||-%|--|-%%-%--%%----
%%%%%%%%%----|-------|---%%%--|--------|---------|--||---%-|||-----|-|-%|-----|--|-||||-|||--------|----||-|||-||||-||||||--||||-||-||--|-||-|%-||-%--
|||||||||XXXX|XXXXXXX|XXX|||-X|XXXXX--XXXXXXXX--X|XX||XXX|X|||XX-XX|X|X||XX---|--|X|||XX|||--X-XXX-|XXXX||X|||X|X||X||||||--||||-||X||--|X||X||XXXX|XX