------------------------------------------------------------------------------------------------------------------------------------------------------
------------------------------------------------------------------------------------------------------------------------------------------------------
------------------------------------------------------------------------------------------------------------------------------------------------------
------------------------------------------------------------------------------------------------------------------------------------------------------
------------------------------------------------------------------------------------------------------------------------------------------------------
------------------------------------------------------------------------------------------------------------------------------------------------------
-------------------------------------------------------S----------------------------------------------------------------------------------------------
------------------------------------------------------------------------------------------------------------------------------------------------------
--------------------------------------------------------------------------------------------------------------------------------------%---------------
-------------------------------------------------------------------------------------------------------------------------%------------|---------------
-------------------------------------------------------%%----------------------------------------------------------------|------------|---------------
----------------------------------------%------------%%||--%---------------------------t-%-----------S------%------------|------%-----|------%--------
------------------%------------------%--|------%-----||||%-|-----%%-%%-%------------%--t-|------------------|------%%%-%-|---%%%|-----|------|--------
---------%%%------|%-----------------|--|------|-----|||||-|-----||-||-|------------|--t-|-%----------------|------|||-|-|---||||-----|-%%---|--------
%%%%%%%%%|||------||---%-----------%-|--|------|#----|||||-|-%---||%||%|------------|--%%|-|----------------|------|||-|-|---||||-----|-||-%-|--------
||||||||||||XXXXXX||-XX|XXX-XXX-XXX|X|--XXX----|XXX--|X|||X|X|XXXX||||||XXXXX-XX--XX|-X|||X|XX-XXXXXXXX--XXX|XXX-XX|||-|X|XXX||||XXXXX|X||X|X|XX---XXX