------------------------------------------------------------------------------------------------------------------------------------------------------
------------------------------------------------------------------------------------------------------------------------------------------------------
------------------------------------------------------------------------------------------------------------------------------------------------------
------------------------------------------------------------------------------------------------------------------------------------------------------
------------------------------------------------------------------------------------------------------------------------------------------------------
------------------------------------------------------------------------------------------------------------------------------------------------------
------------------------------------------------------------------------------------------------------------------------------------------------------
--------------------------------------------------------------------------------------------------------------------------------------------%---------
--------------------------------------------------------------------------------------------------------------------------------------------|----D----
--------------------------------------------------------------------------------------------------------------------------------------------|---------
-------------------------------%--%-----------------%--------------------------------------------------%------------------%-----------------|---------
---------%--------------------%|--|-----------------|---%--------------------%--------S----------------|------------------|--------C--------|----t----
---------|--%--%-------%%---%%||--|-----------------|---|---%-----%----------|---%-----%---------#----%|----%%----%%------|-----%------%----|----t----
---------|--|--|-%-----||---||||--|%---%-%----------|---|---|-----|----------|%%%|-----|----F%---#%---||---%||----||------|---%%|%----%|----|----t----
%%%%%%%%-|--|-%|-|--%%%||--%||||--||%--|-|----------|--%|---|-%%--|%-%---%---|||||----%|----%|--%%|---||---|||----||-----%|---||||----||-%--|----%---%
||||||||X|-X|-||X|X-|||||XX|||||XX|||X-|X|-XXXX--XXX|XX||XXX|X||-X||X|XXX|XXX|||||X-XX||-XXX||XX||X-XX||XXX|X|XXX-||-XXXX||-XX||||-X--|X-|XX|X--X|XX-|