------------------------------------------------------------------------------------------------------------------------------------------------------
------------------------------------------------------------------------------------------------------------------------------------------------------
------------------------------------------------------------------------------------------------------------------------------------------------------
------------------------------------------------------------------------------------------------------------------------------------------------------
-----------------------------------------------------------------------------------------S------------------------------------------------------------
------------------------------------------------------------------------------------------------------------------------------------------------------
------------------------------------------------------------------------------------------------------------------------------------------------------
-----------------------------------------------------------------------------------------%----------------------------------------r-------------------
-----------------------------------------------------------------------------------------|----------------------------------------%-------------------
-----------------------------------------------------------------------------------------|------------------------%%--------------|-------------------
-----------------------------------------------------------------------------------------|------------------------||--------------|-------------------
-----------------%----------------------------------------------U---K----%---------------|----------%---------2---||--------------|-------------------
-----------------|------------------------%-----------%-------------%----|---------------|----------|%--%----%----%|-----------%--|-----%-------------
-----------------%-%-------%--g------%----|-----------|-------%-----|--%%|----%%---------|----------||--|-%%-|-%-%||-%------%%-|--|-----|-%--------%--
%%%%%%%%---------|%|------%|-%--%%%%-|-%%-|-----------|--%----|-----|--|||----||--%-%%--%|%----%---%||%-|-||-|-|-|||-|---%%%||%|--|-%---|-|--------|--
||||||||XXXXXXXXXX||XXXXXX||X|XX||||-|X||X|XXXXX--XXXX|XX|XX-X|-XXXX|X-|||XX-X||--|X||XX|||---X|XXX||X|-|X||-|X|X|||-|XXX|||||||--|X|XX-|X|---X--XX|XX