------------------------------------------------------------------------------------------------------------------------------------------------------
------------------------------------------------------------------------------------------------------------------------------------------------------
------------------------------------------------------------------------------------------------------------------------------------------------------
------------------------------------------------------------------------------------------------------------------------------------------------------
------------------------------------------------------------------------------------------------------------------------------------------------------
-------------------------------------------------------------------------------------------------%----------------------------------------------------
-------------------------------------------------------------------------------------------------|----------------------------------------------------
-------------------------------------------------------------------------------------------------|----------------------------------------------------
-------------------------------------------------------------------------------------------------|-------------------------------%--------------------
--------------------------------------------------------------------------------------%----------|----t---------%----------------|--------------------
--------------------------------------------------------------------#-------------%---|----------|----t---------|----------------|--------------------
--------------------------------------------------------------------#-------------|--%|----------|----t---------|----------------|--------------------
----------%--%%%---%-------%%--%--%---------%%----------------%-----#%-----%%-----|%%||%---%-----%---%%--%------|------%----%%---|------%%------------
----------|--|||---|-------||--|--|--%%-----||%---%%----------|--%%-%|-----||---%-||||||---|-----|--%||--|------|------|----||---|------||------------
%%%%%%%%%%|--|||---|%------||--|--|%%||---%-|||---||%-%----%-%|%-||-||-----||--%|%||||||--%|----%|--|||--|------|%%%%--|----||---|------||---------%-%
|||||||||||XX|||XX-||XXX--X||XX|XX|||||XX-|X|||XXX|||-|XXXX|X|||-||X||XXXX-||XX||||||X||XX||-X--||XX|||-X|--X-XXX||||XX|--X-||XXX|XXXXXX||XXXXXX--X|X|