------------------------------------------------------------------------------------------------------------------------------------------------------
------------------------------------------------------------------------------------------------------------------------------------------------------
------------------------------------------------------------------------------------------------------------------------------------------------------
------------------------------------------------------------------------------------------------------------------------------------------------------
------------------------------------------------------------------------------------------------------------------------------------------------------
------------------------------------------------------------------------------------------------------------------------------------------------------
------------------------------------------------------------------------------------------------------------------------------------------------------
------------------------------------------------------------------------------------%D----------------------------------------------------------------
------------------------------------------------------------------------------------|----%------------------------------%-----------------------------
------------------------------------------------------------------------------------|----|------------------------------|-----------------------------
----------------------------------------------------------------C-----------------t-|----|---------%----%%------------%-|-----------------------------
---------------------------------------------------------------------------%------T-|t---|---------|--%-||------------|-|--------------%--------------
-----------------%------------------%-------%----------------------%-------|------t-|T---|---------|--|-||------------|-|----------%-%%|-------%-%%%--
-----------------|----%%%%---%%%-%--|-%---%-|--%-------------------|-------|-----%%-|%%--|----%%---|%-|%||--%-----%---|-|-%%%-----%|-|||--%----|-|||--
%%%%%%%%-----%---|---%||||---|||-|--|%|---|-|--|%-%---------%%%%%%%|-------|%%---||-|||--|--%%||---||-||||-%%-----|%--|%|-|||%--%-||-|||--|%-%-|-|||%-
||||||||XXXXX|XXX|--X|||||XXX|||X|XX|||XXX|XXX-X|X|-X-XXX-XX||||||||XXXXXXXX||XXX||-|||X-|XX||||-XX|XX|X||X||-XXX-||XX|||X||||--|X||X|||-X||-|X|X||||X