------------------------------------------------------------------------------------------------------------------------------------------------------
------------------------------------------------------------------------------------------------------------------------------------------------------
------------------------------------------------------------------------------------------------------------------------------------------------------
------------------------------------------------------------------------------------------------------------------------------------------------------
------------------------------------------------------------------------------------------------------------------------------------------------------
------------------------------------------------------------------------------------------------------------------------------------------------------
------------------------------------------------------------------------------------------------------------------------------------------------------
--------------------------------------------------------------------------------------------------%---------------------------------------------------
-----------------------------%--------------------------------------------------------------------|---------------------------------------------------
-----------------------------|--------------------------------------------------------------------|----%----------------------------------------------
-----------------------------|-------------------%------------------------------------------------|---C|-----------------------------------%----%-----
-----------------------------|-------------------|-----------------------------C------------------|----|------%----------------------------|----|-----
---------------%%--%-%-------|%----%--%--%-------|------------------%-----------#--%%%%%-%----%---|%%--|%%%%--|-------%------------%-----%-|%%--|-----
---------------||%-|%|%------||----|--|--|----%%-|---%--------------|-------%-%-%--|||||-|%---|%--|||--|||||--|-------|%---------%-|-%-%-|-|||--|-----
%%%%%%%%%-%--%-|||-||||------||----|--|--|----||-|--%|--%----%%-%%--|-------|-|-|--|||||-||---||--|||-%|||||--|%%%%---||-%-%%----|-|%|-|-|-|||-%|%%%--
|||||||||X|XX|X|||X|||XXXXXX-||XX-X|X-|X-|XXXX||-|--||-X|XXXX||X||XX|X-XXXXX|X|X|XXX|XXXXX|XXXX|XX|||X||||||XX|||||---||X|X||XXXX|X|||X|X|X|||-|||||XX