------------------------------------------------------------------------------------------------------------------------------------------------------
------------------------------------------------------------------------------------------------------------------------------------------------------
------------------------------------------------------------------------------------------------------------------------------------------------------
------------------------------------------------------------------------------------------------------------------------------------------------------
------------------------------------------------------------------------------------------------------------------------------------------------------
------------------------------------------------------------------------------------------------------------------------------------------------------
------------------------------------------------------------------------------------------------------------------------------------------------------
------------------------------------------------------------------------------------------------------------------------------------------------------
---------%--------------------------------------------------------------------------------------------------------------------------------------------
---------|--------------------------------------------------------------------------------------------------------------------------------------------
---------|-------%-----------------------------------------------t---------------------------#--------------------------------------------------------
---------|-------|----%---%--%----------------%------------------t------------%--------------#----------------------------------%---------------------
---------|-------|----|---|--|----------------|----------%-------t---------%--|%%%-%--%------%%-%%---%----------%---%%----%-----|-%%-----%------------
---------|------%|----|---|-%|----------------|----------|%-%%--%%--%%-----|--||||-|--|------||-||---|----------|---||----|-----|-||-----|-------%-%%%
%%%%%%%%-|------|%----|---|-||--------%--%-%--|----------||-||-%||--||---%-|-%||||-|%-%-----%||-||--%|---%------|--%||--%%|----%|%||----%|-------|-|||
||||||||X|XX-XX-||-XX-XX--XX|XXXXX--XX|XX|X|XXXXXX-XXXXXX||X||X|||X-||XXX|X|X|||||-||X|-XXXX|||-||XX||X-X|XXXXXX|XX|||XX|||-XXX|X|||X---||XXXXX--|X|||