------------------------------------------------------------------------------------------------------------------------------------------------------
------------------------------------------------------------------------------------------------------------------------------------------------------
------------------------------------------------------------------------------------------------------------------------------------------------------
------------------------------------------------------------------------------------------------------------------------------------------------------
------------------------------------------------------------------------------------------------------------------------------------------------------
------------------------------------------------------------------------------------------------------------------------------------------------------
----------------------------------------------------------------------------------------------------------%-------------------------------------------
----------------------------------------------------------------------------------------------------------|-------------------------------------------
-----------------------------------k----------------------------------------------------------------------|-------------------------------------------
-----------------------------------%----------------------------------------------------------------------|-------------------------------------------
-----------------------------------|--------------t-------------%-----------------------------------------|----------------------------------------%--
--------------------%--------------|--------------t-------------|------------%-----------------%----------|----------------------------------------|D-
--------------%-----|------%%--2-%-|----%%--------t-------------|------------|--------------%--|-----%----|-%-----%---------%-----%%---%-----------|--
--------%-----|%----|---%--||---%|%|-%%%||--------%%--%--%------|------------|--%--------%--|--|----%|----|-|----%|---------|--%--||---|-----------|--
%%%%%%%%|-%---||---%|---|--||---||||-|||||-----%%%||--|%-|----%-|-%-----%-%%-|--|-%-F-%--|--|--|----||----|-|--%-||-%--%----|--|--||-%-|------%%--%|%-
|||||||||X|X--||X--|XXX-|XX||XXX||||X|||||XXXX-|||||XX||X|XXXX|X|X|XXX--|X||XX--|X|-XX|XX|-X|XX|X-XX||XXXX|X|XX|X||X|--|X-XX|--|XX||X|X|XXXXXX||X-|||X