------------------------------------------------------------------------------------------------------------------------------------------------------
------------------------------------------------------------------------------------------------------------------------------------------------------
------------------------------------------------------------------------------------------------------------------------------------------------------
------------------------------------------------------------------------------------------------------------------------------------------------------
------------------------------------------------------------------------------------------------------------------------------------------------------
------------------------------------------------------------------------------------------------------------------------------------------------------
--------D------------------------------------------------------------------------2--------------------------------------------------------------------
---------------------------------------------------------------------------------------------------------------------%--------------------------------
---------------------------------------------------------------------------------------------------------------------|------------------------%-------
----------%-----------------------------%----------------------------------------------------------------------------|------------------------|-%-----
----------|----------------------%------|----------------------------------------%-----------------------------------|------------------------|-|-----
----------|----------------------|------|-%--------------------------------------|--------------%--%-----------------|-----%S-----------------|-|-----
----------|-----%------%%--------|-%----|-|----------%---%----%------------------|--------------|--|%%%----%-%----%--|---%%|-%---%---------%--|-|-----
--------%-|-----|------||--------|-|----|-|----------|-%-|----|%-----%-----------|----------%--%|--||||%%--|%|----|--|---|||-|---|---------|-%|-|-----
%%%%%%%%|-|-----|------||--------|%|-%--|-|----------|-|-|----||----%|-----------|-----%----|--||--||||||--|||---%|--%---|||%|---|---------|-||-|----%
|||||||||X|XXXXX|XXXXXX||XXXXXXXX|||X|-X|X|XXXXX-XXXX|X|X|XXXX||-XXX||XXXXXXXX--X|XXXXX|-XX-X-X||XXX|||||-X|||XXX||XX|XXX|||||X--|XX-XX-XXX|-||X|XXXX|