------------------------------------------------------------------------------------------------------------------------------------------------------
------------------------------------------------------------------------------------------------------------------------------------------------------
------------------------------------------------------------------------------------------------------------------------------------------------------
------------------------------------------------------------------------------------------------------------------------------------------------------
------------------------------------------------------------------------------------------------------------------------------------------------------
----------------------------------------------------------------------%-------------------------------------------------------------------------------
----------------------------------------------------------------------|-------------------------------------------------------------------------------
----------------------------------------------------------------------|-------------------------------------------------------------------------------
------------------T---------------------------------------------------|-------------------------------------------------------------------------------
------------------t---------------------------------------------------|-------------------------------------------------------------------------------
------------------t---------------------------------------------------|-%----------------------%--------------k--------------------------%------------
---------%--%-----%-------------------------------------------------S-|-|%---------------------|---%---------------------%----------%%---|------------
---------|--|-----|-------------------%%-%------%%-----------%%-------|-||---------------------|---|--------%%-----------|%---------||--%|--------%---
---------|--|-----|-------%----%%----%||-|------||-----------||------%|-||-------%-%--------%--|---|--%-----||----%-%%%--||---------||--||--------|-%-
%%%%%%%%-|--|----%|%------|%---||%--%|||-|-%----||%%%------%-||------||-||-------|-|--%-----|-%|#--|-%|-----||%---|-|||%-||-%-%-----||--||-%-%----|%|-
||||||||X|-XXX--X|X|XXXX-X||X--|||X-||||X|X|XXX-|||||X--XXX|X||X-X-XX||-||XXXX---|X|--|XXXXX|X||XXX|-|XXXXX-|||-XX|X||||X||-|X|X--XXX|X-||X|X|XX-X|||X