------------------------------------------------------------------------------------------------------------------------------------------------------
------------------------------------------------------------------------------------------------------------------------------------------------------
------------------------------------------------------------------------------------------------------------------------------------------------------
------------------------------------------------------------------------------------------------------------------------------------------------------
------------------------------------------------------------------------------------------------------------------------------------------------------
------------------------------------------------------------------------------------------------------------------------------------------------------
------------------------------------------------------------------------------------------------------------------------------------------------------
------------------------------------------------------------------------------------------------------------%-----------------------------------------
------------------------------------------------------------------------------------------------------------|-----------------------------------------
-----------------------------------------------------------------------------------t------------------------|-----------------------------------------
--------------------------------------------------------------------------%--------t------------------------|-----------------------------------------
--------------------------------------------------------------------------|-----%--t----------------------%-|------%----------------------------------
-----------------------%%-------------%%----------------------------%-----|-----|-%t%%---%---%------------|-|------|---------#----------------%-----%-
-------------%-----%---||---%---------||------------------------%%--|-%%%%|-----|-|%||---|---|%-----%--%%%|-|%--%--|%%%%----%%------%---------|-----|%
%%%%%%%%----%|----%|---||---|-%%------||-------%-----%-%%%------||--|-|||||-----|%||||---|---||-----|--||||-||--|--|||||----||%---%-|---%-----|-----||
||||||||XXX-||XXXX||XXX||XXX|X||XXX--X||XXXXX-X|XX--X|X|||--XXXX||XX|X|||||XXX--||||||XXX|XXX||XXXXXX--||||X||--|XX|||||-X-X|||XXX|X|-XX|--XXX|X-X-XX|