------------------------------------------------------------------------------------------------------------------------------------------------------
------------------------------------------------------------------------------------------------------------------------------------------------------
------------------------------------------------------------------------------------------------------------------------------------------------------
------------------------------------------------------------------------------------------------------------------------------------------------------
------------------------------------------------------------------------------------------------------------------------------------------------------
-------------------------------------------------------%----------------------------------------------------------------------------------------------
-------------------------------------------------------|--%-------------------------------------------------------------------------------------------
-------------------------------------------------------|--|---------------------------------------------------%---------------------------------------
------------%------------------------------------------|--|---------------------------------------------------|---------------------------------------
------------|------------------------------------------|--|---------------------------------------------------|---------------------------------------
------------k------------------------------------------|--|---------------------------------------------------|--------------------%------------------
------------|-------------%%--------------%------------|--|-------------%-------------------------g-----------|----------%---------|--------U---------
--------%---|-------%-----||---------%----|--%---------|--|-------------|-%---%%---%---------%----|--%--------|---%------|---------|---------%%%%---%-
--------|---|-------|-----||%%---%-%-|----|--|---------|--|-------------|-|---||---|---------|---%|--|--------|---|------|%--------|-------%-||||---|-
%%%%%%%%|%-%|----%--|----%||||%--|-|%|----|--|---------|%-|%------------|-|%--||--%|---------|---||--|--------|---|------||--------|---%---|-||||---|-
||||||||||X||XXXX|-X|-XXX||||||XX|XX||XXXX|-X|--XXXX-X-||X||XXX-XXXXXXXX|-||XX||-X||XXX--X-XX|-XX|X--|XXXX-XXX|XXX|XXXXXXX|XXXXXXXX|-XX|XXX|X||||XX-|-