------------------------------------------------------------------------------------------------------------------------------------------------------
------------------------------------------------------------------------------------------------------------------------------------------------------
------------------------------------------------------------------------------------------------------------------------------------------------------
------------------------------------------------------------------------------------------------------------------------------------------------------
------------------------------------------------------------------------------------------------------------------------------------------------------
------------------------------------------------------------------------------------------------------------------------------------------------------
------------------------------------------------------------------%---------------------------------------------------------------------------------#-
--------------------------------U---------------------------------|---------------------------------------------------------------------------------%-
---------------------------------y---------------------------%----|----------------------------------------------------------%----------------------|-
---------------------------------%---------------------------|----|----------------------------------------------------------|----------------------|-
-----------------%---------------|---------------------------|--S-|----------------------------------------------------------|----------------------|-
-----------------|--------------%|---------------------------|---%|-%--------------------------------------------------------|----------------------|-
-----------------|---------%----||---%------%%%-----------%--|%--||-|%-%--------%---------%---------------------------%%-----|--%%---------%---%----|-
-----------------|---------|----||---|-----%|||---------%%|--||--||-||-|%---%---|%%%--%---|-%---%---------%--%--------||-----|--||-%-------|---|----|-
%%%%%%%%--%--%---|-----%--%|-%%%||%--|-----||||-%%------|||--||-%||%||-||%%-|---||||--|---|-|%--|---------|--|--%-----||---%-|--||-|-------|---|----|-
||||||||XX|X-|--X|XXX-X|--||X||||||XX|--XXX||||X||X--XXX|||--||X||||||X|X||X|XXX||||-X|XXX|-||X-|XXXXXXXXX|XX|XX|XXX-X||XXX|X|XX||-|XXXXXXX|XX-|XXXX|X