------------------------------------------------------------------------------------------------------------------------------------------------------
------------------------------------------------------------------------------------------------------------------------------------------------------
------------------------------------------------------------------------------------------------------------------------------------------------------
------------------------------------------------------------------------------------------------------------------------------------------------------
------------------------------------------------------------------------------------------------------------------------------------------------------
------------------------------------------------------------------------------------------------------------------------------------------------------
------------------------------------------------------------------------------------------------------------------------------------------------------
-----------------S------------------------------------------------------------------------------------------------------------------------------------
----------------------------------------------------------------------------------------------------------------------------------------------%-------
-----------------------------------------------------------------------------------------%---------S----------t-------------------------------|-------
------------------------------------------------------%----------------------------------|---------------t----t-------------------------------|-------
------------------------------------------------------|----------------------------------|------------%--t----%-------------------------------|-------
----------------------%-----------------%%----%-------|---------%-------%------%---%-----|----%%--g---|--t-%%-|-------------------------------|-------
---------%--%----%----|----%-%----%-----||--2-|-------|%----%---|--%%---|------|---|-----|%-%-||---%%%|--%-||-|-----%%-%-----%----------------|-----%-
%%%%%%%%%|--|----|----|----|-|----|-----||----|---%-%-||-%%%|---|--||---|-%%---|---|--%-%||-|-||--%||||--|-||-|-----||-|-----|%%%---%---------|-----|-
||||||||||XX|-XXX|XXXXXX-XX|-|X-X-|XXXXX||XXXX|XXX|X|-||X||||XX-|XX||--X|X||XXX|XXX|XX|X|||-|X||XX|||||XX|XXXX|XX-XX||X|XX-XX||||XXX|XXXXXXXXX|XXXXX|X