------------------------------------------------------------------------------------------------------------------------------------------------------
------------------------------------------------------------------------------------------------------------------------------------------------------
------------------------------------------------------------------------------------------------------------------------------------------------------
------------------------------------------------------------------------------------------------------------------------------------------------------
---------------------------------------------------------------------------------------------------------------------------------t--------------------
---------------------------------------------------------------------------------------------------------------------------------t--------------------
---------------------------------------------------------------------------------------------------------------------------------%--------------------
------------------------------------------------------------------------------------------------%--------------------------------|--------------------
------------------------------------------------------------------------------------------------|--------------------------------|--------------------
--------------------------S--------------------------------%------------------------------------|--------------------------------|--------------------
-----------------------------------------------------------|-------------------------------%----|--------------------------------|--------------------
-----------------------------------------------------------|-------------------------------|----|--------------------------------|--%---%-------------
---------%--------%------%--%-----%%%----%---------------%-|%--%-----------------------%%-%|----|---------------------------%----%--|--%|---------%---
---------|-%------|%--%--|%-|---%%|||----|-------%-------|-||--|-----------%%----------||-||---%|%%%%--%--------------------|----|--|%-||---------|---
%%%%%%%%%|-|------||-%|--||-|---|||||----|-------|-------|-||-%|%----%-----||------%---||-||-%%||||||%%|-%-%%---------------|%--%|--||-||---------|---
||||||||||X|X-X---||-||X-||-|XXX|||||--XX|XX-XXXX|XXXXX-X|X||X|||X--X|---XX||---XX-|-XX||X||X|||||||||||X|X||-XX--XXXXXXX--X||--||XX||X|X--X---XXX|XXX