------------------------------------------------------------------------------------------------------------------------------------------------------
------------------------------------------------------------------------------------------------------------------------------------------------------
------------------------------------------------------------------------------------------------------------------------------------------------------
------------------------------------------------------------------------------------------------------------------------------------------------------
------------------------------------------------------------------------------------------------------------------------------------------------------
------------------------------------------------------------------------------------------------------------------------------------------------------
--------------------------------------------------------------S---------------------------------------------------------------------------------------
------------------------------------------------------------------------------------------------------------------------------------------------------
--------------------------------------------------------S---------------------------------------------------------------------------------------------
----------------------C-------------------------------------------------------------------------------------------------------------------------------
----------------------------------------------%---------------%--------------------------------------------------%------------------------------------
---------------%------------------------------|--%------------|--%-----------------------------------------------|------------------------------------
---------------|----%-----------------%%------|%-|-%--%-%-----|-%|----%%----------------%---%--------------------|------%-----------------#----%------
----------%----|----|-%--------%------||---%--||-|-|%-|%|%-%%%|%||---%||----------%-%-%-|%--|--------------------|------|--%---------%----%%%--|---%--
%%%%%%%%-%|%---|----|-|--------|%-----||---|--||-|%||-%|||-|||||||%--|||-%%-%%----|-|-|-||%%|------------%-------|-----%|--|%--%-----|----|||--|---|--
||||||||X|||XXXXXXXX|-|XXXXX-XX||XXXX-|X--X|XX|XX||||-||||X|||||X||XX|||X||X||XXXX|X|X|X||||XXXXXXXX-XXXX|XXXX-XX|XXXXX||XX||XX|-X-XX|X-XX|||-XXXXX|XX