------------------------------------------------------------------------------------------------------------------------------------------------------
------------------------------------------------------------------------------------------------------------------------------------------------------
------------------------------------------------------------------------------------------------------------------------------------------------------
------------------------------------------------------------------------------------------------------------------------------------------------------
-----------------------------------------------------------------------------------------------------------------S------------------------------------
-----------------------------------------------------------------------------------------------------------------------%------------------------------
--------------------------------------------------------------------------------%--------------------------------------|------------%-----------------
--------------------------------------------------------------------------------|--------------------------------%-----|------------|-----------------
--------------------------------------------------------------------------------|---------------%----------------|-----|------------|-----------------
--------------------------------------------------------------------------------|---------------|-------%--------|-----|------------|-----------------
--------------%---------------------------------------------------%%------------|---------------|-------|--------|-----|------------|-----------------
--------------|-----#---------------------------------------------||------------|---------------|-------|--------|-----|------------|--------------%--
--------------|-----#S---------%%--C-------%---%%--%%---%--%%%%---||-----------%|-%-----%---%---|---%---|%%------|-----|%%%--------%|------%-------|--
--------------|-----#----------||--C-------|---||--||---|%%||||--%||--------%-%||-|-----|---|---|-%-|---|||--g---|-----||||--------||------|%------|--
%%%%%%%%------|--%%-%---------%||----%%%---|---||%%||---|||||||%%|||--------|%|||-|-%%%-|---|---|-|-|---|||-%----|----%||||--------||%%%---||------|--
||||||||XXXXXX|XX||-|XXX-XX--X|||--XX|||XXX|XXX||||||X--|||XX|||||||X---XXX-|||||X|X|||-|XXX|XXX|X|X|XXX|||X|XXXX|XXXX|||||XX-XXXXX|||||XXXX|XX---X|XX