------------------------------------------------------------------------------------------------------------------------------------------------------
------------------------------------------------------------------------------------------------------------------------------------------------------
------------------------------------------------------------------------------------------------------------------------------------------------------
------------------------------------------------------------------------------------------------------------------------------------------------------
------------------------------------------------------------------------------------------------------------------------------------------------------
------------------------------------------------------------------------------------------------------------------------------------------------------
------------------------------------------------------------------------------------------------------------------------------------------------------
------------------------------------------------------------------------------------------------------------------------------------------------------
----------------------------------------------------%---%------------------C--------------------------------------------------------------------------
--------------------------------------------------%-|---|-------------------------------------------------%---------------------S------------------%--
--------------------------------------------------|-|---|------------------------------------------------D|-----------------------------%----------|--
--------------------------------------------------|-|---|--%%------%--------------------------------------|-%--------------------------%|----------|--
--------------%---%-----%-----%-%----%%-----------|-|--%|--||---%%-|#-%----%------------------------------|-|-%----------%-----%-------||----------|--
--------------|---|-----|-%---|-|---%||--------%--|-%--||%-||---||-|#-|----|------------%-%--%------------|-|-|-----%----|-----|-%-----||----%%%---|--
%%%%%%%%--%%--|---|-----|-|---|-|%--|||-%-----%|%-|-|--|||-||---||-|%-|--%%|-----%%-%---|-|--|----------%%|-|%|-----|--%-|-----|-|-%---||----|||%--|--
||||||||X-||XX|XX-|----X|X|XXX|X||XXX||-|--XXX|||-|X|XX|||XX|--X||X||X|-X|||XXXX-||X|XXX|X|XX|XXXXXXXXXX|||X|||---XX|XX|X|XXXXX|XXX|XXX||XXXX||||XX|XX