------------------------------------------------------------------------------------------------------------------------------------------------------
------------------------------------------------------------------------------------------------------------------------------------------------------
------------------------------------------------------------------------------------------------------------------------------------------------------
------------------------------------------------------------------------------------------------------------------------------------------------------
------------------------------------------------------------------------------------------------------------------------------------------------------
-----------------------------------------------------------------%------------------------------------------------------------------------------------
-----------------------------------------------------------------|%-----------------------------------------------------------------------------------
-----------------------------------------------------------------||------------------------------------------------------------------C----------------
-----------------------------------------------------------------||-----------------------------------------------------------------------------------
--------%--------------------------------------------------------||-----------------------------------------------------------------------------------
--------|--------------------------------------------------------||-------------%---------------------------------------------------------------------
--------|--------------------------------------------------------||------%------|---%%-----------%-----------------------------------%----------------
--------|---%-%%---------------------------------%---------------|%------|---%--|-%-||%----------|-%--%-------------------------%--%-|%--------%%-----
--------|---|-||--%------%%--%%%-----%-----------|---------%--%%-||---%--|---|%-|-|-|||-F--------|-|--|---------%--------------%|-S|-||--------||-----
%%%%%%%%|%%-|-||--|------||--|||-----|%-%--------|---------|--||-||---|--|---||-|%|%|||-%-%--%---|-|--|---------|--------------||--|-||%-------||---%-
|||||||||||X|X||XX|-XXXXX||XX|||XXXX-||-|XXXXXXXX|X--XX--XX|--||X||-X-|XX|XXX||-|||||||X|X|XX|-XXXX|XX|-XX--XXX-|XXXXXX-XXXXXXX||XX|-|||X--XXXX||XXX|X