------------------------------------------------------------------------------------------------------------------------------------------------------
------------------------------------------------------------------------------------------------------------------------------------------------------
------------------------------------------------------------------------------------------------------------------------------------------------------
------------------------------------------------------------------------------------------------------------------------------------------------------
------------------------------------------------------------------------------------------------------------------------------------------------------
------------------------------------------------------------------------------------------------------------------------------------------------------
------------------------------------------------------------------------------------------------------------------------------------------------------
------------------------------------------------------------------------------------------------------------------------------------------------------
------------------------------------------------------------------------------------------------------------------------------------------------------
---------------------------------------------------------------%--------------------------------------------------------------------------------------
-----------C------------%--------------------------------------|-------------------------------------------t--------------------%---------------------
------------------------|------------------------------%---%---|-------------------------------------------t--------------------|---------------------
-------------%%---------|----%%-------%--%-------------|---|---|-------%------------------%--%%------------t----------%--%----%%|-------%-------------
-------------||---------|%---||-------|--|----%%------%%---|---%-------|-------%----------|--||--%%-------%%-%%-%%----|-%|---%|||-------|------------%
%%%%%%%%---%-||----%-%--||--%||-------|--|----||--%---||--%|---|-------|---%---|-%%%%%%---|--||--||---%---||-||-||----|-||-%-||||----%--|---%--%-----|
||||||||XXX|X||XXXX|X|--||XX|||--XXX-X|XX|-X--||XX|--X||X-|XXXX|-XX--XXXX-X|XXX|-||||||XXX|-X||XX||-XX|--X||X||X||X--X|-||-|XX|||--XX|XX|XXX|XX|XXXXX|