------------------------------------------------------------------------------------------------------------------------------------------------------
------------------------------------------------------------------------------------------------------------------------------------------------------
------------------------------------------------------------------------------------------------------------------------------------------------------
------------------------------------------------------------------------------------------------------------------------------------------------------
------------------------------------------------------------------------------------------------------------------S-----------------------------------
------------------------------------------------------------------------------------------------------------------------------------------------%-----
------------------------------------------------------------------------------------------------------------------------------------------------|-----
------------------------------------------------------------------------------------------------------------------------------------------------|-----
------------------------------------------------------------------------------------------------------------------------------------------------|-----
------------------------------------------------------------------%-----------------------------------------------------------------------------|-----
---------------%--%-------%---------------------------------------|--2-------------------------------%------------------------------------------|-----
---------------|--|-------|-------%-------------------------------|-------------------------%-----%--|------------%-----------------------------|-----
------------%--|--|--%%%--|-%----%|----%----%---%-----------------|---%%--%%----------------|-----|%%|------------|--------%%-----------%-------|---%-
------------|--|--|--|||-%|-|--%-||%---|---%|--%|-----------------|---||--||-%--%%%%%%%-----|-----||||------%%----|----%---||-----------|-----%-%---|-
%%%%%%%%%%--|%-|%-|--|||-||-|%-|%|||---|---||--||%---%%-----------|--%||%-||-|--|||||||%----|-%%%%||||-%%%%-||-%-%|----|---||---%-------|-----|-|---|-
||||||||||XX||X||X|XX|||X||X||X|||X|XX-X--X||X-|||XX-||-XXXXXXXX-X|--||||-||-|XX||||||||-XXX|X||||X|||X||||X||X|X||XXX-|XX-||XXX|-XXXXXX|XXXXX|-|X--|X