------------------------------------------------------------------------------------------------------------------------------------------------------
------------------------------------------------------------------------------------------------------------------------------------------------------
------------------------------------------------------------------------------------------------------------------------------------------------------
------------------------------------------------------------------------------------------------------------------------------------------------------
------------------------------------------------------------------------------------------------------------------------------------------------------
------------------------------------------------------------------------------------------------------------------------------------------------------
------------------------------------------------------------------------------------------------------------------------------------------------------
------------------------------------------------------------------------------------------------------------------------------------------------------
------------------------------------------------------------------------------------------------------------------------------------------------------
------------------------------------%--------------------------------------------------------------------------------%--------------------------------
------------------------------------|-------------------------------------------%------------------------------------g--------------------------------
------------------------------------|--%----------------------------------------|------------------------------------|--------------------------------
------------------------------------|--|---%---%#-------------------------------|%-------%---------------------------|----------%%----%------------%--
---------------%%-------------------|--|---|---|#%-----------------%------------||----k-%|------%%----------%--------|-U--------||----|------------|%-
%%%%%%%%---%--%||------------%-%----|--|---|%%-|%|%----%%----------|-----%--%---||---%--||------||---%--%---|-%%-%%%-%----------||----|%%---------%||-
||||||||XXX|-X||XXXX-XXXX-XXX|-|XXXX|XX|--X|||X||||XXXX||---X--XXXX|XXXXX|XX|XXX||--X|XX||XXXXXX||X-X|XX|-XX|X||X|||X|XXXXXXXXX-||---X|||XXXXXXXXX|||-