------------------------------------------------------------------------------------------------------------------------------------------------------
------------------------------------------------------------------------------------------------------------------------------------------------------
------------------------------------------------------------------------------------------------------------------------------------------------------
------------------------------------------------------------------------------------------------------------------------------------------------------
----------------%-------------------------------------------------------------------------------------------------------------------------------------
----------------|-------------------------------------------------------------------------------------------------------------------------------------
--------------%-|------------------------------------------------------------------------------------------%------------------------------------------
--------------|-|-----%------------------------------------------------------------------------------------|------------------------------------------
--------------|-|-----|----D-------------------------------------------%-----------------------------------|-----------------%------------------------
--------------|-|-----|------------------------------------------------|-----------------------------------|-----------------|------------------------
--------------|-|-----|------------------------------------------------|-----------------------------------|---------------%-|------------------------
--------------|-|-----|----%---%%-%-%----------------%-----------------|-----------------------------------|---------------|-|----------------%-------
--------------%-|-----|----|%%-||-|%|----------------|------%----------|-%---------------%-----------------|---------%-%%--|-|%---%-----------|------%
--------------|-%-%-%-|--%-|||%||-|||----------------|------|----------|%|-----%---------|%----------------|%------%-|-||--|-||%%%|%%-%-------|---%--|
%%%%%%%%%%%%%%|-|%|-|-|-%|-||||||-|||%%-----%--------|--%%--|--%----%-%|||-----|%%-%---%-||--%----%%%------||------|-|-||--|-||||||||-|-------|---|--|
|||||||||||||||-|||-|X|X||X||||X|X|||||XX-XX|X--XXXXX|XX||XX|XX|--X-|-||||XXXX-|||X|-X-|X||XX|---X|||--X--X||XXXX--|-|X||XX|X||||||||X|XXXX-XX|XXX|-X|