------------------------------------------------------------------------------------------------------------------------------------------------------
------------------------------------------------------------------------------------------------------------------------------------------------------
------------------------------------------------------------------------------------------------------------------------------------------------------
------------------------------------------------------------------------------------------------------------------------------------------------------
------------------------------------------------------------------------------------------------------------------------------------------------------
------------------------------------------------------------------------------------------------------------------------------------------------------
--------------------------------------------------------------------------------------D---------------------------------------------------------------
-----------------------------------------------------%------------------------------------------------------------------------------------------------
--------------------C--------------------------------|------------------------------------------------------------------------------------------------
-----------------------------------------------------|------------------------------------------------------------------------------------------%-----
-----------------------------------------------------|--------------------%--------------%%-----------------------------------------------------|-----
-----------#-------------------------%-------g-------|--------------------|--------------||----%------%----------------%------------------------|-----
-----------#%----%--%-%----------%%--|-----%%--------|%%--------%%%-------|----%------%--||----|------|%%%%%--------%%%|---------------%--%%%---|%----
-----------#|----|--|-|-----%----||--|-%%--||----%--%|||---%--%-|||-------%--%-|------|--||---%|------||||||--%-----||||---------------|--|||---||----
%%%%%%%%---%|%---|--|-|-%%--|---%||--|%||%-||----|--||||-%%|--|-|||-------|-%|-|------|--||%--||------||||||--|-----||||%%-------------|--|||---||%---
||||||||---|||---|X-|XXX||XX|-XX|||XX|||||-||XXXX|XX||||-|||--|X|||XXXXXXX|X||X|--X-XX|-X|||XXX|X-XX-X||||||XX|XX-XXX||X||XXXXXXXXXXXXXXXX|||XX-|||XX-