------------------------------------------------------------------------------------------------------------------------------------------------------
------------------------------------------------------------------------------------------------------------------------------------------------------
------------------------------------------------------------------------------------------------------------------------------------------------------
------------------------------------------------------------------------------------------------------------------------------------------------------
------------------------------------------------------------------------------------------------------------------------------------------------------
----------------------------------------------------------------------------------------------------D-------------------------------------------------
------------------------------------------------------------------------------------------------------------------------------------------------------
------------------------------------------------------------------------------------------------------------------------------------%-----------------
----------------------------------------------------------------------------------------------------%-------------------------------|-----------------
--------------------------------------------%-------------------------------------------------------|-------------------------------|-----------------
---------------%----------------------------|-------%%----------------------------------------------|-------------------------------|%-%--------------
---------------|----------------------------|-------||%------------------------------------------%--|--------------------------%----||-|--------------
-------------%-|----------------------------|---%-%-|||----%%---------%-------------%------------|%%|--%--------%-------%------|----||-|--%-----%--%%%
--------%----|-|-------%--F--%---%--%%------|-%-|%|-|||----||---------|---%----%---%|------------||||%-|-%---%--|-------|%-----|-%%%||%|--|-----|%%|||
%%%%%%%%|%---|%|-------|--%--|---|--||---%-%|-|-|||-|||----||%----%%--|---|----|---||--------%---|||||-|%|---|%-|-%%-%--||-----|-|||||||--|-----||||||
||||||||||XX-|||XXXX---|XX|XX|XXX|XX|XXXX|X||X|X|||X|||XXX-|||XX-X||XX|XXX|XX-X|X--||XXXX-XXX|XXX|X||X-|||---||X|-||X|XX||XX-XXXXXX|||X|X-|XXXX-||||||