------------------------------------------------------------------------------------------------------------------------------------------------------
------------------------------------------------------------------------------------------------------------------------------------------------------
------------------------------------------------------------------------------------------------------------------------------------------------------
------------------------------------------------------------------------------------------------------------------------------------------------------
------------------------------------------------------------------------------------------------------------------------------------------------------
------------------------------------------------------------------------------------------------------------------------------------------------%-----
-------------------------------------------------------------------------------------------------------------%----------------------------------|-----
-------------------------------------------------------------------------------------------------------------|----------------------------------|-%---
------------------------------------------------------------------------------------------------------%------|----------------------------------|-|---
------------------------------------------------------------------------------------------------------|------|----------------------------------|-|---
------------------------%-----------------------------------------------------------------------------|-----%|----------------------------------|-|---
------------------------|---------------------%--%------------------%--------%---C--------------------|-----||---------------------%----------U-|-|---
------------------%-----|---------------------|-%|----%-------------|--%----%|-%--%%------------------|--%--||--------%------------|------------|-|-%%
-----------------%|-%---|%----------%--------%|-||%-%%|-%-----------|-g|----||-|--||--------%%--%%----|%-|-%||--------|%-%---------|------------|-|%||
%%%%%%%%%-------%||-|%-%||-----X-%--|--------||-|||-|||-|----%-%%%--|-X|----||-|--||%%------||-%||----%|%|%|||--------||-|---%-%--%|------------|-||||
|||||||||XXXXXX-|||X||X|||XXXXXXX|XX|XXXX---XX|-|||X||XX|XXXX|X|||XX|XX|XXXX||X|XX||||--XXXX||X|X|XXXX||||||||XXXXX-XX||X|X-X|X|XX|XXXX-XX--XXX-|X||||