------------------------------------------------------------------------------------------------------------------------------------------------------
------------------------------------------------------------------------------------------------------------------------------------------------------
------------------------------------------------------------------------------------------------------------------------------------------------------
------------------------------------------------------------------------------------------------------------------------------------------------------
---------------------------------------------------------------------------------------------------------------------------------------S--------------
------------------------------------------------------------------------------------------------------------------------------------------------------
------------------------------------------------------------------------------------------------------------------------------------------------------
-----------------------------%--------------------------%---------------------------------------------------------------------------------------------
-----------------------------|------------------%-------|---------------------------------------------------------------------------------%-----------
-----------------------------|------------------|-------|------------------------------%--------------------------------------------------|-----------
-----------------------------|---------------%--|-------|------------------------------|--------------------------------------------------|-----------
-----------------------------|---------------|--|-------|------------------------------|-------%--------------------------------------S---|---%--S----
-----------%%-----------%----|--------%---%--|-%|-------|---%---%%-------------%%------|------%|--%-----------%---%--%--------------------|---|-------
-----------||-----------|-%%-|--------|---|--|%||%-----%|---|%%%||%------%%--%%||-%----|------||--|----%----%-|---|--|---%-------%-----%--|---|-------
%%%%%%%%---||-----------|%||-|---%----|---|--|||||-----||---|||||||----%-||%%||||-|--%-|------||--|--%%|----|-|---|--|---|-%%--%-|--%--|F-|---|-----%-
||||||||XXX||X-XXXXXX-XX||||X|-XX|XXX-XX-X|XX|X|||--XXX||XXX|||||||-XXX|X||||||||-XX-|X|X-XXX-|XX-|XX|||XXXX|X|XX-|XX|XX-|X||--|XX-X|XX|XX|XXXXX-XXX|X