------------------------------------------------------------------------------------------------------------------------------------------------------
------------------------------------------------------------------------------------------------------------------------------------------------------
------------------------------------------------------------------------------------------------------------------------------------------------------
------------------------------------------------------------------------------------------------------------------------------------------------------
------------------------------------------------------------------------------------------------------------------------------------------------------
------------------------------------------------------------------------------------------------------------------------------------------------------
------------------------------------------------------------------------------------------------------------------------------------------------------
------------------------------------------------------------------------------------------------------------%-----------------------------------------
------------------------------------------------------------------------------------------------------------|-----------------------------------------
-----------S-------------------------------%----------------------------t----------------%------------------|-----------------------------------------
-------------------------------------------|---%------------------------t----------------|------------------|-----------------------------------------
-----------g-------------------------------|---|------------------------t----------------|--------------%---|-----------------------------------------
-----------%----------%-%-%-------------%--|-%-|-----%-----%-----%----%%%--%%--%---------|----------%---|---|--------------------%-------%---%-%--%%-%
-----------|%%%%------|-|-|-%------#----|--|-|-|-----|-----|-----|----|||--||%%|%---%----|-%%-----%-|---|---|------%----%--------|------%|---|-|--||%|
%%%%%%%%---|||||%-----|-|-|-|---%--%-%--|--|-|%|-----|-%%-%|--%--|----|||%%||||||---|%---|-||-----|-|---|---%---%-%|---%|----%%--|---%--||---|-|--||||
||||||||XXX|||X||XXXX-|X|-|X|XXX|--|X|XX|XX|-|||XXX--|X||-||XX|X-|-X-X||||||||X||XXX||XXX|X||XXXXX|X|XXXXXXX|XX-|X||XXX||---X||XX|XX-|XX||XXX|-XX-||||