------------------------------------------------------------------------------------------------------------------------------------------------------
------------------------------------------------------------------------------------------------------------------------------------------------------
------------------------------------------------------------------------------------------------------------------------------------------------------
------------------------------------------------------------------------------------------------------------------------------------------------------
------------------------------------------------------------------------------------------------------------------------------------------------------
------------------------------------------------------------------------------------------------------------------------------------------------------
---------------------------------------------------------------------------------------------------------------------------%--------------------------
--------------------------------------------------------------------------------------------------------------------------%|-U------------------------
--------%-----------------------------------------------------------------------------------------------------------------||--------------------------
--------|-----------------------------------------------------------------------------------------------------------------||-r-----------------%------
--------|-------------------------------------------%------------------------------------------------------t--------------||-%-----------------|------
--------|-------------------------------------------|------------------------------------------------------t--------------||-|-%--g------------|------
--------|-----#-%%-----%---%---%---------------%--%%|------------------%------------------%%--------%------t--------------||%|-|------%-%%-----|------
--------|----%#-||-%%--|---|---|---------------|--|||------------------|--%%%%-%-%--------||-%-----%|-----%%------%------%||||-|------|-||--%%-%%%----
%%%%%%%%|----|%-||-||-%|%%-|-%-|--%%%---------%|--|||%-%----%--%-%--%--|-%||||-|-|-%%-%--%||-|-%---||-----||------|----%-|||||-|------|-||--||-|||-%%-
|||||||||XX-X||X||X||X||||-|-|X|XX|||XXXXXXXXX||XX||||X|XXXX|XX|X|XX|--|-|||||X|X|X||-|XX|||X|-|XXX||X---X||-XX---|-XXX|XX|||XX|XXXX--|X||XX||-|||X||X