------------------------------------------------------------------------------------------------------------------------------------------------------
------------------------------------------------------------------------------------------------------------------------------------------------------
------------------------------------------------------------------------------------------------------------------------------------------------------
------------------------------------------------------------------------------------------------------------------------------------------------------
------------------------------------------------------------------------------------------------------------------------------------------------------
------------------------------------------------------------------------------------------------------------------------------------------------------
------------------------------------------------------------------------------------------------------------------------------------------------------
----------------------------%------------------------------------------------------------------------------------%------------------------------------
----------------------------|------------------------------------------------------%-----------------------------|------------------------%-----------
----------------------------|-----------%------------------------------------------|-----------------------------|----------%-------------|-----------
--------%--------------S--D-|-----------|----#----------------------------------%--|--------------------------%--|----------|-------------|-----------
--------|-------------------|-----------|----#--------------------------%-------|-%|----------%%--------------|--|-%-----%--|-------------|-----------
--------|%--%-------%-%-%---|-%-%%-%----|S---%-%-----%---%--------%%----|-------|-||----------||-%--%-%---%--%|--|-|-----|%%|---%-----%---|-----------
--------||--|-------|-|%|-%-%%|-||-|----|-%--|-|-----|---|%%------||----|-%-----|-||---%%%%--%||-|--|-|--%|--||--|-|-----||||---|-----|---|----------%
%%%%%%%%||--|%------|-|||-|-|||-||-|----|-|--|%|-----|--%|||------||----|-|%----|-||---||||--|||-|--|-|--||--||--|%|%-%%%||||---|-----|-%%|%------%%-|
||||||||||X-||XXXXXX|-|||-|X|||-||X|XX--|X|X-|||XX--X|X-||||-XXXXX||--X-|X||XXXX|X||XXX||||-X|XX-|XX|XX--||X-||XX||||X|||X|||XXX|X----|X||||XXXXXX||X|