------------------------------------------------------------------------------------------------------------------------------------------------------
------------------------------------------------------------------------------------------------------------------------------------------------------
------------------------------------------------------------------------------------------------------------------------------------------------------
------------------------------------------------------------------------------------------------------------------------------------------------------
------------------------------------------------------------------------------------------------------------------------------------------------------
------------------------------------------------------------------------------------------------------------------------------------------------------
------------------------------------------------------------------------------------------------------------------------------------------------------
------------------------------------------------------------------------------------------------------------------------------------------------------
------------------------------------------------------------------------------------------------------------------------------------------------------
------------------------------------------------------------------------------------------------------------------------------------------------------
--------------------------------------------g------------------------------------%--------------------------------------------------------------------
--------------------------------%------------------------------------------------|-------%-------------------------%---------------%------------------
-----------%-------%------------|-%---%------%---------------%-------------------|------%|---%%------------------%%|-%-%-------%---|-----------%--%---
--------%--|-------|------------|-|---|------|--------------%|%--------%%%--%----|------||---||------------------|||-|-|-------|---|----%---%%-|-%|---
%%%%%%%%|--|-------|--%---%-%%--|-|---|-----%|---%%%--------|||--------|||--|%-%-|------||---||----------%%---%--|||-|-|------%|-%-|----|---||-|-||---
|||||||||XX|-XX----|XX|XXX|X||XX|X|X--|XX--X||X-X|||------XX|||XXXX-XXX|||-X||X|X|-XXXX-||XXX||XXXXXXX---||XXX|-X|||X|-|-XXXX-||-|X|XXX-|-XX||X|X||XXX