------------------------------------------------------------------------------------------------------------------------------------------------------
------------------------------------------------------------------------------------------------------------------------------------------------------
------------------------------------------------------------------------------------------------------------------------------------------------------
------------------------------------------------------------------------------------------------------------------------------------------------------
------------------------------------------------------------------------------------------------------------------------------------------------------
------------------------------------------------------------------------------------------------------------------------------------------------------
---------------------------------------------------------------------------------------S-----------S---------------U----------------------------------
------------------------------------------------------------------------------------------------------------------------------------------------------
-------------S---------------------------------------%-------------S-----------------------------------------------r----------------------------------
-----------------------------------------------------|---------------------------------%---------------------------%----------------------------------
-----------------------------------------------------|------------------------%----%---|-----------%---------------|-----------------------%----------
----------%-------------------%----------------------|------------------------|----|---|-----------|---------------|-----------------------|----------
----------|-------------------|----%--%%-------%%-%--|--%%-----%%%------------|----|---|-----%-----|---------------|---------------%--%----|--%-------
----------|-------%--%--------|--%-|--||-----%%||-|--|--||--%--|||-%-------%--|%-%-|---|-%-%-|-----|-----%-%-%%--%-|%------%-----%-|--|%%--|--|-------
%%%%%%%%--|-------|--|%--%%%--|--|-|%%||%----||||-|--|%%||%-|--|||-|---%---|--||-|%|%-%|-|%|-|-----|-----|-|-||--|%||%%----|-----|-|%-|||--|--|----%--
||||||||XX|XXX-XXXXXX||XX|||X-XXX|X||||||X--X||||X|--||||||-|XX|||X|--X|X--XX-||-||||X||XX||-|XXXX-|XXXXX|-|X||-XX|||||XXXX|XXXXX|X||X|||--|XXXXXXX|XX