------------------------------------------------------------------------------------------------------------------------------------------------------
------------------------------------------------------------------------------------------------------------------------------------------------------
------------------------------------------------------------------------------------------------------------------------------------------------------
------------------------------------------------------------------------------------------------------------------------------------------------------
------------------------------------------------------------------------------------------------------------------------------------------------------
------------------------------------------------------------------------------------------------------------------------------------------------------
------------------------------------------------------------------------------------------------------------------------------------------------------
-----------------------------------------------------------------------------------------------------------------S------------------------------------
---------D---------------------------------------------------------------------------------------------------------------------%----------------------
-------------------------------------------------------------------------------------------------------------------------------|----------------------
----------------------------------------------------------S-----------------------------%--------------------------------------|----------------------
---------%g---------------------------------------------------------%-----------------%-|--------------------------------#-----|----------------------
---------|----%%------%%-%-----------------------------%%-----------|%-%---------%----|-|-%-----%------------------------%-----|---%-----------%------
---------|----||---%--||-|%%-----------------%---------||---------%-||-|------%--|----|-|-|----%|--%%---%------------%%--|%----|---|-----------|------
%%%%%%%%-|----||-%-|-%||-|||-----------%----%|---------||-%-%-----|-||%|------|--|----%-|-|%---||--||---|-----------%||--||---%|---|---%---%---|%%--%%
||||||||X|XXXX||X|X|X|||X|||-X-X---XXX-|XXXX||XX-XX-XXX|X-|X|--XXX|X|||XXXXX-X|XX|XXXX|-|X||XXX||XX||X-X|XX-XXXXXXX-|||X-||XXX||XXX|--X|XXX|-XX|||-X||