------------------------------------------------------------------------------------------------------------------------------------------------------
------------------------------------------------------------------------------------------------------------------------------------------------------
------------------------------------------------------------------------------------------------------------------------------------------------------
------------------------------------------------------------------------------------------------------------------------------------------------------
------------------------------------------------------------------------------------------------------------------------------------------------------
--------------------------------------------------%-----------------------------------------------------------2---------------------------------------
--------------------------------------------------|----------------------------------------------------------------------------D----------------------
--------------------------------------------------|-----------------------------------------------------------------------------%---------------------
--------------------------------------------------|-----------------------------------------------------------------------------|---------------------
--------------------------------------------------|----------------------------------%------------------------------------------|--t------------------
--------------------------------------------------|----------------------------%-----|------------------------------------------|--t------------------
--------------------------------------------------|-%--------------------------|-----|---------S-S------------%-----------------|--t------------------
---------%-----------------%----%%---%------%-----|-|-------%--------------%---|-----|------------%-----------|----------------%|--t------------------
---------|--------%--------|----||---|------|-%---|%|%------|--%--------%--|---|%%--%|%%%%------%-|--%------%%|-------%-%%-----||%-%%%-%----%---------
%%%%%%%%-|--%%%---|------%-|%%--||---|------|-|---||||------|--|--------|--|---|||--||||||-----%|-|--|-%----|||---%-%%|-||%-%--|||-|||-|---%|%%----%-%
||||||||X|XX|||XX-|X-XXXX|X|||XX||XXXX--X-XX|X|---||||XXXXXX|XX|XXXXXXXX|XX|XXX|||--||||||XXXXX|XX|XX|X|X-XX|||X-X|X|||X|||X|XX|||X|||-|--X||||-XXX|-|