------------------------------------------------------------------------------------------------------------------------------------------------------
------------------------------------------------------------------------------------------------------------------------------------------------------
------------------------------------------------------------------------------------------------------------------------------------------------------
------------------------------------------------------------------------------------------------------------------------------------------------------
------------------------------------------------------------------------------------------------------------------------------------------------------
------------------------------------------------------------------------------------------------------------------------------------------------------
------------------------------------------------------------------------------------------------------------------------------------------------------
------------------------------------------------------------------------------------------------------------------------------------------------------
------------------------------------------------------------------------------------------------------------------------------------------------------
----------------------------------------------------------------------------------------------------------------D-------------------------------------
---------------------------------------------------------------------------D%-%----------------------------------------------------------------S------
-------------------------------%--------------------------U-----------------|-|---%------------------------------%------------------------------------
-----------%%----%---%%%%%-----|--------%%------------%--------%-%------%---|-|---|----%---%---------------------|---------%------------%-------%---%%
-----------||%%%%|--%|||||---%-|-------%||----%-----g-|--------|-|-----%|-%%|-|%--|%%%%|---|-----------------%--%|---------|-------%----|-%-----|---||
%%%%%%%%---|||||||--||||||--%|-%------%|||-%--|-------|%-----%%|-|----%||-|||%||--||||||---|-%--%%%----------|--||---------|%------|----|-|----%|---||
||||||||XX-|||||||X-X|||||XX||-|X-XXXX||||-|XX|XXXXXX-||--XX-|||X|X--X|||X||||||XX||||||-XX|-|--|||--XXXXX-XX|XX||-XXXXX-XX||XXXXXX|-XXX|X|X-XX||XXX||