------------------------------------------------------------------------------------------------------------------------------------------------------
------------------------------------------------------------------------------------------------------------------------------------------------------
------------------------------------------------------------------------------------------------------------------------------------------------------
------------------------------------------------------------------------------------------------------------------------------------------------------
------------------------------------------------------------------------------------------------------------------------------------------------------
---------------------------------------%--------------------------------------------------------------------------------------------------------------
---------------------------------------|--------------------------------------------------------------------------------------------------------------
---------------------------------------|--------------------------------------------------------------------------------------------------------------
---------------------------------------|--------------------------------------------------------------------------------------------------------------
---------------------------------------|-----------------%---------------------------------------------%----------------------------------------------
---------------------------------------|-----------------|---------------------------------------------|----------------------------------------------
------------------------%--------------|---------%-------|-----%------------------------------%---%----|---------------%------------------------------
------------------------%--------------|---------|-G%----|-----|----%------%-------------%----|%--|----|%-%---------%--|-------%%--------------%------
-----------%----%%%--%--|---%----%-----%---------|-%|----|-----|----|------|%%------%---%|----||--|----||-%%---%%---|-%|---%---||%-------------|------
%%%%%%%%%-%|----|||--|%-|---|----|-----|---------|-||----|-----|-%--|--%--%|||%%%%%%|---||--%-||%-|----||-||---||%--|%||%%-|---|||---%--%%%%%--|------
|||||||||X||XXXX|||XX||XXXXX|XXXX|X-XXX|XXXX-X---|XX|-XXX|XXXXXXX|X-|-X|X-|||||||||||XXX||XX|-X||X|X---|X-X|XXX|||XX||||||X|XXX|||---|XX|||||X-|-XXXXX