------------------------------------------------------------------------------------------------------------------------------------------------------
------------------------------------------------------------------------------------------------------------------------------------------------------
------------------------------------------------------------------------------------------------------------------------------------------------------
------------------------------------------------------------------------------------------------------------------------------------------------------
------------------------------------------------------------------------------------------------------------------------------------------------------
------------------------------------------------------------------------------------------------------------------------------------------------------
------------------------------------------------------------------------------------------------------------------------------------------------------
------------------------------------------------------------------------------------------------------------------------------------------------------
------------------------------------------------------------------------------------------------------------------------------------------------------
--------------------------------------------------------------------------------------------------------------#---------------------------------------
------------------------%---%----------------------%-----------------%-----------------%---------------%------#---------------------------------------
------------------------|---|----------------------|-----%-----------|-------%%--------|---------------|-%----#--------------------%-----------%------
-------------------%%---|---|----------------------|-----|-----------|-------||----%---|-----%-----%%-%|-|%--%%-%----%----%---%---%|--------%%-|------
-------------------||---|---|---------------%------|-----|-%---------|-------||-%--|-%%|---%-|-----||-||-||--||-|----|----|---|---||--%--%--||-|------
%%%%%%%%-%--%-%----||---|---|--%--------%-%%|-----%%-----|-|-%%-%----|-------||%|--|%|||%--|-|-----||%||-||--||%|-%--|----%---|-%-||-%|--|%%||%|------
||||||||X|X-|X|XXXX||XX-|XXX|XX|XXXXXXXX|X|||-----||XXXXX|X|X||X|XXXX|XXXXXXXXX||--||||||X-|X|X-XXX|||||X||X-||||X|XX|X---|XXX|-|X||X||XX|||||||-XXXX-