------------------------------------------------------------------------------------------------------------------------------------------------------
------------------------------------------------------------------------------------------------------------------------------------------------------
------------------------------------------------------------------------------------------------------------------------------------------------------
------------------------------------------------------------------------------------------------------------------------------------------------------
------------------------------------------------------------------------------------------------------------------------------------------------------
------------------------------------------------------------------------------------------------------------------------------------------------------
------------------------------------------------------------------------------------------------------------------------------------------------------
------------------------------------------------------------------------------------------------------------------------------------------------------
-----------------------------------------------------------------------------------------------------------------------------------S------------------
---------------------------------------------------%-----------------------------------------------------------------------------------------------%--
---------------------------------------------------|--------------------------------------------------------------%---------%----------------------|--
-----------%--------------%------------------------|--------------------------g-----------------------------------|---------|----------------------|--
---------%%|--------------|----------------------%%|------------%--------------------------K%---------------------|---------|--%---%--%-%----%-----|--
--------%|||-----------%--|------------------%---|||---%----%%--|--------------%-----------%|---%%----%%--%%------|--------%|%-|%--|--|-|----|-----|--
%%%%%%%%||||---%%%-----|--|---------%%%-%----|---|||-%-|-%--||--|-----%--------|--%-----%--||%%-||--%%||--||------|--------|||-||--|--|-|----|-----|-%
|||||||||||X---|||XXXXX|X-XXXXXXXXXX|||X|-XXX|XXX|||-|X|X|XX||XX|XXXX-|XXXX--XX|XX|XX-XX|--X|||X||XX||||XX||XXXXXX|XXXX-XXX|||-||-X|X-|-|XXXX|X-X--|X|