------------------------------------------------------------------------------------------------------------------------------------------------------
------------------------------------------------------------------------------------------------------------------------------------------------------
------------------------------------------------------------------------------------------------------------------------------------------------------
------------------------------------------------------------------------------------------------------------------------------------------------------
------------------------------------------------------------------------------------------------------------------------------------------------------
------------------------------------------------------------------------------------------------------------------------------------------------------
-------------------------------------------------------------------------%--------------------------------------%------%------------------------------
---------------------------------------------------------------------S---|--------------------------------------|------|------------------------------
--------------------------------------------------------g----------------|--------------------------------------|------|------------------------------
-------------------------------------------------%-----------%-----------|--------------------------------------|------|------------------------------
-------------------------------------------------|-----------|----%--%%--|--------------------------------------|------|------------------------------
----------------%--------------------------------|-----------|--%-|--||--|----%---------------------------------|------|------S-----------------------
----------------|---%------%------%----------%---|---%-------|--|%|--||--|-%%-|------------------------------%--%------|------------------%--------%-%
--------------%%|---|-----%|-----%|--------%-|---|---|-------|-%|||--||--|-||-|------%--%--------------%%----|%%|k%%---|%-------------%---|----%---|-|
%%%%%%%%------|||%-%|-----||%----||--------|%|---|---|-%-----|-||||--||--|-||-|%--%%-|-%|-------%%--%--||%-%-||||-||-%-||---%---%%%%%-|---|----|--%|%|
||||||||XX-X--|XX|X||X-XXX|||XX-X|XXXXXXXXXX||XXX|XXX|X|---XX|X|X||XX||XX|-||-||XX||X|-||X---XXX||XX|--|||X|-||||X||-|X||X-X|XXX|||||X|XXX|----|X-||||