------------------------------------------------------------------------------------------------------------------------------------------------------
------------------------------------------------------------------------------------------------------------------------------------------------------
------------------------------------------------------------------------------------------------------------------------------------------------------
------------------------------------------------------------------------------------------------------------------------------------------------------
------------------------------------------------------------------------------------------------------------------------------------------------------
------------------------------------------------------------------------------------------------------------------------------------------------------
------------------------------------------------------------------------------------------------------------------------------------------------------
-------------------------%------%--------------------------------------------------t------------------------------------------------------------------
-------------------------|------|--------------------------------------------------t------------------------------------------------------------------
-------------------------|------|--------------------------------------------------t------------------------------------------------------------------
-------------------------|-----C|--------------------------------------------------%------------------------------------------------------------------
-------------------------|------|--------------------------------------%-----------|----------%----------%--------------------------------------------
--------%----------%%----|------|--------------------------%%--2--%----|------%---%|------%%--|----------|------------------%%%------%-%----%---------
--------|%-#----%-%||----|-----%%--------%%------------%---||%-%-%|----|-----%|-%-||------||--|----------|------------%-----|||------|%|----|---------
%%%%%%%%||-%----|-|||---%|%----||%%------||-----------%|---|||-|-||%--%|%-%--||%|-||------||%-|%%%-----%-|----%%------|----%|%|-%%---|||--%%|--------%
||||||||||X|XXXX|X|||--X|||XX-X||||X-XX--||-XXX-XXXXXX||XXX|||XXX|||-X|X|-|XX|||XX||XXX--X|||XX|||XXXXX|X|XXXX||---XXX|XXXX||||X||XXX|||X-||XXX-XXXXX|