------------------------------------------------------------------------------------------------------------------------------------------------------
------------------------------------------------------------------------------------------------------------------------------------------------------
------------------------------------------------------------------------------------------------------------------------------------------------------
------------------------------------------------------------------------------------------------------------------------------------------------------
------------------------------------------------------------------------------------------------------------------------------------------------------
------------------------------------------------------------------------------------------------------------------------------------------------------
---------------------------------------------------------------------------------------------------2--------------------------------------------------
--------------------------------------------------------------------------------------------------------------------------------%---------------------
--------------------------------------------------------------------------------------------------------------------------------|---------------------
--------------------------------------------------------------------------------------------------------------------------------|---------------------
----------------------------------------------------%------------------------------------------%-%-%----------------------------|----%------------%---
-----------g%-------------------%----%%-------------|-------------%------------------------%---|-|-|----------------------------|----|--%--------%|---
------------|-%%%--------------%|----||--%----------|-%--%--%%----|%-----%-------------%---|---|-|-|--%--------------%------%---|%---|--|-----%--||---
------------|-|||-----%--------||S-%-||--|%%-%%-----|-|%-|--||--%-||-----|-------------|-#-|-%-|-|%|--|--------------|------|---%|%--|--|-%--%|--||---
%%%%%%%%----|-|||-----|----%---||--|%||--|||-||--%--|-||-|--||%%|-||-%---|-------------|-#-|-|-|-|||%-|--------%----%|------|---|||-%|--|%|--||--||---
||||||||-XXX|X|||XXXXX|XXX-|---||X-||||XX|||X||--|XX|-XXX|-X|X|||X||X|-XX|XXXXXXXXXXXXX|XX-|X|-|X||||-|---XXXXX|-XXX||X-XXXX|XXX||XX||XX|||-X||XX||-XX