------------------------------------------------------------------------------------------------------------------------------------------------------
------------------------------------------------------------------------------------------------------------------------------------------------------
------------------------------------------------------------------------------------------------------------------------------------------------------
------------------------------------------------------------------------------------------------------------------------------------------------------
------------------------------------------------------------------------------------------------------------------------------------------------------
------------------------------------------------------------------------------------------------------------------------------------------------------
------------------------------------------------------------------------------------------------------------------------------------------------------
----------------------------------------------T-------------------------------------------------------------------------------------------------------
----------------------------------------------t--------------------------------------------%%---------------------------------------------------------
----------------------------------------------t--------------------------------------------||---------------------------------------------------------
----------------------------------------------t%--------------%--------------------------%-||-----------------------------------------%%%%------------
----------------------------------------------%|--------g-----|--------------------------|-||-----------------------------------------||||--%---------
-------------%---%-----%---------------S--%---||---%----%-----|------%-----%---%-%-------|-||-----------------------------------------||||%-|%------%%
-------------|---|-----|------------------|---||---|%-%%|-----|------|-----|---|-|-------|%||%%--------%%-%--%-------------------%--%-|||||%||%---%-||
%%%%%%%%%----|---|--%--|-----------%----%-|---||--%||-|||--%--|%-----|%%%%%|---|-|--%--%-||||||--------||-|--|----%-----%--------|--|-|||||||||%%-|-||
|||||||||XX-X|-XX|XX|-X|XXXX-XXXXXX|XXXX|X|XXXX|X-|||-||X-X|--||X-X--|||||||XXX|X|X-|XX|X||||||XX-XXXXX||X|XX|XXXX|-X-XX|X-XXXXXX|XX|X||||||X||||X|X||