------------------------------------------------------------------------------------------------------------------------------------------------------
------------------------------------------------------------------------------------------------------------------------------------------------------
------------------------------------------------------------------------------------------------------------------------------------------------------
------------------------------------------------------------------------------------------------------------------------------------------------------
------------------------------------------------------------------------------------------------------------------------------------------------------
------------------------------------------------------------------------------------------------------------------------------------------------------
-------------------------------------------------------------------------------------S----------------------------------------------------------------
----------------------------------------------------------------------%--------------------------------------------------------%----------------------
-----------------------------------------------------T----------------|--------------------------------------------------------|----------------------
-----------------------------------------------------t----------------|--------------------------S-----------------------------|----------%-----------
------------------------------------------%----------t----------------|--------------%----%--%---------------------------------|----------|#----------
------------------------------------------|-%---%----t----g-----------|--------------|-%--|--|-------------------------%-------|----------|#----------
--------------------%---%-%---------------|-|---|----%-----------%----|--------------|-|--|--|-------------------%-----|--%----|-%----%---|%%-----%---
--------------------|---|-|-----------%---|%|-%-|----|-%---------|----|--%--%%%----F%|-|%-|-%|%%-%-%-------------|----%|--|--%-|%|----|---|||-----|-%%
%%%%%%%%--%-----%%--|---|-|%----%%----|-%-|||%|-|----|-|---------|%%--|%-|--|||-%--%||%||-|-||||-|-|%---%--------|----||--|--|-|||--%%|--%|||--%--|-||
||||||||-X|XX-XX||XX|-XX|X||-XXX||XXXX|X|X||X||XX--XXXX|--XX-XXXX|||XX||-|XX|||-|-X|||||XX|-||||X|-||XXX|XXXXXXXX|XX-XXXXX|--|X|||XX|||--||||X-|XX|X||