------------------------------------------------------------------------------------------------------------------------------------------------------
------------------------------------------------------------------------------------------------------------------------------------------------------
------------------------------------------------------------------------------------------------------------------------------------------------------
------------------------------------------------------------------------------------------------------------------------------------------------------
-------------%----------------------------------------------------------------------------------------------------------------------------------------
-------------|----------------------------------------------------------------------------------------------------------------------------------------
-------------|----------------------------------------------------------------------------------------------------------------------------------------
-------------|-------------------------------------------------------------------------------------------------%--------------------------------------
-----------%-|-------------------------------------------------------------------------------------------------|--------------------------------------
-----------|-|------------------------------------------------------------------------%------------------------|--------------------------------------
---------%-|-|--------------------------------------------------------------------%---|-----------------------%|--------------------------------------
---------|-|-|g--------C--------------------------------------------------%g------|---|-----------------------|%--------------------------------------
--------%|-|-%-------%%--%-------%----%--------------------C%-------------||-----%|---|------%-----%----------||---------%---------%-%----------------
--------||-|-|--%----||%-|-------|----|--------%------------|-----%-------||----%||---|------|-%%-%|%-%%---%--||--%------|---------|-|----------------
%%%%%%%%|%-|-|--|%---|||%|%%%--%%|%--%|--%%----|-----%%-%---|-----|-%---%%||----|||---|------|-||-|||-||%--|--||--|------|---------|-|-----%----------
||||||||||X|X|XX||-XX||X|||||XX||||XX|X-X||XXXX|XXXXX||-|XXX|XXXXX|X|X--|||XXX-X|||XX-|XXXXXX|X||-|||XX||XX|-X||XXX--XXXX|XX--XXX-X|X|XXXXX|-XXXXXXXX-