------------------------------------------------------------------------------------------------------------------------------------------------------
------------------------------------------------------------------------------------------------------------------------------------------------------
------------------------------------------------------------------------------------------------------------------------------------------------------
------------------------------------------------------------------------------------------------------------------------------------------------------
------------------------------------------------------------------------------------------------------------------------------------------------------
------------------------------------------------------------------------------------------------------------------------------------------------------
------------------------------------------------------------------------------------------------------------------------------------------------------
-----------------------------------------------------------------------------------------%-------------------------%------------------------D---------
-------------------------%---------------------------------------------------------------|-------------------------|----------------------------------
-------------------------|--------------------%--------------------------------%---------|-------------------------|----------------------------------
-------------------------|--------------------|--------------------------------|---------%------------------------%|-----------%------------%---------
----------------------%--|-----------%--------|------------%-----S-------------|---------|------------------------||-----------|------------|%---%----
-------------%--------|%-|--%%--%---%|--------|---%--------|---------%---%----%|%--------|-----%-----------------%||-----------|------------||%--|----
-------------|--------||-|%-||-%|---||-%---%--|---|-----%--|-%-------|---|--%-|||--%----%|-----|-----------------|||-%%------%-|--%--%------|||--|----
%%%%%%%%-%---|------%%||-||-||-||---||-|---|--|---|-----|--|-|-----%-|---|--|-|||--|-%-%||-%-%-|---------%-------|||-||------|-|--|--|--%---|||--|----
||||||||X|-X-|X--XXX||||X|XX||-||-XX||X|X--|X-|XXX|XXXX-|X-|X|X--XX|X|XXX|-X|X|||-X|X|X|||X|X|-|--XXX--XX|XX--X--|||X||XXXX-X|X|X-|XX|XX|XXX|||XX|XXXX