------------------------------------------------------------------------------------------------------------------------------------------------------
------------------------------------------------------------------------------------------------------------------------------------------------------
------------------------------------------------------------------------------------------------------------------------------------------------------
------------------------------------------------------------------------------------------------------------------------------------------------------
------------------------------------------------------------------------------------------------------------------------------------------------------
------------------------------------------------------------------------------------------------------------------------------------------------------
-----------------------------------------------------------------S------------------------------------------------------------------------------------
------------------------------------------------------------------------------------------------------------------------------------------------------
------------------------------------------------------------------------------------------------------------------------------------------------------
-----------------------------------------------------------------%------------------------------------------------------------------------------------
------------------------------------------%---------%------------|----------------------------------------------------------------------%-------------
----------------------------------%-------|------%--|------------|-----------------------------------%------%---------------------------|-------------
---------%------------------%-%--%|-------|%---%-|--|--%%%-----%-|----%-------------%----------%-----|------|----%----------------%-%---|-------------
---------|------%%---%------|2|--||-%%----||-%-|%|--|--|||-%---|-|-%%-|-------------|%--%--%%%-|-----|%-----|----|---------------%|%|---|-----%-------
%%%%%%%%%|-%%---||--%|%--%%%|-|%%||%||-%%%||-|-|||%-|--|||-|---|%|-||%|---%---------||--|-%|||-|-----||-----|----|--------%------||||-%-|-----|-------
||||||||||-||XXX||--|||--||||XX|||||||-|||||X|X||||X|XX|||X|XX-|||X||||XXX|--XXXXXX-X|XX|-||||X|XXXXX||XX---|X---|-XXXXXXX|XXX--X||||X|-|XXX-X|XXXXXXX