------------------------------------------------------------------------------------------------------------------------------------------------------
------------------------------------------------------------------------------------------------------------------------------------------------------
------------------------------------------------------------------------------------------------------------------------------------------------------
------------------------------------------------------------------------------------------------------------------------------------------------------
-------------------------------------------------------%----------------------------------------------------------------------------------------------
-------------------------------------------------------|-------------------%-----------------------------------%--------------------------------------
-------------------------------------------------------|-------------------|-----------------------------------|--------------------------------------
-------------------------------------------------------|-------------------|-----------------------------------|--------------------------------------
-------------------------------------------------------|-------------------|%----------------------------------|--------------------------------------
------------------------------%------------------------|-------------------||----------------------------------|---------------------t----------------
------------------%---%-------|------------------------|-------%------%%---||-------------------------%--------|---------------------t----------------
-------------%----|---|-%---%%|------------------------|-------|------||--%||-----------F-%-----------|--------|-----------------%---%----------------
-------------|-%%-|%-%|-|---|||--------------------%%--|%------|------||--|||----------%%-|-----%-----|--------|-%---------------|---|-----%--%-------
-------------|-||-||-||-|---|||-----%--------------||--%|------|---%--||--%||----------||-|-----|-----|-%------|-|---------------|---|-%---|--|%------
%%%%%%%%-----|-||-||-||-|---|||----%|------%-%-----||--||----%-|---|--||--|||-%--------||-|%----|----%|%|%%%---|%|---%--%-----%%%|%%%|-|---|--||------
||||||||X-X-X|X||-||X||X|XX-|X|XXXX||XXXXXX|X|XXX--||-X||XXX-|X|XXX|XX||XXX||-|XXXX----|XXX|----|-XXX|||||||XXX|||XXX|X-|XXX-X||||||||X|XXX|--|XXX-XX-