------------------------------------------------------------------------------------------------------------------------------------------------------
------------------------------------------------------------------------------------------------------------------------------------------------------
------------------------------------------------------------------------------------------------------------------------------------------------------
------------------------------------------------------------------------------------------------------------------------------------------------------
--------------------------------------------------------------------------------------------------------------------------------------------D---------
------------------------------------------------------------------------------------------------------------------------------------------------------
-----------------------------------------------------------------------------------------------------%------------------------------------------------
-----------------------------------------------------------------------------------------------------|------------------------------------------------
----------------------------------------------------------------------%----%-------------%-----------|--------------------------------------%---------
-----------------------------------------------------%------------%g--|----|-------------|-----------|-----------------S--------------------|---------
-----------------------S-----------------------------|------------|---|----|-------------|-----------|-------------------------%------------|---------
-----------%%---------------------------------------g|------------|---|-%--|--%-%--------|-----------|-------------------------|------------|---------
-----------||---------------------%-----------------||-----------%|---|%|-%|%%|-|--------|-%%%-------|-------------------------|--------%---|---------
-----------||---------------------|-%---------------||------%----||%--|||-|||||-|--------|-|||-----%-|------------------%------|----%%--|%--|---------
%%%%%%%%---||-%----%-%%%-%-------%|-|-%--%-%-%%-----||------|----|||--||%%|||||-|-%----%-|-|||-----|-|%----------%-%--%-|%-%%--|%---||--||--|-%-------
||||||||XXX||X|--X-|X|||-|XXX--XX||X|X|X-|-|X||--XXXXXX--XXX|-XXX|X|XX|||||||||X|-|-X--|X|-|||-----|X||XXXXXXXXXX|X|--|X||X||XX||XX-||XX||XXXX|XXXXXX-