------------------------------------------------------------------------------------------------------------------------------------------------------
------------------------------------------------------------------------------------------------------------------------------------------------------
------------------------------------------------------------------------------------------------------------------------------------------------------
------------------------------------------------------------------------------------------------------------------------------------------------------
-------------------------------------------------------------------------------------S----------------------------------------------------------------
------------------------------------------------------------------------------------%-----------------------------------------------------------------
------------------------------------------------------------------------------------|----%-----------%------------------------------------------------
------------------------------------------------------------------------------------|----|-----------|------------------------------------------------
-------------------------------------------------------------------%-------------%--|----|-----------|------------------------------------------------
-------------------------------------------------------------------|-----%%------|--|----|-----------|------------------------------------------------
-------------------------------------------------------------------|---%-||--%---|--|----|-----------|------------------------------------------------
-------------------------------------%-----------------------------|---|-||%-|---|--|%---|-%----%----|--%---------------------------------------------
-----------%--------------%-------%-%|-%--%-----------------------%|---|-|||-|---|--||---|-|----|----%--|---------------------------------------------
-----------|-K------------|%-%----|-||-|-%|---%%------%--------%-%||---|-|||-|---|-%||%--|-|----|---%|--|-%-----%-%-%----%----------------------------
%%%%%%%%-%-|-%%%-----%----||-|---%|%||-|-||--%||------|%---%---|-|||-%-|-|||-|---|-||||--|-|--%%|%--||--|%|%----|-|-|----|------%%%%-%%---------------
||||||||X|X|X|||--XXX|XXXXX|X|XXX||||XX|X||XX|||XXX--X||XXX|XX-|X|X|X|X|X|||X|-X-|X||||XX|-|XX||||XX||XXX|||-XXX|X|-|XXXX|XXXXXX||||X||XXXXXXXXX-X-X-X