------------------------------------------------------------------------------------------------------------------------------------------------------
------------------------------------------------------------------------------------------------------------------------------------------------------
------------------------------------------------------------------------------------------------------------------------------------------------------
------------------------------------------------------------------------------------------------------------------------------------------------------
------------------------------------------------------------------------------------------------------------------------------------------------------
------------------------------------------------------------------------------------------------------------------------------------------------------
-----------------------------------------------------------------------------------------------------------D------------------------------------------
------------------------------------------------------------------------------------------------------------------------------------------------------
------------------------------------------------------------------------------------------------------------------------------------------------------
-----------------------------------------------------------------------------------------------%-------------------------------------------------%----
-----------------------------------------------------------------------------------------------|------------------------------------%------------|----
-----------------------------------%-----------------------------------------------------------|------------------------------------|------------|----
-----------------%%-------%-%------|------%%%%-%---#--------------%%-%----%--%---------%--%----|%%-%-----%-%------%----------%------|------%%%---|----
-----------------||%------|-|--%---|%-----||||-|---#---------%----||-|--%-|--|-------%-|--|----||%-|-----|-|--%---|--%-------|------|------|||--%|----
%%%%%%%%--------%|||-%---%|%|--|---||-%%--||||%|%--%%--------|----||-|--|-|--|-------|-|-%|----|||%|--%--|-|--|---|--|%--%---|------|------|||--||----
||||||||X-XXXXXX|||X-|XXX||||XX|XXXX|X||XX|||||||--||XXXXXXXX|X---||-|XXXX|XX|-XXXXXX|X|-||-X--|||||XX|XX|X|X-|XX-|XX||XX|XXX|---X-X|XXXXX-|||XX||XXXX