------------------------------------------------------------------------------------------------------------------------------------------------------
------------------------------------------------------------------------------------------------------------------------------------------------------
------------------------------------------------------------------------------------------------------------------------------------------------------
------------------------------------------------------------------------------------------------------------------------------------------------------
------------------------------------------------------------------------------------------------------------------------------------------------------
------------------------------------------------------------------------------------------------------------------------------------------------------
------------------------------------------------------------------------------------------------------------------------------------------------------
------------------------------------------------------------------------------------------------------------------------------------------------------
----------------------------------------------------------------------------------------------------------------------S-------------------------------
------------------------------------------------------------------------------------------------------------------------------------------------------
------------------------------------------------------------------------------%-------------------------------------------------%---------------------
--------------------------------------------------%---------------------------|------%-t------------2------------------%--------|%----%---------------
---------------------%---%----------------%------%|-%--%----%---%----%---%---%|------|-t-----%-----%------------%-%--%%%-%-%----||--%-|---------%--%--
---------%----------%|---|%%%-----------%-|------||%|--|--%-|---|--%-|---|---||------|-%-%---|-----|--%-------%-|-|--|||-|-|----||--|-|----%--%-|--|--
%%%%%%%%-|%-----%--%||---||||--%--------|%|%%----||||%-|-%|-|%%%|--|-|---|%--||-%%--%|-|-|---|-----|--|-------|%|-|--|||-|%|--%-||-%|-|--%-|--|-|-%|--
||||||||-||---XX|X-|||XXX||||XX|--XXX-XX|||||XX--|X|||X|X||X|||||--|X|---||XX||X||XX|XX|X|XXXXXXXXXXXX|X---XXX|||X|XX|||X|||XX|-||X||X|XX|X|XX|X|X||XX