------------------------------------------------------------------------------------------------------------------------------------------------------
------------------------------------------------------------------------------------------------------------------------------------------------------
------------------------------------------------------------------------------------------------------------------------------------------------------
------------------------------------------------------------------------------------------------------------------------------------------------------
------------------------------------------------------------------------------------------------------------------------------------------------------
------------------------------------------------------------------------------------------------------------------------------------------------------
------------------------------------------------------------------------------------%-----------------------------------------------------------------
------------------------------------------------------------------------------------|----------------------------------------D------------------------
------------------------------------------------------------------------------------|--------------------------------------------D--------------------
------------------------------------------------------------------------------------|-----------------------------------------------------------------
------------------------------------------------------------------------------------|-----------------------------------------------------------------
---------------------------------------------%-----------------------------%--------|----%------------------------------------------------------------
---------%-----------------%%----------------|-----------------%%------%---|---#%---|----|------%------------------------%-------------------%--------
---------|%----------------||--------------%-|-----%-%%%-------||-%----|--%|---%|%--|----|------|-----%%-------------%-%-|--%%-%-------------|------%%
%%%%%%%%-||----------------||%%%%---%------|%|---%%|-|||-------||-|----|--||---|||--|----|%----%|-----||%--%%---%--%%|-|-|%-||-|-%----%---%--|------||
||||||||X||---XX-XXXXXXXX--||||||XXX|-XXX-XX|XXXX|||X|||-X-XX-X||XXXX--|XX|XXX-|||XX|-XXX||XXXX|XXXXXX|||XX||XXX|XX|||XXX||X||X|X|XXXX|X-X|XX|X--XX-X|