------------------------------------------------------------------------------------------------------------------------------------------------------
------------------------------------------------------------------------------------------------------------------------------------------------------
------------------------------------------------------------------------------------------------------------------------------------------------------
------------------------------------------------------------------------------------------------------------------------------------------------------
-------------------------------------------------------------------------------------------------------------------------D----------------------------
---------------------------------------------------------------------------%--------------------------------------------------------------------------
---------------------------------------------------------------------------|---------------------------------------------S----------------------------
---------------------------------------------------------------------------|--------------------------------------------------------------------------
---------------------------------------------------------------------------|--------------------------------------------------------------------------
---------------------------------------------------------------------------|-----%--------------------------------------------------------------------
------------------------------------------%--------------------------------|-----|---------------------------------------%----------------------------
------------------------------------------|--------------------------------|-----|----S----------------------------------|-------------%--------------
-----------------------------------%------|-S----------------------%%------|-----|%-------------------%--%%-%%-----------|--%----------|-------------%
-----------------------------------|------|------%-----------------||%-----|-----||%------%----------%|--||%||-%---------|--|%---------|-------------|
%%%%%%%%-----------------%---------|-----%|-----%|-----------%-----|||-----|-----|||------|----------||--|||||-|---------|--||%%%-%-%--|-------%%%%--|
||||||||XXX-XXXXXXXXXXXXX|XXXXXX-XX|-XXXX||-XXXX||X-XX-XXXXXX|XXX--|||--X-X|-XXXX||XXXX-XX|X-XXXXX-XX||X-|||||-|XX--XXXXX|XX|||||X|X|XXX-XX-XXX||||XX|