------------------------------------------------------------------------------------------------------------------------------------------------------
------------------------------------------------------------------------------------------------------------------------------------------------------
------------------------------------------------------------------------------------------------------------------------------------------------------
------------------------------------------------------------------------------------------------------------------------------------------------------
------------------------------------------------------------------------------------------------------------------------------------------------------
------------------------------------------------------------------------------------------------------------------------------------------------------
------------------------------------------------------------------------------------------------------------------------------------------------------
------------------------------------------------------------------------------------------------------------------------------------------------------
-------------------------------------------------------------------------------------------------------------------------C----------------------------
------------------------------------------------------------------------------------------------------------------------------------------------------
------------------------------------------------------------------------------------------------------------------------------------------------------
-----------------------%----------------------S-------------------------------------------%-----%-S---------------------------------g-----------------
-----------------------|--------%%-------------------------%---------------------%--------|%-%--|-----%--%--%%-%%%%---%%-%------%----%%---------------
-----------%--%--------|--------||---------%-g-----------%%|%%%--%%%%---%%-------|--------||-|--|%----|--|--||-||||---||-|------|----||-----%-%--%----
%%%%%%%%-%-|--|--------|--------||%----%%--|--%%---------||||||--||||--%||-------|------%-||-|--||----|--|--||-||||---||-|------|----||-%%--|-|--|-%--
||||||||X|X|-X|XX--X-XXXXXXXXXXX|||XX--||XX|XX||XXXXXXX--||||||X-||||XX|X|XXXXXXX|XXXX-X|XX|XXXXXXXX--|XXX--||X||||X--||X|XX-XXX|-XXX||X||XX|X|X-|-|XX