------------------------------------------------------------------------------------------------------------------------------------------------------
------------------------------------------------------------------------------------------------------------------------------------------------------
------------------------------------------------------------------------------------------------------------------------------------------------------
------------------------------------------------------------------------------------------------------------------------------------------------------
------------------------------------------------------------------------------------------------------------------------------------------------------
------------------------------------------------------------------------------------------------------------------------------------------------------
------------------------------------------------------------------------------------------------------------------------------------------------------
-------------------------------------------------------------------------------------------------------%----------------------------------------------
-------------------------------------------------------------------------------------------------------|----------------------------------------------
-----------%-------------------------------------------------------------------------------------------|----------------------------------------------
-----------|----------------------------------------------------------------------------------%--------|----------------------------------------------
-----------|----------------%------------------------------%g-----------------%---------------|--------|--2------------------%------------------------
-----------|----------------|--------%-----------------%---|--%%-----%----%%--|%---%------%---|--------|%%----------%---%---%|%-----------%-----------
----------%|----------------|--------|--------%----%-%-|---|-%||-%---|----||--||-%-|------|---|---%----|||-%%%------|---|---|||-----------|--------%%-
%%%%%%%%--||---%%--%--------|------%-|%--%%---|-%--|-|-|---|-|||-|-%-|---%||%-||-|-|------|%--|---|%---|||-|||------|---|--%|||----%--%%--|------%%||-
||||||||XX||XXX||XX|XXXXXXXXXXXX---|X||XX||XXX|X|-X|X|X|X--|X|||XXX|X|-XX||||X||X|X|XXXX--||XX|XXX||XXX|||X|||X--XXX|XXX|XX||||-X--|XX||X-|XXXXX-||||-