------------------------------------------------------------------------------------------------------------------------------------------------------
------------------------------------------------------------------------------------------------------------------------------------------------------
------------------------------------------------------------------------------------------------------------------------------------------------------
------------------------------------------------------------------------------------------------------------------------------------------------------
------------------------------------------------------------------------------------------------------------------------------------------------------
------------------------------------------------------------------------------------------------------------------------------------------------------
------------------------------------------------------------------------------------------------------------------------------------------------------
----------------------------------------------------------------------------------S-------------------------------------------------------------------
------------------------------------------------------------------------------------------------------------------------------------------------------
--------------------------------------------------------------------------------------------------------%----------------------------------%--------%-
--------------------------------------------------------------------------------------------------------g----------------------------------|--------|-
-----------------------------------------------------%--------------------------------------------------|--#%-------%----------------------|--------|-
----------------------------------%-----%%-----------|--------------%-------------------%%----%%%-------|--%|--%-%--|----------------------|------%%|-
--------------%------------%%--%%%|--%--||-------%---|--------------|-------------%-----||----|||------%|--||--|-|--|--%%------------------|------|||-
%%%%%%%%%-%---|----%%%-----||--||||--|--||%------|%-%|--%%-%---%----|-----%--%--%%|-%%--||%%%-|||-%%---|%--||%-|-|-%|-%||------%-----------|------|||-
|||||||||X|XXX|--XX|||XXXXX||X-||||XXXXX|||XXX--X||X||-X||X|XXX|---X|--XXX|X-|XX|||X||XX|||||X|||-||-XX||X-|||X|XXX||-|||XXXX--|-XXXX-X-XXX|XXXXXX|||-