------------------------------------------------------------------------------------------------------------------------------------------------------
------------------------------------------------------------------------------------------------------------------------------------------------------
------------------------------------------------------------------------------------------------------------------------------------------------------
------------------------------------------------------------------------------------------------------------------------------------------------------
------------------------------------------------------------------------------------------------------------------------------------------------------
--------------------------------------------------------------------------------------------------------------------%---------------------------------
--------------------------------------------------------------------------------------------------------------------|-----------------------------%---
--------------------------------------------------------------------------------------------------------------------|-----------------------------|---
--------------------------------------------------------------------------------------------------------------------|-----------------------------|---
---------------------------------------%%%--------------------------------------------------------------------------%-----------------------------|---
---------------------------------------|||--------------------------------------------------------------------------|-----------------------------|---
---------------------------------------|||---------------------------------------------------%-%--------------%-----|-----------------------------|---
-----------------%---------%-------%---|||%%----%---------%%-%-----------%---%--------------%|-|--------------|-----|----%-%---%------------------|---
------------%%---|-----%%--|---%-%-|--%|||||----|%%-------||-|------%----|---|--------------||-|%%---%--------|-%---|%---|-|---|------%-----------|--%
%%%%%%%%%--%||-%-|-----||--|-%-|-|-|--||||||%%%-|||%------||%|%%-%--|%%--|---|------------%-||-|||---|%---%---|-|-%%||-%%|-|--%|------|-----------|--|
|||||||||XX|||X|-|XXXXX||--|-|X|-|-|XX|||||||||X||||-X-XXX||||||X|-X|||XX|--X|X-XXXXXXXXXX|-||X|||-XX||X-X|XX-|-|X||||X|||-|XX||XXX-XX|XXXXX---XX-|--|