------------------------------------------------------------------------------------------------------------------------------------------------------
------------------------------------------------------------------------------------------------------------------------------------------------------
------------------------------------------------------------------------------------------------------------------------------------------------------
------------------------------------------------------------------------------------------------------------------------------------------------------
--------------------------------------------------------------------------%---------------------------------------------------------------------------
--------------------------------------------------------------------------|-%-------------------------------------------------------------------------
--------------------------------------------------------------------------|-|-------------------------------------------------------------------------
--------------------------------------------------------------------------|-|--------------------------------------------S----------------------------
--------------------------------------------------------------------------|%|---------------------------------------------------%---------------------
--------------------------------------------------------------------------D||---------------------------------------------------|---------------------
---------------------------------------------------------------%-----------||---------------------------------------------------|---------S-----------
----------%-----------------%-----------------%---------2------|-----------||---------------------------------------------------|----------------%---%
----------|-----------------|-----------%-%--%|---%------------|-----------||-----%----%----------#--%-------------------------%|-%%-------------|%--|
----------|-----------------|-#%--------|-|--||---|------------|-----------||-%---|----|----------#--|----------%-%------%-----||-||------%---%--||%-|
%%%%%%%%--|-------%-%-%-----|-%|-%------|-|--||%--|%-----------|--------%--||%|%%%|----|----------#--|----%----%|-|%---%-|--%-%||-||%-----|---|--|||-|
||||||||X-|XX-XXXX|-|X|-----X-||X|XX---X|X|XX|||-X||--XXXXXXXXX|XXXXXX--|XX||||||||X-XX|XXXXXXXXXXX-XXXX--|XXXX||-||XXX|X|XX|X|||X|||XXXXX|-XX|XXX|XXX