------------------------------------------------------------------------------------------------------------------------------------------------------
------------------------------------------------------------------------------------------------------------------------------------------------------
------------------------------------------------------------------------------------------------------------------------------------------------------
------------------------------------------------------------------------------------------------------------------------------------------------------
------------------------------------------------------------------------------------------------------------------------------------------------------
--------------------------------------------------------%---------------------------------------------------------------------------------------------
--------------------------------------------------------|---------------------------------------------------------------------------------------------
--------------------------------------------------------|---------------------------------------------------------------------------------------------
---------------t----------------------------------------|---------------------------------------------------------------------------------------------
---------------t---------------S------------------------|---------------------------------------------------------------------------------------------
---------------t----------------------------------------|---------------C-------------------------------%-------K---------%--%------------------------
---------------%---------%#----t------------------------|----%------------------------------------------|-------%---------|--|------------------------
---------------|----%----|#----t--%------------%--------|----|-------------------%------------%%--------|%%-----|--------%|--|-%--------%--------%%---
--------%%--%%-|-%%-|%--%|%%---t-%|----r%--%---|--%-----|---%|-------------------|%-%---------||-%------|||-----|--------||--|%|--------|--------||---
%%%%%%%%||--||%|-||-||--||||---%-||-----|--|---|--|-----|---||---%%%--%%%--------||-|------%--||-|----%-|||-%---|--------||--|||%-----%-|--%-----||-%%
||||||||||XX||||X||X||--||||X--|-||XXX-X|--|X-X|X-|-XXX-|XXX||XXX|||-X|||XX-----X||X|XXXXXX|XX||X|XX-X|-|||X|--XXXXXXXXXX||--||||XXXXX|X|XX|XXXX-||-||