------------------------------------------------------------------------------------------------------------------------------------------------------
------------------------------------------------------------------------------------------------------------------------------------------------------
------------------------------------------------------------------------------------------------------------------------------------------------------
------------------------------------------------------------------------------------------------------------------------------------------------------
------------------------------------------------------------------------------------------------------------------------------------------------------
------------------------------------------------------------------------------------------------------------------------------------------------------
----------------------------------------------------------------------------------------------------------------------%-------------------------------
------------------------------------------------------------------------------------------------------------D---------|-------------------------------
----------------------------------------------------------------------------------------------------------------------|-------------------------------
-----------------------------------------------------------------------------%-----g----------------------------------|%------------------------------
------------------------------------%----------------------------------------|-----|----------------------------------||------------------------------
--------------------------%---------|--------C--------------%----------------|-----|----------------------------------||-----------------------------%
-----------------%%-%%%---|---------|---%-----------------%%|----%----%------|-----|--%--%----------%------------%----||--------------------%--------|
---------------%-||-|||---|------%--|---|-----------------|||%---|%--%|------|-----%--|--|%---------|--%----%---%|-%--||-%--------%---%%%%--|%-------|
%%%%%%%%--%-%--|-||-|||---|------|--|---|-----%-------%---||||---||--||-%----|%%%%%|--|--||%%-%%--%-|--|----|-%-||-|--||-|-----%--|---||||--||------%|
||||||||X-|X|XX|X||X|||XXX|XXXXXX|XX|XXXXX-XXX|XXX-XXX|XXX||||X--||-X||-|X-X-|||||||XX|-X||||-||XX|X|XX|--XX|-|X||X|X-||XXXXX-X|XX|XXX||||XX||XXX-XX|X