------------------------------------------------------------------------------------------------------------------------------------------------------
------------------------------------------------------------------------------------------------------------------------------------------------------
------------------------------------------------------------------------------------------------------------------------------------------------------
------------------------------------------------------------------------------------------------------------------------------------------------------
------------------------------------------------------------------------------------------------------------------------------------------------------
------------------------------------------------------------------------------------------------------------------------------------------------------
---------------------%-----------------------------------------------------------------------------------------------------%--------------------------
---------------------|-----------------------------------------------------------------------------------------------------|----%---------------------
---------------------|-----------------------------------------------------------------------------------------------%-----|----|---------------------
---------------------|-----------------------------------------------------------------------------------------------|-----|----|---------------------
---------------------|-------------------------------------------------------------------------g--------------------t|-----|----|---------------------
---------------------|---------------------------------------------t%%--------------%-------------%-----------------t|-----|----|-------%-------------
--------------%-----%|--------------------%------------------------t||------------%%|-------------|%%-----%-------%-t|-----|-%--|-------|-------------
--------%-----|%----||-%------%%----------|--------------%----%--%%t||------%%---#|||--------%--%-|||-----|-----%%|%%|%----|%|%-|--%%-%-|-%%----------
%%%%%%%%|-----||----||-|------||------%---|--%-%-------%-|-%%-|--||%||------||---%|||----%---|%%|-|||-----|-----|||||||----||||%|-%||-|-|-||--%---%---
|||||||||XXX--||X-XX||X|XXXXXX|XXX----|X--|--|-|XXXXXXX|X|-||-|XX|||||XXXXXX||X--||||XX--|XXX||||X|||XXXXX|--XXXX||||||--XX||||||X|||-|X|X||XX|XXX|XXX