------------------------------------------------------------------------------------------------------------------------------------------------------
------------------------------------------------------------------------------------------------------------------------------------------------------
------------------------------------------------------------------------------------------------------------------------------------------------------
------------------------------------------------------------------------------------------------------------------------------------------------------
-------------------------------------------------------------------------S----------------------------------------------------------------------------
------------------------------------------------------------------------------------------------------------------------------------------------------
------------------------------------------------------------------------------------------------------------------------------------------------------
------------------------------------------------------------------------------------------------------------------------------------------------------
-----------------------------------------------%------------------------%-----------------------------------------------------------------------------
----------------------------%------------------|------------------------|-------------------------------------------------------------------%---------
----------------------------|---------------%--|------------------------|%---------------------------------------------------------------S--|---------
---------------------%------|---------------|--|-----------------%--%---||----------------%------------------------------------------------2|---------
----------%---------%|-%%---|--------%------|--|---%%-------%----|--|---||----------------|--------------%%--%--%---%---%%------------------|----%----
----------|%%--%-%%-||-||%--|--%%--%-|%%----|--|-U-||------%|----|-%|---||------%---------|--------------||--|%-|---|---||-----------%------|----|---%
%%%%%%%%%-|||-%|-||-||-|||--|-%||--|-|||--%-|--|---||------||---%|-||-%%%|------|-------%-|---%----------||%-||-|---|---||-----%-%---|-%%%--|----|---|
|||||||||X|||-||X||X||X|||X-|-|||X-|-|||XX|X|--|-XX||XXX-XX|XXX-||X||X||||-XX-XX|X-XXXXX|X|--X|XXXXXXXXXX|||-||X|XX-|XXX||-----|X|XXX|X|||-X|XX--|-X-|