------------------------------------------------------------------------------------------------------------------------------------------------------
------------------------------------------------------------------------------------------------------------------------------------------------------
------------------------------------------------------------------------------------------------------------------------------------------------------
------------------------------------------------------------------------------------------------------------------------------------------------------
------------------------------------------------------------------------------------------------------------------------------------------------------
------------------------------------------------------------------------------------------------------------------------------------------------------
------------------------------------------------------------------------------------------------------------------------------------------------------
------------------------------------------------------------------------------------------------------------------------------------------------------
----------------------------------------------------------------------------------------------------------------------------------------------------%-
------------------------------------------------------%---------------------------------------------------------------------------------------------|-
------------------------------------------------------|------------%-----------------------------------------------------------------------------%--|-
-------------------------------%----------------------|------------|--------%--------------------------------------------------------------------|--|-
-------------------------------|-----------%---%--%---|------------|------%-|------------------%-%----%%-----------------------------------------|-%|-
--------%%-------%-%-----%%----|------%----|---|--|---|-----------%|---%--|-|---------------%-%|-|--%-||--------------------------%------------%%|-||-
%%%%%%%%||---%--%|-|-----||----|--%-%-|----|-%-|-%|---|-----------||---|--|-|-------%%%-%%--|-||-|--|-||--------%%%--%%-%%%-------|------%-----|||-||-
||||||||||X--|--||-|X-X-X||X-XX|XX|X|X|XXX-|-|X|X|X-XX|XXXXXXXXXXX||XXX|XXXX|XX-XXXX|||-||-X|X||X|--|X||---X----|||XX||-|||XXXXXX-|XXX-X-|XXX-X|||-X|X