------------------------------------------------------------------------------------------------------------------------------------------------------
------------------------------------------------------------------------------------------------------------------------------------------------------
------------------------------------------------------------------------------------------------------------------------------------------------------
------------------------------------------------------------------------------------------------------------------------------------------------------
------------------------------------------------------------------------------------------------------------------------------------------------------
------------------------------------------------------------------------------------------------------------------------------------------------------
------------------------------------------------------------------------------------------------------------------------------------------------------
------------------------------------------------------------------------------------------------------------------------------------------------------
--------------------------------------------------------------------------------------------------------------------------%---------------------------
--------------------------------------------------------------------------------------------------------------------------|-----------%---------------
-----------%-----------------------------k-------------%-------------%------------------------------S---------------------|-----------|---------------
-----------|--------%------------------%-D-------------|----%--%-----|------------------------S---------------S----%------|-----------|---------------
-----------|------%-|---%-%%-----------|%--%%----------|----|--|----%|----%-----------%----%------------%--%-#-----|------|-----------|-------%------%
-----------|------|-|---|-||-------%---||--||-%--------|----|-%|----||-%--|-----------|-%%-|--------%---|--|-#-----|-%----|%---%------|--%%---|------|
%%%%%%%%---|---%%%|-|-%-|-||%%-----|---||--||%|-------%|-%--|-||----||-|--|--------%%-|-||%|-------%|---|--|-%-----|-|%---||---|------|--||%--|------|
||||||||X-X|XXX||||X|X|-|X||||---X-|---||XX||||XXXX--X||-|--|-||-XXX||-|XX|XXXXX---||XXX||||XXXX-XX||XXX|XX|-|X--XXXX||XXX||XXX|X-XXXXX-X|||--|XXXXXX|