------------------------------------------------------------------------------------------------------------------------------------------------------
------------------------------------------------------------------------------------------------------------------------------------------------------
------------------------------------------------------------------------------------------------------------------------------------------------------
------------------------------------------------------------------------------------------------------------------------------------------------------
------------------------------------------------------------------------------------------------------------------------------------------------------
------------------------------------------------------------------------------------------------------------------------------------------------------
------------------------------------------------------------------------------------------------------------------------------------------------------
-----------------------------------------------------------%------------------------------------------------------------------------------------------
----------------------------------------------%------------|------------------------------------------------------------------------------------------
----------------------------------------------|------------|-------------------%----------------------------------------------------------------------
----------------------------------------------|------------|-------------------|--------------------------------------------%-------------------------
----------------------------------------------|----------%%|---------%-----#---|----%---------%-----%-----------------------|-------------------------
------------%-%-----%-%%%%-------%------------|-----%----|||---------|-----#%--|----|%--------|-----|%----------------%%----|-------%---%---%%--------
------------|%|%---%|-||||-------|--------%%%-|----%|-%--|||---------|-----%|%-|--%-||%---%---|-----||----------------||%---|-------|---|---||--------
%%%%%%%%-%%-||||---||%||||--%-%%-|%--%----|||%|----||-|--|||----%----|%-%--|||%|%-|%|||---|---|-----||%%--%------%----|||---|%%---%-|---|---||%-------
||||||||X||X||||XX-|||||||X-|-||X||XX|XX-X|||||X-XX|XX|--XX|XXXX|XXX-||X|-X||||||X||X||XXX|XXX|XXX--||||X-|XXXXXX|--XX|||--X|||--X|X|XXX|XXX|||XXXXXXX