------------------------------------------------------------------------------------------------------------------------------------------------------
------------------------------------------------------------------------------------------------------------------------------------------------------
------------------------------------------------------------------------------------------------------------------------------------------------------
------------------------------------------------------------------------------------------------------------------------------------------------------
------------------------------------------------------------------------------------------------------------------------------------------------------
------------------------------------------------------------------------------------------------------------------------------------------------------
----------------------------------------------------%-------------------------------------------------------------------------------------------------
----------------------------------------------------|-------------------------------------------------------------------------------------------------
----------------------------------------------------|-------------------------------------------------------------------------------------------------
----------------------------------------------------|-------------------------------------------------------------------------------------------------
-------------------%-----%--------------------------|-------------------------------------------------------------------------------------------------
-------------------|-----|--------------------------|-------------------------------------------------------------------------------------------------
-------------------|-----|----------------%---------|---%---%%----------%-%--%%%--------%--------------%-%----%-------------------%----------%-----%--
-------------------|--%--|------------%---|---------|---|---||--%--%-%-%|-|--|||--------|-----%-----%--|%|----|-------%--%%%---%--|----------|----%|--
%%%%%%%%---%%--%%-%|--|--|------------|---|---------|%--|%--||%-|--|-|-||-|--|||------%-|-----|-----|--|||---%|%-%-%--|--|||---|--|----------|%---||--
||||||||XXX||XX||-||XX|XX|XXXXX-X--XXX|XXX|X-XXXXXXX||-X||XX|||X|X-|X|X||-|--|||XXXXXX|X|XXXXX|XXXXX|--|||X--|||-|X|X-|XX|||XX-|XXXXX-XXXX-XX||-XX||XX