------------------------------------------------------------------------------------------------------------------------------------------------------
------------------------------------------------------------------------------------------------------------------------------------------------------
------------------------------------------------------------------------------------------------------------------------------------------------------
------------------------------------------------------------------------------------------------------------------------------------------------------
------------------------------------------------------------------------------------------------------------------------------------------------------
----------------------------------------------------------------------------------------------------------------------------S-------------------------
------------------------------------------------------------------------------------------------------------------------------------------------------
------------------------------------------------------------------------------------------------------------------------------------------------------
------------------------------------------------------------------------------------------------------------------------------------------------------
------------------------------------------------------%-----------------------------------------------------------------------------------------------
------------------------------------------------------|--------------%-----------------------------------------------------------------------------%%%
-----------------------------%------------------------|---------k----|-----------------%--------------------%--------------------------------------|||
-----------%%----------------|----------------%-------|------%--%----|---%%---%---%----|-S----%---%---------|%-------------------------------------|||
-----------||%%-----%%%------|------------%--%|-------|%----%|--|----|---||---|---|----|------|---|------%%%||----------%---%--%%-----%------------|||
%%%%%%%%-%%||||-----|||------|---%%-%-%-%-|--||-%-----||----||-%|-%-%|%--||--%|---|----|-----%|---|%-----|||||-%--%-%%%-|---|--||----%|----%------%|||
||||||||X||||||-XX--|||-XXX-X|XXX||X|X|X|X|XX|XX|X-XXX||XXXX||X|XX|X|||X-||--||XXX|XX--XXXXXX||XXX||X-XXX|||||-|XX|X|||X|-XX|XX||-X--||XXXX|XXX--X||||