------------------------------------------------------------------------------------------------------------------------------------------------------
------------------------------------------------------------------------------------------------------------------------------------------------------
------------------------------------------------------------------------------------------------------------------------------------------------------
------------------------------------------------------------------------------------------------------------------------------------------------------
------------------------------------------------------------------------------------------------------------------------------------------------------
------------------------------------------------------------------------------------------------------------------------------------------------------
------------------------------------------------------------------------------------------------------------------------------------------------------
------------------------------------------------------------------------------------------------------------------------------------------------------
-------------------------------------------------------------------------%----------------------------------------------------------------------------
-------------------------------------------------------------------------|---------------------------------------t--------------------------------%---
-------------------------------------------------------------------------|---------------------------------------t--------------------------------|---
-------------------------------------%----------------------------------%|-%%---%--------------------------------t---------------------------%----|-%-
-----------------%-----%%--%%--------|%-%------------------%-----------%||-||---|----%-----------------%-%-------%----%-------%--------%-----|%-%-|-|%
-----------2---%-|-----||-%||%----%--||%|-%----------------|----------%|||-||---|----|-------%------%-%|-|------%|----|------%|--%-----|-%%--||-|-|%||
%%%%%%%%-------|-|---%-||-||||---%|--||||-|---%------------|---%-----%||||-||---|---%|--%----|------|-||-|------||%--%|--%---||--|-----|-||-%||-|-||||
||||||||XXXXXXX|X|--X|X||-X|||-XX||-X||||-|--X|XXXX-X-XX-XX|XX-|-----|||||-||XXXXXXX|X--|-XXX|X-XXXX|X||X|XXX-XX|||XX||XX|XXX|XXX|XXXXX|-||X|||X|X||||