------------------------------------------------------------------------------------------------------------------------------------------------------
------------------------------------------------------------------------------------------------------------------------------------------------------
------------------------------------------------------------------------------------------------------------------------------------------------------
------------------------------------------------------------------------------------------------------------------------------------------------------
------------------------------------------------------------------------------------------------------------------------------------------------------
------------------------------------------------------------------------------------------------------------------------------------------------------
------------------------------------------------------------------%-----------------------------------------------------------------------------------
------------------------------------------------------------------|-----------------------------------------------------------%-----------------------
------------------------------------------------------------------|-----------------------------------------------------------|-----------------------
------------------------------------------------%-----------------|-----------------------------------------------------------|-----------------------
------------------------------------------------|-----------------|----------------%---------------------------%--%------%----|-----------------------
---------------------------2------%--------%----|-----------------|--%-------------|--%------------------------|--|------|----|-----------------------
----------%%--%---%%--------%%----|--------|----|-------%---------%%%|--%-----%-%--|--|-----%---%-%---%--%-----|--|------|----|---------------%%%-----
----------||--|---||--------||----|--------|-%-%|-------|---------||||--|----%|-|%-|%-|%----|---|-|---|%%|---%%|--|------|%%%%|-------%--%----|||-----
%%%%%%%%%-||%%|%%-||%-------||%---%--------|%|%||--%----|--------%||||--|----||-||-||-||%---|---|-|---||||---|||--|---%%%||||||--%---%|--|---%||%-----
|||||||||X|||||||-|||-XXXXXX|||XX-|XXXX-XXXX|||||-X|XXXX|-XX--XXX||||XXX|XXXX||X||X||X|||---|XXX|X|XXX||||---|||-X|XXX|||||||X|--|X--||XXX--X||||XXX--