------------------------------------------------------------------------------------------------------------------------------------------------------
------------------------------------------------------------------------------------------------------------------------------------------------------
------------------------------------------------------------------------------------------------------------------------------------------------------
-----------------------------------------------------------------------------------------g------------------------------------------------------------
-----------------------------------------------------------------------------------------S------------------------------------------------------------
------------------------------------------------------------------------------------------------------------------------------------------------------
------------------------------------------------------------------------------------------------------------------------------------------------------
-----------------------------------------------------------------------------------------%--------------------------------%-----------------%---------
-----------------------------------------------------------------------------------------|--------------------------------|-----------------|---------
-----------------------------------------------------------------------------------------|%------%------------------------|-----------------|---------
-----------------------------------------------------------%---------------------------%-||------|------------------------%-----------------|---------
-----------------------------------------------------------|-----------------g---------|-||------|---%--------------------|-----------------|---2---%-
-------------%%----%------%------------%-------------------|%---------------%----------|-||------|---|-%-%-------%%-%-----|%--------------%-|-------|-
-------------||----|------|-----------%|%-%-------S-----%--||-%%%-----------|----------|-||------|-%-|-|%|-------||-|-----||--%-----------|-S%%----%|-
%%%%%%%%%-%--||----|-%%---|-----------|||-|----%%%------|--||-|||-----------|----------|-||--%%-%|-|-|%|||-------||-|-%---||--|--%-%----%-|%-||%---||%
|||||||||-|XX||XXXX|X||XXX|XXXXXXXXXXX|||X|X---|||XXX-XX|-X||X|||XXXXXXXXXXX|X--XXXXXXX|X||XX||X||X|X|||||XXXXXXX||-|-|XXX||XX|XX|X|X-XX|-||-|||XXX|||