------------------------------------------------------------------------------------------------------------------------------------------------------
------------------------------------------------------------------------------------------------------------------------------------------------------
------------------------------------------------------------------------------------------------------------------------------------------------------
------------------------------------------------------------------------------------------------------------------------------------------------------
------------------------------------------------------------------------------------------------------------------------------------------------------
------------------------------------------------------------------------------------------------------------------------------------------------------
------------------------------------------------------------------------------------------------------------------------------------------------------
------------------------------------------------------------------------------------------------------------------------------------------------------
------------------------------------------------------------------------------------------------------------------------------------------------------
----------------------------------------------------------------------------------------------------%------%---------------------------------------%--
----------------------------------------------------------------------------------------------------|-----r|---------------%-----------------------|--
----------------------------------------------------------S-----------------------------------------|-----%|-%-------------|-----------------------|--
----------%-----%---%---%---%%-----------------------%-%-------#%----------%--------------------%---|----%||%|%--------%---|----------------%----%%|--
---------%|-----|---|---|---||-------%------------%--|-|%%-----#|-%--------|----%-----%%%%%-----|-%-|----||||||%%---%--|%%%|--------------%-|-%--|||--
%%%%%%%%-||-----|---|--%|---||-------|---%--------|--|-|||----%%|%|--------|--%-|%%-%-|||||-----|-|-|--%-||||||||--%|%%|||||---------%--%%|-|-|--|||--
||||||||X||X-XXX|X-X|XX||XXX||XXXX---|XXX|XXXXXXX-|XX|XX||X-XX|||||XXXXX---|--|-|||X|X|||||X---X|X|-|XX|X||||X|||-X|||||||||XXX--XXXX|X-||XXXX|-X|X|X-