------------------------------------------------------------------------------------------------------------------------------------------------------
------------------------------------------------------------------------------------------------------------------------------------------------------
------------------------------------------------------------------------------------------------------------------------------------------------------
------------------------------------------------------------------------------------------------------------------------------------------------------
------------------------------------------------------------------------------------------------------------------------------------------------------
--------------------------------%%--------------------------------------------------------------------------------------------------------------------
--------------------------------||--------------------------------------------------------------------------------------------------------------------
--------------------------------||-------------------------------------------------------------------------------------------------D------------------
--------------------------------||--------------------------------------------------------------------------------------------------------------------
----------------------------%---||---------------------------------------------S----------------------------------------------------------------------
----------------------------|---||--------------------------------------------------------------------------------------------------------------------
----------------------------|---|%---------------------------------------------------------------------------------------------%----------------------
-------------%-------------%|---||---------------------------%-%%%-------%-----------------------------------------%%----------|----------------------
-------------|%--------%---||---||-----%--%--%-------%-------|-|||%------|--%%---%%------%-%%--%--------%%-r-------||----------|---%------------------
%%%%%%%%---%%||--%%--%-|---||---||-----|-%|-%|-------|-------|-||||------|--||--%||-%-%--|-||--|-----%--||%%--%%---||%------%%-|---|------------%%----
||||||||XXX||||-X||XX|-|XXX||X-X||XXXXX|-||X|X-XXX-X-|XXXXXXX|X||||X----X|--||--|||X|X|XX|X||-X|XXXXX|XX||||XX||XXX|||XXX-XX||-|XXX|XXX----XXXXX||XXXX