------------------------------------------------------------------------------------------------------------------------------------------------------
------------------------------------------------------------------------------------------------------------------------------------------------------
------------------------------------------------------------------------------------------------------------------------------------------------------
------------------------------------------------------------------------------------------------------------------------------------------------------
------------------------------------------------------------------------------------------------------------------------------------------------------
------------------------------------------------------------------------------------------------------------------------------------------------------
------------------------------------------------------------------------------------------------------------------------------------------------------
------------------------------------------------------------------------------------------------------------------------------------------------------
--------------------------------------------------------------------------------------------%-----%---------------------------------------------------
--------------------------------------------------------------------------------------------|-%---|---------------------------------------------------
--------------------------------------------------------------------------------------------|-|---|---------------------------------------------------
---------------------------------------------------------------------------%-----%----------|-|---S---------------------------------------------------
------------------------------------------%-%------%---------%-%%%---%-----|--%--|--------%-|-|-----%%---%-----------------------%-----%%--------%----
-----------------------%---------------%--|-|----%-|---------|-|||---|-----|--|--|-%-----%|-|-|-----||---|----%%%----------------|-----||-------%|----
%%%%%%%%%---%----------|-%-------------|--|-|----|%|-%-------|-|||---|-----|--|--|-|-----||-|-|%%-%-||---|-%%%|||%%--------%%%---|---%%||-----%%||%%-%
|||||||||X--|XXX--XXXXX|X|-XXXXX-XX-XXX|XX|X|-X-X|||-|XXXXXXX|X|||XXX|-XXXX|XX|XX|X|XXXXX||X|-|||X|X||--X|-||||||||XXXXXXXX|||-XX|---||||XX---||X|||X|