------------------------------------------------------------------------------------------------------------------------------------------------------
------------------------------------------------------------------------------------------------------------------------------------------------------
------------------------------------------------------------------------------------------------------------------------------------------------------
------------------------------------------------------------------------------------------------------------------------------------------------------
------------------------------------------------------------------------------------------------------------------------------------------------------
------------------------------------------------------------------------------------------------------------------------------------------------------
------------------%-----------------------------------------------------------------------------------------------------------------------------------
------------------|-----------------------------------------------------------------------------------------------------------------------------------
------------------|-----------------------------------------------------------------------------------------------------------------------------------
------------------|-------------------------------------------------------------------------------------------------------%--------------------------%
---------%--------|--%----------------------------------------------------------------%-----------------------------------|--------------------------|
---------|--G-----|--|----------------------------------------------------------------|-------------------%-%-------------|--------------------------|
---------|--%--%%%|--|--------%--%--------------------------%---------%-----------%---|-%%%------%-%--%%%-|-|--%%%%%%-----|-%--%-------%-------------|
---------|--%--||||%%|--------|%-|--------------------------|-----%--%|-----------|---|-|||------|-|--|||-|-|--||||||---%%|-|--|-------|------%-----%|
%%%%%%%%-|--|--|||||||%-----%-||-|%---------------%%--------|---%-|--||----------%|%--|-|||-%--%-|%|--|||-|-|--||||||---|||-|--|%------|-----%|-----||
||||||||-|XX|--||||||||XXXXX|X||X||XXXXXXXXXXXX---||-XXXXXXX|XXX|X|XX||XXXXXXXXXX|||XX|X|||X|--|X|||-X|||X|X|-X||||||XXX|||X|X-||XX-X-X|XXXXX||XXXXX||