------------------------------------------------------------------------------------------------------------------------------------------------------
------------------------------------------------------------------------------------------------------------------------------------------------------
------------------------------------------------------------------------------------------------------------------------------------------------------
------------------------------------------------------------------------------------------------------------------------------------------------------
------------------------------------------------------------------------------------------------------------------------------------------------------
------------------------------------------------------------------------------------------------------------------------------------------------------
------------------------------------------------------------------------------------------------------------------------------------------------------
------------------------------------------------------------------------------------------------------------------------------------------g-----------
----------------------------------------------------------------------------------------------------------S-------------------------------|-----------
----------------------------------%---------------------------------g---------------------------------------------------------------------|-----------
----------------------------------|-------------------------------------------------------------------------------------------------------|-----------
----------------------------------|----------%-%--------------------------------------------%---------------------------------------------%---%---%---
------------------------------%-%-|----------|-|-------------%---%---%---%---%--%---%-------|-------%%----%------%----%--%-------------%--|%-%|--%|---
--------%-----%---%%%%%-------|-|-|----%-----|-|-----%-------|---|-%%|---|---|--|---|-------|-------||----|---%--|----|--|%%%--%-------|-%||-||--||---
%%%%%%%%|%%---|--%|||||-------|-|-|----|%%--%|%|--%%-|-------|--%|%|||---|---|--|---|%-----%|---%%--||---%|---|--|----|--||||--|----%--|-|||-||-%||---
|||||||||||X-X|XX||||||X-XX-XX|X|-X--X-|||XX||||--||X|XX-X-XX|XX||||||--X|-XXX--|XXX||XXX-X||XXX||X-||XXX||XX-|XX|--XX|XX||||XX|--XX|XX|X|||-||X|||X-X