------------------------------------------------------------------------------------------------------------------------------------------------------
------------------------------------------------------------------------------------------------------------------------------------------------------
------------------------------------------------------------------------------------------------------------------------------------------------------
------------------------------------------------------------------------------------------------------------------------------------------------------
------------------------------------------------------------------------------------------------------------------------------------------------------
------------------------------------------------------------------------------------------------------------------------------------------------------
------------------------------------------------------------------------------------------------------------------------------------------------------
------------------------------------------------------------------------------------------------------------------------------------------------------
----------------------------------------------------%-------------------------------------------------------------------------------------------------
----------------------------------------------------|-------------------------------------------------------------------------------------------------
------------2---------------------%-----------------|---%---------------------------------------------------------------------------------------------
----------------S-----------------|-----------%-----|---|-----------------------------------------------------------------%---t-----------------------
---------------------%-%%---%-%--%|------%----|-----|---|----%--------------------%---%----------------------------------%%---t-----------------------
----------%-----%----|%||%%%|-|--||-%----|%%-g|---%%|%%%|----|------------%-%-----|---|----------%--%%-------------------||---t-%---------------------
%%%%%%%%%-|-%--%|---%||||||||-|--||-|----|||--|%%%|||||||----|---%--------|-|-----|--%|-%%%%--%%-|--||%-------%%---%%----||%--%-|---------%--%--------
|||||||||-|X|-X|XXXX|||||||||-|XX||XXXXXX|||XX|||||||||||XXXX|XXX|XXXXFXXXX-|XXXXX|XX||-||||XX||XXXX|||-XXXXXX||XXX||XXXX|||XX|X|X----XXX-|--|X--XXXXX