------------------------------------------------------------------------------------------------------------------------------------------------------
------------------------------------------------------------------------------------------------------------------------------------------------------
------------------------------------------------------------------------------------------------------------------------------------------------------
------------------------------------------------------------------------------------------------------------------------------------------------------
------------------------------------------------------------------------------------------------------------------------------------------------------
---------------------------------------------------------------------------------------------------S--------------------------------------------------
------------------------------------------------------------------------------------------------------------------------------------------------------
------------------------------------------------------------------------------------------------------------------------------------------------------
------------------------------------------------------------------------------------------------------------------------------------------------------
-----------------------------------------------------------------------------------------t-----------------------------%------------------%-----------
---------------------------------------------------------------------%---g---------------t-----------------------------|---------------%--|-----------
---------------------------------------------------------------------|-----------------g-t-----------------------------|---------------|--|-----------
------------------------%------------------%------%--%-%-------------|-%%------------%-|-%%%-------%----------------%--|%%-%%----------|--|-----------
-------------------%----|-%---------%%-----|-%----|--|-|----%--------|-||------%-----|-|-|||-------|---%---%%%%%----|--|||-||----------|--|%--%%-%-%--
%%%%%%%%%--%%%%----|----|-|-%%------||-----|-|----|%-|-|----|--------|-||%-----|---%-|-|-|||%------|---|---|||||----|--|||-||-%----%---|--||-%||-|-|--
|||||||||--||||XXXX|X-XX|X|X||XXXXXXX|XXXXX|X|XXX-||X|X|X--X|-XXX-XXX|X|||XXXXX|XXX|X|XXX||||XXX-XX|XXX|X-X|||||XXX-|--|||X||X|XX-X|XXX|XX|XX|||-|X|XX