------------------------------------------------------------------------------------------------------------------------------------------------------
------------------------------------------------------------------------------------------------------------------------------------------------------
------------------------------------------------------------------------------------------------------------------------------------------------------
------------------------------------------------------------------------------------------------------------------------------------------------------
------------------------------------------------------------------------------------------------------------------------------------------------------
------------------------------------------------------------------------------------------------------------------------------------------------------
------------------------------------------------------------------------------------------------------------------------------------------------------
------------------------------------D-----------------------------------------------------------------------------------------------------------------
------------------------------------------------------------------------------------------------------------------------------------------------------
------------------------------------------------------------------------------------------------------------------------------------------------------
------------------------------------------------------------------------------------------------------------------------------------------------------
------------------------------------%-------------------------------------------------------%--------g---------------------------%%-------------------
----------------%-----%----%--%-----|--%----%----2---%---------------%---------------%%--%--|--------------%-------%------------%||------------%------
---------%------|-----|----|--|--%--|--|----|-----%--|-----%%---%----|%%------------%||--|--|-------%------|-------|------------|||------------|------
%%%%%%%%-|----%-|-%%-%|----|--|--|--|--|----|-----|--|-----||---|----|||-----%----%-|||--|--|-------|-----%|-----%-|------------|||---%---%---%|------
||||||||X|XXXX|X|-||X||XXXX|--|XX|XX|XX|XX-X|XXXXX|XX|XXXXX||XXX|XXXX|||XXXXX|XXXX|X|X|XX|XX|XXXXX-X|XXXXX||XXX-X|X|XX-X-X-XXXX-|X|XXX|XXX|---|XX--XXX