------------------------------------------------------------------------------------------------------------------------------------------------------
------------------------------------------------------------------------------------------------------------------------------------------------------
-----------------------------------------------------#------------------------------------------------------------------------------------------------
-----------------------------------------------------#------------------------------------------------------------------------------------------------
-----------------------------------------------------#------------------------------------------------------------------------------------------------
-----------------------------------------------------#%-----------------------------------------------------------------------------------------------
-----------------------------------------------------%|-----------------------------------------------------------------------------------------------
-----------------------------------------------------||-----------------------------------------------------------------------------------------------
-----------------------------------------------------||-----------------------------------------------------------------------------------------------
-----------------------------------------------------||------------------------------------------------%----------------------------------------------
-----------------------------------------------------||----------------------------%-------------------|-------%--------------------------------------
----------------------%------------------------------||-------------%-----------%--|--%----------------|---%---|--------------------------------------
--------------%-%-----|-------------------%----------||-------------|----------%|--|--|--------------%%|%--|---|------------------%------%----K-------
--------------|%|---%-|---%%-%-%----------|----%-%%-%|D---------%---|--------%-||--|--|-%--%------%--||||--|---|----%-%-----------|----%-|---%%-------
%%%%%%%%----%-|||%--|-|%%-||-|%|-%%-------|----|-||-||----------|---|--%-%%%-|-||--|-%|-|--|------|--||||--|%--|--%-|-|-------%%--|--%-|-|--%||-%-----
||||||||X-XX|X||||XX|XX||X||XX||X||XXX-XXX|---X|X||X||-XX-X-X--X|XXX|-X|X|||X|X||XX|X|XXXXX|XXXXXX|XX||||X-||XX|X-|X|X|XXXXXXX||XX|XX|X|X|X-|||X|XXXXX