------------------------------------------------------------------------------------------------------------------------------------------------------
------------------------------------------------------------------------------------------------------------------------------------------------------
------------------------------------------------------------------------------------------------------------------------------------------------------
------------------------------------------------------------------------------------------------------------------------------------------------------
--------------------------------------------------------------------------------------------------S---------------------------------------------------
------------------------------------------------------------------------------------------------------------------------------------------------------
------------------------------------------------------------------------------------------------------------------------------------------------------
--------------------------------------------------------------------------------------------------%--------------------------%------------------------
--------------------------------------------------------------------------------------------------|--------------------------|------------------------
---------------------------%%---------------------------------------------------------------------|--------------------------|------------------------
---------------------------||-----------------------------------%---------------------------------|--------------------------|-------------S----------
---------------%---%-------||--------%%-------------------------|---------------%-----------------|-----------------%--------|-%----------------------
----------%--%-|---|-------||-%------||---------%---------------|%--2%---%---%--|-----%%---%-----%|--------%----%%--|----%---|-|-%--%-----------%%----
----------|--|-|---|------%||-|%-----||-------%-|---------------||---|-%%|%--|%-|-----||---|----%||--------|----||--|----|%%%|%|%|--|---------%%||----
%%%%%%%%--|--|-|%%%|------|||-||-%%-%||--%---%|-|----%---------%||-%-|-||||--||-|----%||---|----|||---%-%--|%%--||-%|----||||||||%%-|----%-%%-||||-%--
||||||||-XXXX|-||||XXXX---|||X||X||X|||XX|XX-||X|XXXX|XXXXX-XXX|||X|X|X||||XX||X|XX-X|||XX-|X-XX|||XXX|-|-X|||XX||X|X--XX||||||||||-|XXXX|X||X||||-|--