------------------------------------------------------------------------------------------------------------------------------------------------------
------------------------------------------------------------------------------------------------------------------------------------------------------
------------------------------------------------------------------------------------------------------------------------------------------------------
------------------------------------------------------------------------------------------------------------------------------------------------------
------------------------------------------------------------------------------------------------------------------------------------------------------
------------------------------------------------------------------------------------------------------------------------------------------------------
-------------------------%------------------------------------g---------------------------------------------------------------------------------------
-------------------------|------------------------------------S--D------------------------------------------------------------------------------------
-------------------------|----------------------------------------------------------------------------------------------------------------------------
-------------------------|----------------------------------------------------------------------------------------------------------------------------
-------------------------|-------------------%------------------------------------------%-------------------------------------------------------------
-------------------------|-------------------|%-----------------------------%-----------|---------------------%--------------%------------------------
--------%--%%%%-%%%%%----|--%-%%%------------||-----------------------------|%%-----%---|-------------%-------|--------------|------------------------
--------|--||||-|||||--%-|%%|%|||------%----%||--%----%-------%-------------|||----%|-%-|----%--------|-----%-|------%-----%%|---%%%%----%----%----%-%
%%%%%%%%|%-||||%|||||--|-||||||||----%-|----||%--|----|-------|-------------%||-%--||-|%|%---|---%%%--|%%---|-|-----%|-----|||---||||---%|%---|----|-|
||||||||||X||||||||||XX|X||||||||-XXX|-|-X-X|||--|XXXX|XX-X--X|-X-X-XXXXXXXX|||X|XX||-||||XXX|X-X|||XX|||-XX|XXXXX--||XX--X|||XXX||||X-X|||XXX|XXXX|-|