------------------------------------------------------------------------------------------------------------------------------------------------------
------------------------------------------------------------------------------------------------------------------------------------------------------
------------------------------------------------------------------------------------------------------------------------------------------------------
------------------------------------------------------------------------------------------------------------------------------------------------------
------------------------------------------------------------------------------------------------------------------------------------------------------
--------------------------------------------------------------------------------------------------------------------------------------D---------------
------------------------------------------------------------------------------------------------------------------------------------------------------
----------------------------------S-------------------------------------------------------------------------------------------------------------------
------------------------------------------------------------------------------------------------------------------------------------------------------
------------------%------------------------------------------------------------------------------------------------%----------------------------------
------------------|------------------------------------------------------------------------------------------------|-----------------------------%----
------------------|--%------------%-------------------------------------------------------%----%-------------------|-%-------%-%---%--%%--K------|----
-------------%----|--|------------|------------------------------%------------%-----------|----|%--------------%---|-|-------|-|---|-%||--%%-----|-%--
-------------|----|--|------%-----|%-----%--------%--------------|%-%%----%---|%----------|----||-------%----%%|---|-|-------|-|---|-|||--||-----|-|--
%%%%%%%%-%---|----|--|------|-----||-----|----%---|--------------||%||---%|---||-%--------|----||--%-%--|--%%|||---|%|----%-%|-|---|-|||--||-----|-|--
||||||||X|-XX|-XXX|X-XX--XX-|-XXXX|XXX---|--XX|XXX|XXXXXXXXX-XXXX|||||XXX||-XX||X|XXXXXXXXXXXX-||XX|X|XX|XX|||||-XX|||XX-X|X||XXXXX|-||XXX||XXXXX|-|X-