------------------------------------------------------------------------------------------------------------------------------------------------------
------------------------------------------------------------------------------------------------------------------------------------------------------
------------------------------------------------------------------------------------------------------------------------------------------------------
------------------------------------------------------------------------------------------------------------------------------------------------------
------------------------------------------------------------------------------------------------------------------------------------------------------
------------------------------------------------------------------------------------------------------------------------------------------------------
------------------------------------------------------------------------------------------------------------------------------------------------------
------------------------------------------------------------------------------------------------------------------------------------------------------
--------------------------------------------------------------------------------------------------------------------------%--------------C------------
--------------------------------------------------------------------------------------------------------------------------|---------------------------
--------------------------------------------------------------------------------------------------------------------------|-%-------------------------
--------------------------%%-------------%---------------%--------F--------t--------------------------------------------%-|-|-------------------------
--------%--%----%%--------||---------%-%-|-------%-------|--------%-------%t------%-------%%----%----------g---%%%------|-|-|------------%------------
--------|--|----||--------||---------|%|-|-------|-------|--------|-------|t---%--|----%--||----|-------%------|||------|-|-|----------%-|------------
%%%%%%%%|%-|--%%||--%%----||-----%%--|||-%----%%-|-%%-%-%|--------|---%--%|%---|%%|----|--||----|%------|------|||------|-|%|--%%--%---|-|%-----------
||||||||||X|XX||||-X||XXXX||XXXXX||--|||-|XXX-||-|-||-|X||XXXXXXXXXX--|-X|X|-XX||||XXXX|XX||XXXXX|XXXXX-|---XXX|||XXX--X|X|||--||X-|XXX|-||XXXX-XX-XXX