------------------------------------------------------------------------------------------------------------------------------------------------------
------------------------------------------------------------------------------------------------------------------------------------------------------
------------------------------------------------------------------------------------------------------------------------------------------------------
------------------------------------------------------------------------------------------------------------------------------------------------------
------------------------------------------------------------------------------------------------------------------------------------------------------
------------------------------------------------------------------------------------------------------------------------------------------------------
------------------------------------------------------------------------------------------------------------------------------------------------------
-------------------------------------------------------------------------------------------------------------------%--------%-------------------------
-------------------------------------------------------------------------------------------------------------------|--------|-------------------g-----
------------------------------------%------------%-----------------------------------------------------------------|--------|-------------------%-----
------------------------------------|------------|-----------------------------------------------%-----------------|--------|-------------------|-----
-----------------%------------------|------------|-----------------------------------------------|-%---------------|-----%--|-------------------|-----
-----------------|------------------|--%--%%-----|-------%----%-----------------------%----------|-|%%---k%%-------|-----|--|-------------------|-----
--------------%--|-%---%%--%-%------%--|--||-----|-------|----|-----------------------|-%--------|-|||---%||--%----|-----|--|--------------%-%%-|%----
%%%%%%%%%-%%%%|--|-|--%||--|%|------|-%|--||--%%%|---%%%-|----|----------%------------|-|--------|-|||---|||%-|%%--|--%--|--|%--------%-%--|-||%||---%
|||||||||X|||||--|X|-X|||XX|||XXXXXX|X||XX||XX|||X-XX|||XXXXXX|XXXXXX----|XX-XXX-XXX--|X|X--X----|X|||---||||X|||-X|XX|XX|-X||XXXX---X|-|XX|-|||||XXX|