------------------------------------------------------------------------------------------------------------------------------------------------------
------------------------------------------------------------------------------------------------------------------------------------------------------
------------------------------------------------------------------------------------------------------------------------------------------------------
------------------------------------------------------------------------------------------------------------------------------------------------------
------------------------------------------------------------------------------------------------------------------------------------------------------
------------------------------------------------------------------------------------------------------------------------------------------------------
-----------------------------------------------------------------------------------%------------------------------------------------------------------
-----------------------------------------------------------------------------------|------------------------------------------------------------------
-----------------------------------------------------------------------------------|----------------%-----%-------------------------------------------
-----------------------------------------------------------------------------------|----------------|-----|-------------------%-----------------------
-----------------------------------------------------------------------------------|-----%-%--------k-----|-------------------|-----------------------
----------%-----------------------------------------------------%------------------|-----|-|-----%--|%%%--|-------------------|-----------------------
----------|--------%-----------%%-------%-----%---%-----%-------|%----%-%%---%-----|-----|-|--%--|--||||--|%-------%-----%----|%%%%--%%%-%----%-%-%---
----------%-------%|----%-----%||--%----|--%--|---|-----|------%||----|-||%--|%----|---%-|-|--|--|--||||--||-------|%----|----|||||-%|||-|----|-|-|---
%%%%%%%%--|-------||----|-----|||--|----|%%|--|-%-|%----|------|||----|-|||--||%---|---|-|-|--|%%|--||||--%|-------||----|----|||||-||||-|----|-|-|--%
||||||||XX|XXXXX-X||XXX-|XXXXXXX|-X|XXXX||||XX|-|X||XXX-|XXXXXX|||--XX|X|||-X|||X-X|XXX|-|X|-X||||-X||||XX||XXXX-X-||---X|XXXX|||||X||||X|X-XX|-|X|XX|