------------------------------------------------------------------------------------------------------------------------------------------------------
------------------------------------------------------------------------------------------------------------------------------------------------------
------------------------------------------------------------------------------------------------------------------------------------------------------
------------------------------------------------------------------------------------------------------------------------------------------------------
------------------------------------------------------------------------------------------------------------------------------------------------------
---------------------------------------------#--------------------------------------------------------------------------------------------------------
---------------------------------------------%--------------------------------------------------------------------------------------------------------
---------------------------------------------|----------------%------------------------------------%--------------------------------------------------
---------------------------------------------|----------------|------------------------------------|--------------------------------------------------
---------------------------------------------|----------------|------------------------------------|--------------------------------------------------
---------------------------------------------S----------------|------------------------------%-----|-------------%------------------------------------
-----------------------------#--------------------------------|-------------------%-------%%%|--%--|%--g-%-------|----------------S-%-----------------
--------------%--------%%---%%-%%------%--%%------------------|----%%---%---------|--%----||||-%|-%||----|-------|------------------|-%%%-----------%-
--------------|--------||---||-||------|-%||-%--%%%%----%%%%%-|%%%-||---|%--------|--|----||||-||-|||---%|%------|---%--------------|-|||-----------|%
%%%%%%%%-%--%%|--------||---||-||------|-|||-|--||||---%|||||-||||-||---||--%--%%-|--|--%-||||-||-|||---|||-%%%--|---|-%%--%-----%--|%|||-----------||
||||||||-|X-|||XXXXX-XX||XXX||X||X-XXXX|X|||-|X-||||---||||||X||||X||XXX||--|XX||X|XX|X-|X||||-||X||XXXX|X|X|||XX|XXX|-||XX|-XXXX|XXX||||XX--X-XX-XX||