------------------------------------------------------------------------------------------------------------------------------------------------------
------------------------------------------------------------------------------------------------------------------------------------------------------
------------------------------------------------------------------------------------------------------------------------------------------------------
------------------------------------------------------------------------------------------------------------------------------------------------------
------------------------------------------------------------------------------------------------------------------------------------------------------
------------------------------------------------------------------------------------------------------------------------------------------------------
------------------------------------------------------------------------------------------------------------------------------------------------------
------------------------------------------------------------------------------------------------------------------------------------------------------
------------------------------------------------------------------------------------------------------------------------------------------------------
----------------------------------------------------------------------------------------------------------------%-------------------------------------
----------%---------------------------------------------------------------------------------%-------------------|-------------------------------------
----------|---------------------------------------------------------------------------------|--------S-U--------|------------------%-----%------------
----------|----------------------%%%%-%--------%%-----------------%----%----%%%-----------%%|------------%%-----|---------%-%------|--%--|%-----------
--------%-|------%------%--------||||-|--%---%-||-----------%-----|%--#|----|||-%%------%-|||--%---------||%%--%|---------|-|------|--|--||----%------
%%%%%%%%|-|----X-|------|--------||||-|--|---|-||%%%--------|-----||%-%|----|||-||---%--|-|||--|---%-----||||%%||%-----%--|-|-%----|-%|--||----|------
|||||||||X|XXXXXX|X---XX|XX-X--XX||||X|XX|XXXX-|||||XXX-XXXX|XXXXXX||X||XXX-|||X||XXX|XX|X|||XX|XXX|XXXXX|||||||||X-XXX|-X|X|X|XXXX|X||XX||-XXX|XXXXXX