------------------------------------------------------------------------------------------------------------------------------------------------------
------------------------------------------------------------------------------------------------------------------------------------------------------
------------------------------------------------------------------------------------------------------------------------------------------------------
------------------------------------------------------------------------------------------------------------------------------------------------------
------------------------------------------------------------------------------------------------------------------------------------------------------
------------------------------------------------------------------------------------------------------------------------------------------------------
------------------------------------------------------------------------------------------------------------------------------------------------------
-----------------------------------------------------%-----------------------------------------------------------------------------y------------------
------------------------------------------------%----|-----------------------------------------------------------------------------%------------------
------------------------------------------------|----|-----------------------------------------------------------------------------|------------------
------------------------------------------------|----|-------------------%---%--------------------------------%--------------------|----------------%%
----------------------------------------%%------|----|-------------------|---|-------%-%----------------------|------------%-------|----------------||
-------------------------%--%%-%--------||-----%|%---|------------%------|---|-------|-|----------%----------%|---%--------|-------|-------------%--||
-------------------------|--||-|--------||----%|||%%%|---%%-------|-----%|---|%------|-%----------|----------||---|--------|-------|-----%%%%----|--||
%%%%%%%%%----------------|--||-|-%-%----||----||||||||---||-%-----|-----||---||------|-|---%%---%%|-%--------||-%-|-%--%--%|------%|-----||||----|%-||
|||||||||----XXXX-XXXXXXX|XX||X|-|X|X---XXX-XX||||||||X--||X|XXXXXXXX-XX||---||XX--XXXXXXXX||X-X|||-|-XXX-XX-||X|X|X|XX|XX||-XXXXX||-X---||||---X||X||