------------------------------------------------------------------------------------------------------------------------------------------------------
------------------------------------------------------------------------------------------------------------------------------------------------------
------------------------------------------------------------------------------------------------------------------------------------------------------
------------------------------------------------------------------------------------------------------------------------------------------------------
------------------------------------------------------------------------------------------------------------------------------------------------------
---------------------------------------------------------------------------------------%--------------------------------------------------------------
-------------------------S-------------------------------------------------------------|--------------------------------------------------------------
---------------------------------------%-----------------------------------------------|---------------------------------------------------%----------
----------%----------------------------|-----------------------------------------------|---------------------------------------------------|----------
----------|--------------%-------------|-----------------------------------------------|---------------------------------------------------|----------
----------|--------------|-------------|------%----------------------------------------|-------------G-------------------------------------|----------
----------|--------------|-------------|-%----|--------------------------g--------%----|-------------%-------------------------------------|----------
----------|-%------------|---%-%%------|-|----|%-------------%-------%--------%---|%---|--------%%%--|-%%--------%---------------------S---|-------%--
----------|-|------------|%-%|-||%----%|%|--%-||-%-%---------|-------|--%-%---|---||---|--%%%---|||%-|-||-------%|-------%----%-----%------%%--%%-%|--
%%%%%%%%-%|%|--%-%--%----||%||-|||----||||--|-||-|-|-------%-|%------|%-|-|-%%|---||-%%|%%|||---||||-|-||-------|%-------|-%%-|-----|------||--||-||--
||||||||-||||XX|X|-X|-XXXX||||X||XXXX-||||XX|X||-|X|XX--XXX|X||XXX-XX||X|X|X|||-XX||X||||||||XXX|||XXXX||XX--XXX||XXXXXXX|X||X|XXXXX|XXXXXX||XX||X||-X