------------------------------------------------------------------------------------------------------------------------------------------------------
------------------------------------------------------------------------------------------------------------------------------------------------------
------------------------------------------------------------------------------------------------------------------------------------------------------
------------------------------------------------------------------------------------------------------------------------------------------------------
------------------------------------------------------------------------------------------------------------------------------------------------------
-------------------U----------------------------------------------------------------------------------------------------------------------------------
------------------------------------------------------------------------------------------------------------------------------------------------------
------------------------------------------------------------------------------------------------------------------------------------------------------
------------------------------------------------------------------------------------------------------------------------------------------------------
-------------------%--------------------------%-------------------------------------------------------------------------------------------------------
----------S--------|-------------%-----%------|-----------------------------------------t-------------------------------------------------------------
-------------------|-------------|-----|------|-----r--------------%--------------------t--------------------------------------------------------%----
-------------------|---------%---|-----|-----%|-%--------------%---|------%-------------t-----%%--%%%------------%-----------%--%---------%------|----
----------------%--|%-----%--|---|%%---|-----||-|--------------|---|%%-%--|-------------%-----||-%|||------------|---%-----%-|--|%---%----|-----%|----
%%%%%%%%--%-----|--||-----|--|---|||---|-----||-|%---%----%----|---|||%|%%|%%%--%%%-----|-----||%||||----%%------|---|%----|%|%-||%--|----|--%--||--%%
||||||||XX|----X|XX||-XX-X|XX|XXX|||--X|X-XXX||X||---|-XXX|XXXX|-XX|||||||||||XX|||XXXXX|XXXXX|||||||XXX-||XXXXXX|-XX||XXXX||||X|||-X|X--X|XX|XX|XXX||