------------------------------------------------------------------------------------------------------------------------------------------------------
------------------------------------------------------------------------------------------------------------------------------------------------------
------------------------------------------------------------------------------------------------------------------------------------------------------
------------------------------------------------------------------------------------------------------------------------------------------------------
------------------------------------------------------------------------------------------------------------------------------------------------------
------------------------------------------------------------------------------------------------------------------------------------------------------
------------------------------------------------------------------------------------------------------------------------------------------------------
------------------------------------------------------------------------------------------------------------------------------------------------------
-------------------g--------------------------------------------------------------%-------------------------------------------------------------------
--------------------------------------------------------t-------------------------|-----------------------------------------------------------%-------
--------------------------------%-%---------------------t-------------------------|-----------------------------------------------------------|-------
-----------------------%----S---|-|---------------------t-------%-----------------|-----------------------------------------------------------|-------
--------%--------------|--------|-|-------%----%-----%-%%-------|-----------------%----%%%%--%------%----------------%-----------------%------|-------
--------|-----g--------|%--%----|%|%------|----|-----|-||-----%-|-------%---------|--%-||||--|------|----------%-----|---------%%%-----|%-----|-------
%%%%%%%%|-----%------%-||-%|----||||------|----|-----|-||-----|-|-------|---------|--|-||||-%|-----%|----------|-----|---------|||---%%||-----|------%
|||||||||-XXXX|XXX---|-||X||XXXX||||XXXX--|X---|XXXX-|X||XXXX-|XXXXXXXXX|XX--XX-XX|X-|X||||-||XXXXX||XXXXXXXXXX|-X--X|XX-XXXXXX|||XXX||||X--XX|XXXXXX|