------------------------------------------------------------------------------------------------------------------------------------------------------
------------------------------------------------------------------------------------------------------------------------------------------------------
------------------------------------------------------------------------------------------------------------------------------------------------------
------------------------------------------------------------------------------------------------------------------------------------------------------
---------------------------------------------------------------------------------------------------------------------------------%--------------------
---------------------------------------------------------------------------------------------------------------------------------|--------------------
---------------------------------------------------------------------------------------------------------------------------------|--------------------
-----------------------------------------S---------------------------------------------------------------------------------------|--------------------
---------------%-----------------------------------------------------------------------------------------------------------------|--------------------
---------------|---------------------t-------------------------------------------------------------------------------------------D--------------------
---------------|----------%----------t--------------------%----------------------------%--------------------------------------------------------------
---------------|-%--------|----%-----t--------------------|--%-------------------------|----------%------------%-----------------------------%--------
---------------%-|--------|----|-----%-%---%---%----------|--|----------------%%%------|----------|--%---%-----|--%%----------%--------------|-%------
-----------%---|-|--------|%---|%----|-|%%-|-%%|--%--%-%--|--|--------%%-%-%--|||------|----------|-%|--%|-----|--||-------%--|-%--%-------%-|-|---%%-
%%%%%%%%---|---|-|----%---||-%%||--%-|%|||-|-|||--|--|-|--|%-|--------||-|-|--|||-%%%--|----------|-||--||-----|--||----%--|%-|-|--|-------|-|%|---||-
||||||||XX-|XXX|X|XXXX|XX-|X-||||--|X|||||X|X|||XX|XX|X|X-||X|--XXXXXX||X|-|XX|||X|||XX|X------X--|X||XX||XXXXX|XX||X-XX|XX||X|X|XX|-XX-XXX|X|||XXX||X