------------------------------------------------------------------------------------------------------------------------------------------------------
------------------------------------------------------------------------------------------------------------------------------------------------------
------------------------------------------------------------------------------------------------------------------------------------------------------
------------------------------------------------------------------------------------------------------------------------------------------------------
------------------------------------------------------------------------------------------------------------------------------------------------------
-----------------------------------------------------------------------------------------------------------------------%------------------------------
---------------------------------------------------t-------------------------------------------------------------------|------------------------------
---------------------------------------------------t-------------------------------------------------------------------|------------------------------
---------------------------------------------------t------------------------------------------------------%------------|------------------------------
-----------------S---------------------------------%--------S---------------------------------------------|------------|---------%--------------------
-------------------------------S-------------------|------------------------------------------------%-----|------------|---------|--------------------
----------------%----------------------------------|---%--------------------------------------------|-----|------------|---------|--------------------
--------------%-|---%%---------------------%-%-%%-%|---|----------------%--------%%-%%------------%%|-----%------%-----|---------|%-%--------K--------
--------------|-|%-%||%----%--------%------|-|-||-||---|---#%-----------|--------||-||----%%------|||-----|------|--%--|--------%||-|--%-----%%%-%--%-
%%%%%%%%%%----|-||-||||----|---%----|------|-|-||-||---|--%%|%-%%%--%%--|--------||-||----||-%----|||----%|---%--|-%|--|--------|||-|--|%----|||%|--|-
||||||||||-X-X|XX|X||||XXXX|XXX|XXXX|XXXXXX|X|-||X||-XXX--||||X|||-X||-X|XXXXXXX-|XX||XXXX||X|---X|||XXXX||XXX|XX|X||XX|-XXXXXXX|||X|XX||XXXXX||||XX|X