------------------------------------------------------------------------------------------------------------------------------------------------------
------------------------------------------------------------------------------------------------------------------------------------------------------
------------------------------------------------------------------------------------------------------------------------------------------------------
------------------------------------------------------------------------------------------------------------------------------------------------------
------------------------------------------------------------------------------------------------------------------------------------------------------
------------------------------------------------------------------------------------------------------------------------------------------------------
------------------------------------------------------------------------------------------------------------------------------------------------------
---------------------------------------------------------------------------------------------------%-----%---------------%----------------------%-----
---------------------------------------------------------------------------------------------------|-----|---------------|----------------------|-----
------------------------------------------------------------%--------------------------------------|-----|--------------%|----------------------|-----
------------------------------------%-----------------------|--------------------------------------|-----|-------%------||----------------------|-----
------------------------------------|-----------------------|--------------------------------------|-----|-------|------||----------------------|-----
----------%-%----%%%%%-%-%%--------%|-----%---%%%-----%--%%%|-%----%%-----------------------%-----%|-----|-------|-----%||---------------%------|C----
----------|-|----|||||-|-||----%%--||%%-%-|---|||----%|-%||||-|----||%----------------------|---%%||-%%-%|%---%-%|-----|||-%-----%%--%---|-----%%-----
%%%%%%%%%-|-|--%-|||||-|-||----||--||||-|-|---|||----||%|||||-|----|||-----%%--%------------|---||||-||-|||---|-||-----|||-|%%---||%-|---|-----||-%--%
|||||||||X|-|X-|X|||||X|X||-XX-||XX||||X|-|XXX|||-X-XX|||||||X|X-XX|||X----||--|--XXXXXXX---|XXX||||X||X|||X-X|X||--X--|||-|||-XX|||X|XXX|XXXXX||X|--|