------------------------------------------------------------------------------------------------------------------------------------------------------
------------------------------------------------------------------------------------------------------------------------------------------------------
------------------------------------------------------------------------------------------------------------------------------------------------------
------------------------------------------------------------------------------------------------------------------------------------------------------
------------------------------------------------------------------------------------------------------------------------------------------------------
--------------------------------------D---------------------------------------------------------------------------------------------------------------
-----------------------------------------------D------------------------------------------------------------------------------------------------------
--------------------------------------g-------------------------------------------------------------------------------------------------------------%-
--------------------------------------%---------------------------------------------------------------------%---------------------------------------|-
--------------------------------------|--------------------------------------%------------------------------|---------------------------------------|-
-------------------%------------------|--------------------------------------|------------------------------|---------------------------------------|-
-------------------|-----------#-%----|--------------------------------------|------------------------------|----------------------C----------------|-
--------%--%%------|------%-%--%-|----|%%------%----------------%------------|-------------------------%%-%-|%-----%%-------%-------------%---------|-
--------|--||------|------|-|--|-|--%-|||------|----------------|%-%---------|--%--------------%-------||-%-||-----||-------|-------------|--------%|-
%%%%%%%%|--||----%%|------|-|--|%|--|%|||-%----|-%--%--%%-----%-||-|--%------|--|---%---%%-----|-------||-|-||-%---||-------|-------------|-----%-%||-
|||||||||-X||XXXX|||XX---X|X|XX|||--|||||X|XXXX|-|XX|--||XXXXX|X||X|XX|X--XXX|--|XXX|-X-||XXXXX|XX---XX||XXX||-|X--||XXX---X|X-XXXXX-XXXXX|XXX-X|X|||X