------------------------------------------------------------------------------------------------------------------------------------------------------
------------------------------------------------------------------------------------------------------------------------------------------------------
------------------------------------------------------------------------------------------------------------------------------------------------------
------------------------------------------------------------------------------------------------------------------------------------------------------
----------------------------------------------------------------------------------t-------------------------------------------------------------------
----------------------------------------------------------------------------------t-------------------------------------------------------------------
----------------------------------------------------------------------------------%-------------------------------------------------------------------
----------------------------------------------------------------------------------|-------------------------------------------------------------------
-----------------------------------------------------------t----------------------|-------------------------------------------------------------------
-----------------------------------------------------------t----------------------|--------------------%-----------%----------------------------------
-----------------------------------------------------------t----------------------|--------------------|-----------|----------------------------------
--------------------------%-%---------%--%-----------------t----------------------|%--------%----------|------%----|----------------------------------
---------------------%%%--%-|--%---%--|--|%----------------%%----%--%-------------||%-%-%---|----%----%|------|----|-------%----------------%---------
---------------------|||--|%|--|---|--|--||----------------||----|--|----------%--|||%|-|---|----|----||--%---|-%--|%------|-----------%-%-%|-%-------
%%%%%%%%%------------|||--|||--|--%|--|-%||---%--------%---||-%--|%-|%-%%------|%-|||||-|-%-|----|----||-%|-%-|-|--||-%---%|%-------%--|-|-||-|--%----
|||||||||XXXXXXXXXXX-|||XX|||XX|XX||XX|-||XX--|XXXXXXXX|XXX||X|XX||X||X||-XXXXX||X|X|||-|X|X|---X|XXX-||-||X|X|X|XX||X|XXX|||X------|XX|X|X||X|-X|XXX-