------------------------------------------------------------------------------------------------------------------------------------------------------
------------------------------------------------------------------------------------------------------------------------------------------------------
------------------------------------------------------------------------------------------------------------------------------------------------------
------------------------------------------------------------------------------------------------------------------------------------------------------
------------------------------------------------------%----------------------------------------------------------------------------------------------%
------------------------------------------------------|----------------------------------------------------------------------------------------------|
---------------------------------------------%--------|---------------------------------------------%------------------------------------------------|
-----------------------------%-------%-------|--------|---------------------------------------------|------------------------------------------------%
-----------------------------|-------|-------|--------|--------------------------------------------S|------------------------------------------------|
-----------------------------|-------|-------|--------|---------------------------------------------|--------%%--------------------------------------|
----------------------%------|-------|-------|--------|-------S-------------------------------------|--------||------%-------------------------------|
----------------------|-----S|-------|-------|--------|-----------------------------------F-------%-|--------||---%--|----------------------%--------|
----------------------|------|%%-----|--%--%-|%%------%----------%%-----------------------%-------|-|-------%||--%|S-|------%---------------|------%-%
----------------------|------|||-----%--|-%|-|||---%--|%-------%%||----------%-%%---------|------%|-|------%|||--||-%|----%-|---------------|%-----|-|
%%%%%%%%-----%--%%%%%-|------%||-----|--|-||-|||--%|--||------%||||----------|%||---------|------||-|------||||--||-||%%--|-|--%%-%---------||-----|-|
||||||||XXXXX|XX|||||X|XXXXXX|||--XXX|XX|X||X|||XX||XX||XXXXXX|||||XXXXXX-XXX||||-XXXXXXXXXXXXXX-||-|X--XXXX|||XX|XXX|||XXXX|-X||X|XXXXXXXXXX|--XXX|X|