------------------------------------------------------------------------------------------------------------------------------------------------------
------------------------------------------------------------------------------------------------------------------------------------------------------
------------------------------------------------------------------------------------------------------------------------------------------------------
------------------------------------------------------------------------------------------------------------------------------------------------------
------------------------------------------------------------------------------------------------------------------------------------------------------
------------------------------------------------------------------------------------------------------------------------------------------------------
------------------------------------------------------------------------------------------------------------------------------------------------------
------------------------------------------------------------------------------------------------------------------------------------------------------
------------------------------------------------------------------------------------------------------------------------------------------------------
------------------------------------------------------------------------%---------------------------------------#-------------------------------------
---------------------------g--------------g-----------------------------|---------------------------------------#-------------------------------------
------------------%-----------------%-----------------------------------|-%-------------------------------------#-------------------------------------
----------%---%---|---------%--%----|----------%-------%--%-------------|-%-------------------%-------------%%%-%-------------------------------------
--------%-|---|-%-|---%-----|--|----|--%-------|%------|--|%------------|-|--------%-------%-%|-------------|||%|----%%---------%-----%---------------
%%%%%%%%|%|---|-|-|---|-%%--|--|----|%%|--%----||------|-%||------------|-|------%-|-%-----|-||-------------|||||----||-%%%-----|----%|------%------%-
|||||||||||-XX|-|X|XXXX-||X-|XX|XX-X||||-X|-XXX||XXXX--|-|||XXXXXXXXXXX-|-|XXX-XX|X|X|--XXXXX||XX--XXX-XXXXX|||||XXX-||X|||-XXX-|----||XXXXX-|X--XXX|X