------------------------------------------------------------------------------------------------------------------------------------------------------
------------------------------------------------------------------------------------------------------------------------------------------------------
------------------------------------------------------------------------------------------------------------------------------------------------------
------------------------------------------------------------------------------------------------------------------------------------------------------
------------------------------------------------------------------------------------------------------------------------------------------------------
-------------------------------------------------------------------------------------------------------%----------------------------------------------
----------------------------------------------------------------%--------------------------------------|----------------------------------------------
----------------------------------------------------------------|--------------------------------------|----------------------------------------------
-------------------------------------------%--------------------|--------------------------------------|-------%--------------------------------------
-------------------------------------------|-------%------------|--------------------------------------|-------|--------------------------------------
-----------------%-----------------%-----%-|-------|------------|--------------------------------------|------%|--------------------------------------
-----------------|-----------------|-----|-|-------|------------|------g-----------------------------%-D------||-------------------------------------%
--------------%--|---%----------%--|-----|-|%------|------------%--%%--|--%-----%-----%--------------|-|---%--||---%%%---%------%--%--%%-------------|
-------------%|--|%--|----------|%-|-----|-||------|------------|--||--|--|--%--|-%---|%--%------%---|-|---|--||%--|||%--|------|--|--||-----%------%|
%%%%%%%%%----||--||--|--------%%||-|%%---|%||-%%%--|------------|--||%-|--|--|-%|%|%%-||--|%-----|---|-|%%-|--|||-%||||-%|------|%-|--||----%|----%-||
|||||||||XXXX||XX||--|X-X--X--||||-|||-XX|||XX|||X-|-XXXXXXXXXXX|XX|||XXXX|XX|-||||||X||XX||XXXXX|--X|X|||-|XX|||X|||||X||-XXX-X||-|XX||XXXX||XXXX|X|X