------------------------------------------------------------------------------------------------------------------------------------------------------
------------------------------------------------------------------------------------------------------------------------------------------------------
------------------------------------------------------------------------------------------------------------------------------------------------------
------------------------------------------------------------------------------------------------------------------------------------------------------
------------------------------------------------------------------------------------------------------------------------------------------------------
------------------------------------------------------------------------------------------------------------------------------------------------------
-------------------------------------------------------------------------------------%----------------------------------------------------------------
-------------------------------------------------------------------------------------|----------------------------------------------------------------
-----------------------------------------------------------%-------------------------|----------------------------------------------------------------
---------------------------------------------------T-------|-------------------------|----------------------------------------------------------------
---------------------------------------------------t-------|-------------------------|------------------------------------%---------%-------%---------
-----------------------------------%---------------t-------|-------------------------|------------------------------------|%--------|%------|---------
-----------------------------------|--%------%%%%--%-------|%-%----%%-%-%-------%---%|--%-----------------%---%%----------||-------%||----%%|----%----
--------------------%%------------%|--|------||||--|-------||-|----||-|-|--%--%-|---||--|-%%%%%----%------|---||------%-%-||-------|||-%--|||%%%-|-%--
%%%%%%%%--------%---||%-------%%--||--|------||||--|-------||-|----||-|-|--|--|-|---||-%|%|||||-%%%|------|---||------|-|-||---%--%|||-|--||||||-|-|--
||||||||XXXXXXXX|XXX|||XXX-XXX||-X||-X|XX-XXX||||-XX--XXXXX||X|XXXX||XX-|XX|X-|X|-XX||-||||||||-||||-XXXX-|XXX||X-----XX|X||X--|XX|||XX|--||||||-|XXX-