------------------------------------------------------------------------------------------------------------------------------------------------------
------------------------------------------------------------------------------------------------------------------------------------------------------
------------------------------------------------------------------------------------------------------------------------------------------------------
------------------------------------------------------------------------------------------------------------------------------------------------------
-----------------------------------------------------D------------------------------------------------------------------------------------------------
------------------------------------------------------------------------------------------------------------------------------------------------------
------------------------------------------------------------------------------------------------------------------------------------------------------
------------------------------------------------------------------------------------------------------------------------------------------------------
------------------------------------------------------------------------------------------------------------------------------------------------------
----------------------------------------------------------------C-------------------------------------------------------------------------------------
-----------------------------------------------------%-----------------------------------------------%------------------------------------------------
-----------------------------------------------------|----------r------------%----%-----%-----------%|-----------------------------------------------%
----------%--------------------%%------------%%-%%---|--%%--%--%%---------%--|----|-----|%%------%-%||%-------------%--------------------------------|
----------|--%-----------------||---%------g-||-||---|--||--|--||---------|--|----|-----|||-%----|-||||-------------|-------%--%---------------%--%--%
%%%%%%%%--|%-|-%-----%----%----||%%%|----%---||-||---|--||--|--||-%-%---%-|%-|-%%-|-%--%|||-|%---|-||||%---%--------|----%--|%-|-----%---------|--|--|
||||||||XX||X|X|XXX-X|XX--|X---||||||XXXX|XXX||X||XXX|-X||--|--||-|X|XXX|X||-|X||X|X|X-|X|XX||-XX|-|||||-X-|XXXXXXXX|XXXX|XX||X|XX---|XXXX--XXX|XX|XX|