------------------------------------------------------------------------------------------------------------------------------------------------------
------------------------------------------------------------------------------------------------------------------------------------------------------
------------------------------------------------------------------------------------------------------------------------------------------------------
------------------------------------------------------------------------------------------------------------------------------------------------------
------------------------------------------------------------------------------------------------------------------------------------------------------
------------------------------------------------------------------------------------------------------------------------------------------------------
----------------------------------------------------------------------------------------------------------D-------------------------------------------
----------------------------------------------------------------------------------%-------------------------------------------------------------------
----------------------------------------------------------------------------------|-------------------------------------------------------------------
---------------------------------------------------%-------------%----------------|-----------------------------------t-------------------------------
---------------------------------------------------|-------------|----------------|-----------------------------------t-------------------------------
--------------------S------------------------------%-------------|----------------|-----------%-----------------------t-------------------------------
------------%----------------------------%-%--%%---|%%-----------|----------%-%---|-----------|----%%-----%----%%%-%-%%%-%-%-----%%--%------------%---
--------%-%-|---%------%--%---%-%------%-|-|--||---|||-----------|----------|-|---|----%--%---|---%||%----|-%--|||%|-|||-|-|-----||--|%---%%%-----|---
%%%%%%%%|-|-|---|-%----|-%|---|-|--%---|%|%|--||-%-|||%-%--------|--%-------|-|---|-%%%|--|---|---||||----|-|--|||||-|||-|-|-----||--||---|||-----|---
|||||||||X|X|X-X|X|XX-X|X||XXX|X|XX|XX-|||||--||-|-||||X|-XXXXX--|XX|-XXX-XX|X|XXX|-||||X-|XXX|XXX|||XX-XX|X|XX|||||X|||-|-|XXXXX||XX||XX-|||-----|XX-