------------------------------------------------------------------------------------------------------------------------------------------------------
------------------------------------------------------------------------------------------------------------------------------------------------------
------------------------------------------------------------------------------------------------------------------------------------------------------
------------------------------------------------------------------------------------------------------------------------------------------------------
------------------------------------------------------------------------------------------------------------------------------------------------------
------------------------------------------------------------------------------------------------------------------------------------------------------
------------------------------------------------------------------------------------------------------------------------------------------------------
------------------------------------------------------------------------------------------------------------------------------------------------------
-------------------------------------------------------------------------------------------------------------------------g----------------------------
----------------------------------------------------------------------------------------------------------------------------%-------------------------
--------------------------------------------------------------------------------U---------------------------------%-%-------|-------------------------
------------------------------------------------------------------------------------------------------------------|-|-------|-------------------------
--------------------------%%-------------%-------------%---%%--------------------%----------------------%---------|-|-------|%-S--%----%--%--%--%-----
--------%%-----------%%%-%||-%%-%%---%---|--%----------|---||-------%-%----------|-%----%%%------%%-----|---------|-|%-----%||----|%---|--|%-|--|-----
%%%%%%%%||-----------|||%|||-||-||---|---|%-|%------%--|%%%||%%%---%|-|---------%|-|----|||------||----%|-----%---|-||-----|||---%||--%%-%||%|--|-----
||||||||||XXXXXXXXXXX|||||||-||-||XX-|X-X||-||XX--XX|XX|||||||||XXX||X|XXXXXXXXX||X|XXXX|||XXXXX-||XX--||-XXXX|XXX|X||-XX--|||XXX||X--||X|||||XX|XXX--