------------------------------------------------------------------------------------------------------------------------------------------------------
------------------------------------------------------------------------------------------------------------------------------------------------------
------------------------------------------------------------------------------------------------------------------------------------------------------
------------------------------------------------------------------------------------------------------------------------------------------------------
----------------------%-------------------------------------------------------------------------------------------------------------------------------
----------------------|-------------------------------------------------------------------------------------------------------------------------------
----------------------|-------------------------------------------------------------------------------------------------------------------------------
----------------------|-------------------------------------------------------------------------------------------------------------------------------
----------------------|----------------------------------------------------------------------------------------------%--------------------------------
-------------U--------|-----------------------------%----------------------------------------------------------------|----t---------------------------
----------------------|--%----S--------------------%|-------------------------------------------%--------------------|----t---------------------------
----------------------|-%|--------------C----------||-------------------------------------------|---------------%----|----%------%-------------%------
----------------------|-||-%----%-%----------------||-------------------%--------%---------%%---|----%------%---%--%-|----|------|-------------|------
------------%%------%%|%||-|----|-|--------%-------||-------%%----------|--------|---------||---|----|--%--%|---|--|%|%%%%|------|-------------|------
%%%%%%%%%---||------||||||-|-X%%|%|%--%----|%%%----||-------||----------|--%-----|%-----%--||-%%%----|--|--||---|%-||||||||-%----|-%-%----%%%--|-%%%--
|||||||||XXX||XXXXXX||||||X|XX||||||XX|XXX-||||XXXX||-X-----||-XXXX--XXX|--|X-X--||XXXX-|--||X|||XXXX|XX|XX||--XX|-||||||||X|-XXXXX|-|XX-X|||X-|X|||XX