------------------------------------------------------------------------------------------------------------------------------------------------------
------------------------------------------------------------------------------------------------------------------------------------------------------
------------------------------------------------------------------------------------------------------------------------------------------------------
------------------------------------------------------------------------------------------------------------------------------------------------------
------------------------------------------------------------------------------------------------------------------------------------------------------
------------------------------------------------------------------------------------------------------------------------------------------------------
-----------------------------------------------------------------------%------------------------------------------------------------------------------
-------------------------------------------------------------D---------|------------------------------------------------------------------------------
-----------------------------------------------------------------------|------------------------------------------------------------------------------
----------------------------D--------------%---------------------------|-------------%------%--------------------------------------------------------%
-----------%-------------------------------|---------%-----------------|-------------|------|--------------------------------------------------------|
----------%|%-----------------%----%-----%S|---------|---%-------------|--%-----%----|----%-|%-------------------------------------------------------|
----------|||%-------%%--%----|--%-|-----|-|--%------|---|-------------|%%|----%|----|--%%|-||------%-----------%-------%%%%-%%--%-------------------|
--------%-||||%-%----||--|--%-|--|-|--%--|-|--|--%%%%|---|------%------||||----||----|%-|||-||-%----|------%----|-------||||-||-%|---%---------------|
%%%%%%%%|-|||||-|--%%||--|--|-|--|-|--|--|-|--|--|||||---|----%-|----%-||||----||---%||-|||-||%|--%%|---%--|%%--|------%||||-||-||---|--------------%|
|||||||||XX|X||X|XX||||XX|XX|X|--|X|--|XXXX|XX|XXX||||XX-XXXX-|X|XX-X|X||||-XXX||---|||X|||X||||--|||XXX|XX|||XX|XX-XXX|||||-||X||X-X|-X-XXXXXXXX-X-||