------------------------------------------------------------------------------------------------------------------------------------------------------
------------------------------------------------------------------------------------------------------------------------------------------------------
------------------------------------------------------------------------------------------------------------------------------------------------------
------------------------------------------------------------------------------------------------------------------------------------------------------
------------------------------------------------------------------------------------------------------------------------------------------------------
------------------------------------------------------------------------------------------------------------------------------------------------------
------------------------------------------------------------------------------------------------------------------------------------------------------
-------------------------------------------------------------------------------------------------------------------------------------------S----------
-----------------------------------------------------------------S------------------------------------------------------------------------------------
------------------------------------------------------------------------------------------------%-----------------------------------------------------
------------------------------------%-----------------%-----------------------------------------|-------------------------%---------------------------
------------------------------------|-----------------|----------%--------%---------------------|-------------------------|---------------------------
-----------------%----------------%-|-------%---------|%%%%----%-|--------|----------%--%%---%%-|--------%----------%---%%|-----%%--%--------%-------%
-----------------|-------------%%-|-|-------|---------|||||--%-|-|-%-----%|---------%|--||---||%|-----%--|--%---%--%|%--|||-----||-%|-------%|-%-----|
%%%%%%%%%%--%%%--|-------%-----||%|-|%----%%|-%-------|||||-%|%|%|-|-----||---%----%||--||%--||||-----|%%|--|%--|--|||--|||--%--||-||%----%-||-|-----|
||||||||||--|||XX|XXXXXXX|XXX-X||||X||XXX-|||-|---XXXX|||||X||||||X|XXXXX||-XX|XXX-|||XX|X|--||||XXXX-||||XX||X-|-X|||XX|||-X|--||X|||XXXX|X||X|--XXX|