------------------------------------------------------------------------------------------------------------------------------------------------------
------------------------------------------------------------------------------------------------------------------------------------------------------
------------------------------------------------------------------------------------------------------------------------------------------------------
------------------------------------------------------------------------------------------------------------------------------------------------------
------------------------------------------------------------------------------------------------------------------------------------------------------
------------------------------------------------------------------------------------------------------------------------------------------------------
------------------------------------------------------------------------------------------------------------------------------------------------------
------------------------------------------------------------------------------------------------------------------------------------------------------
-----------C------------------------------------------------------------------------------------------------------------------------------------------
------------------------------------------------%-----------------------------------------------------------------------------------------------------
------------------------------------------------|-----------------------------------------------------------------------------------------------------
---------%-----%--------------g-----------------|---------------%------------------------------------------%S-----------------------------------------
---------|%%%--|-%------------|------%----------|--%------%-----|------------%--------------------%----%---|---%--%%------------------------%---------
---------||||--|-|------------|----%-|-%--------|-%|------|%%---|-----g------|--------------------|----|--%|---|--||-%------%%--------------|----%---%
%%%%%%%%%||||--|-|-%-------%--|----|-|-|----%%--|-||%%%---|||---|-------%----|-----%------------%-|----|--||---|--||%|%-----||-----%---%-%--|--%%|---|
|||||||||||||XX|X|-|-XXXX--|XXXXXXX|X|-|XXXX||XX|X|||||X-X|||-X-|XXXXXX-|XXXX|-XXXX|-XXXX-XXXX--|X|XX-X|X-||XX-|XXX||||XXXXX||XXXXX|XXX|-|XX|X-|||XX-|