------------------------------------------------------------------------------------------------------------------------------------------------------
------------------------------------------------------------------------------------------------------------------------------------------------------
------------------------------------------------------------------------------------------------------------------------------------------------------
------------------------------------------------------------------------------------------------------------------------------------------------------
------------------------------------------------------------------------------------------------------------------------------------------------------
------------------------------------------------------------------------------------------------------------------------------------------------------
------------------------------------------------------------------------------------------------------------------------------------------------------
-------------------------------------------------------------D----------------------------------------------------------------------------------------
----------------------------------------------------------------------------------------------------------------------------C-------------------------
------------------------------------------------------------------------------------------------------------------------------------------------------
-------------------------------------------------------------------%-------------%-------%------------------%------------------------------------%----
-------------------------------------------------------------------|-------------|--%----|------------------|------------------------------------|----
-----------%---------------------%--------------------------%------|---%---------|--|-%%-|-------%----%-----|%-%------------%%------%------------|----
-----------|---------------------|%-----%----%%----%--%%----|%-----|---|-------%%|--|-||-|-------|%---|-----||-|------------||------|------------|--%-
%%%%%%%%---|----%-----%----------||----%|----||%---|--||----||-----|%--|%%----%|||--|-||%|------%||---|-----||-|---%-----%--||%-----|%-------%---|--|-
||||||||XXX|XX-X|XXX-X|XX-XXXXXX-||XXX-||-X-X|||XXX|--||XXXX||-XXXX||--|||XX-X||||XX|X||||XXXXXX|||XXX|XX-XX||X|XXX|XXXXX|XX|||XXXXX||-XXXXXX|XXX|XX|X