------------------------------------------------------------------------------------------------------------------------------------------------------
------------------------------------------------------------------------------------------------------------------------------------------------------
------------------------------------------------------------------------------------------------------------------------------------------------------
------------------------------------------------------------------------------------------------------------------------------------------------------
------------------------------------------------------------------------------------------------------------------------------------------------------
------------------------------------------------------------------------------------------------------------------------------------------------------
------------------------------------------------------------------------------------------------------------------------------------------------------
-------------------------------------------------------------------------------------------------------------------------------------------------%----
-------------------------------------------------------------------------------------------------------------------------------------------------|----
---------------------------------------------------------------------------------------%---------------------------------------------------------|----
------------------------------------------%--------------------------------------------|--%------------------------------------------------------|----
-----------------%---%--------------------|-------------------------------------%------|--|------------------------------------------------------|2---
-----------U-----|---|--------------------|--------%--------%-------%-----------|----%-|--|%%----%--%-%%--%-%-%--%--------------------------%----|----
-----------------|--%|-----%-----------%--|-%--%%--|-------%|--%----|-%-%----#--|----|-|--|||----|--|-||-%|%|%|--|-------%------------------|--%-|-%--
%%%%%%%%%--------|-%||--%--|----------%|--|-|--||--|%-%----||--|----|-|-|----#--|----|-|--|||----|%%|-||-||||||--|-------|----%-------%-----|--|-|-|--
|||||||||XXXXXXXXXX|||--|XX|---XXXXXXX||XX|X|XX||XXX|X|XXXX||XX|XXXX|X|-|XX--X-X|XX-X|X|X-|||XXXX||||-||X||||||XX|---XXXX|XXXX|XXXXXXX|XXXXX|XX|X|X|X-