------------------------------------------------------------------------------------------------------------------------------------------------------
------------------------------------------------------------------------------------------------------------------------------------------------------
------------------------------------------------------------------------------------------------------------------------------------------------------
------------------------------------------------------------------------------------------------------------------------------------------------------
------------------------------------------------------------------------------------------------------------------------------------------------------
------------------------------------------------------------------------------------------------------------------------------------------------------
------------------------------------------------------------------------------------------------------------------------------------------------------
----------------------------------------------------------------------------------------------------------------%---D---------------------------------
-------------------------------%--------------------------------------------------------------------------------|-------------------------------------
-------------------------------|-----------------------------------------------------------------%--------------|-------------------------------------
-------------------------------|---%---------------------------------------------------------%---|--------------|-------------------------------------
---------------%---------------|---|-----------%---------------------------------------------|---|S-------------|----------------------%---%----------
---------------|---%-----------|---|--%--%-----|---------%-----------------------------------|%--|-%--%---------|---------%------------|---|----------
---------------|---|-%---------|---|--|--|-----|-------%-|---------------------%--%----------||--|-|--|--------%|---%%%---|%---%-%-%%--|--%|----------
%%%%%%%%-------|---|-|%-%-%%%--|%%-|-%|--|----%|%------|-|-------%------%------|--|%--------%||--|-|--|--------||---|||---||---|-|-||%-|--||----------
||||||||XXXXXXX|XXX|X||X|X|||XX|||X|X||-X|XXXX|||XXXXXX|X|XXXXXXX|-X--X-|XXXXXX|XX||XXXXX-XX|||XX|X|--|XXX-XXXX||X--|||XX-||-XX|X|-|||-|X-||-X-XXXXXX-