------------------------------------------------------------------------------------------------------------------------------------------------------
------------------------------------------------------------------------------------------------------------------------------------------------------
------------------------------------------------------------------------------------------------------------------------------------------------------
------------------------------------------------------------------------------------------------------------------------------------------------------
------------------------------------------------------------------------------------------------------------------------------------------------------
-----------------------------------------------------------------------------------------------------------------------------------------------------S
------------------------------------------------------------------------------------------------------------------------------------------------------
----------------------------------U-------------------------------------------------------------------------------------------------------------------
-----------------------------------------------------------------------------------------------------------------------------------------------------%
--------------------%--------------------------------------------------------------------------------------%-----------------------------------------|
--------------------|--------------------------------------------------------------------------------------|--------%--------------------------------|
-----------------%--|----------%--%------------------------------------------------------------------------|--------|--------------------------------|
-----------%-----|--|----------|--|-%%-----%%%-%%-----------------%-%----%-----------%-%-%--------%-----%--|--------|-------%--%------%------------%-|
-----------|--%--|--|----------|--|-||-----|||-||----------%%----%|-|----|%%---------|-|%|-----%--|-----|--|-%-%-%--|-------|-%|------|%----%------|-|
%%%%%%%%%--|%-|--|-%|----------|--|-||-----|||-||%%%%------||----||-|---%|||-----%--%|-|||-%---|-%|-----|--|%|-|-|%%|---%%%-|%||-%%---||----|------|-|
|||||||||XX||X|XXXX||XXXXX-XXXXXXX|X|X-XXXX|||-||||||X-XX--||---X||-|--X||||XXXXX|XX||X|||X|XXX|-||X-XXX|XXX||XX-||||X--|||X||||-||XXXX|XXXXXXXXXXX|X|