------------------------------------------------------------------------------------------------------------------------------------------------------
------------------------------------------------------------------------------------------------------------------------------------------------------
------------------------------------------------------------------------------------------------------------------------------------------------------
------------------------------------------------------------------------------------------------------------------------------------------------------
------------------------------------------------------------------------------------------------------------------------------------------------------
------------------------------------------------------------------------------------------------------------------------------------------------------
------------------------------------------------------------------------------------------------------------------------------------------------------
------------%--%-------------------------------------------------------------%------------------------------------------------------------------------
------------|--|-------------------------------------------------------------|----------------------------------------------------------------%-------
------------|--|------------------------------------------%------------------|----------------------------------------------%-----------------|-------
------------|%-|------%---------%-------------%-----------|------------------|------------------------------------S---------|----%--%---S-----|-------
------------%|-|---%--|%--------|-------------|----------%|------------------|-----------------%%----------------------%----|----|--|---------|-------
------------||-|---|--||--------|-%--------%-%|----------||-%%---%%-------%--|-----------------||--%%--%--------%------|----|-%--|--|--%------|-----%-
------------||-%%--|--||------%-|-|%%%%-%--|-||---%------||-||%--||-%-----|--|------%%-%-------||-%||--|----%---|------|--%-|-|--|%-|--|%-----|-----|-
%%%%%%%%-%--||%||--|--||------|-|-|||||-|--|-||%--|------||-|||%%||%|-%---|--|--%%--||-|--%-%%-||-|||--|----|---|%%--%%|--|-|-|--||-|--||%----|%----|%
||||||||X|--|||||XX|XX|XXXX-XX|X|X|||||-|XXXX|||XX|XXX-XX||X|||||||||X|XXX|--|--||XX||X|-X|-||-||X|||XX|XXXX|XXX|||X-|||XX|X|X|XX||-|XX|||-X--||XXXX||