------------------------------------------------------------------------------------------------------------------------------------------------------
------------------------------------------------------------------------------------------------------------------------------------------------------
------------------------------------------------------------------------------------------------------------------------------------------------------
------------------------------------------------------------------------------------------------------------------------------------------------------
------------------------------------------------------------------------------------------------------------------------------------------------------
------------------------------------------------------------------------------------------------------------------------------------------------------
--------------------------------------------------------------------------------------------------------------%-------------%%------------------------
--------------------------------------------------------------------------------------------------------------|-------------||------------------------
--------------------------------------------------------------------------------------------------U-----------|-------------||------------------------
--------------------------------------------------------------------------------------------------------------|-------------||------------------------
--------------------------------------------------------------------------------------------%------------%----|-------------||-----%%-----------------
--------------------K--------------------------------%%--------%--------%-------------------|------------|----|-------------||-----||-----------------
--------------------%----------%%%%----------------%-||------%%|--------|-------------------|-%---%------|----|-----------%-%%-%-%-||-----------------
---------%%---------|----------||||--%-----%-------|-||------|||--------|--------%%--%--%---|-|---|------|%-%-%-----------|%||-|-|-||-#------------%%-
%%%%%%%%%||%%-%%-%--|%-------%-||||--|-%-%-|-------|-||--%---|||-----%--|----%---||--|--|---|%|--%|--%%--||-|-|-----------||||-|-|-||-%---%#-------||-
|||||||||||||X||X|XX||XXXX-XX|-||||-X|X|X|-|X-XX-X-|X||XX|XXX|||-XXXX|XX|XXXX|XXX||XX|XX|-XX|||XX||XX||-X||-|X|--XXXX---X-||||-|-|X||X|--X|X----XXX||X