------------------------------------------------------------------------------------------------------------------------------------------------------
------------------------------------------------------------------------------------------------------------------------------------------------------
------------------------------------------------------------------------------------------------------------------------------------------------------
------------------------------------------------------------------------------------------------------------------------------------------------------
------------------------------------------------------------------------------------------------------------------------------------------------------
------------------------------------------------------------------------------------------------------------------------------------------------------
---------------------------------------------------------------------------------------D--------------------------------------------------------------
------------------------------------------------------------------------------------------------------------------------------------------------------
-----------G----------------------------------------------------------------------------------------------------------------------------g-------------
------------------------------------------------------------------------------------------------------------------------------------------------------
-----------------------------------%------------------------%------------------------------------%----------------------------------------------------
-----------------------------------|-%----------------------|------------------%-----------------|----------------------------------------------------
-----------------------------------|-|-------------%-------%|-%--------%-------|----%--%%--------|---%-----------------%-%----%%-----------%------%%%-
-----------%-----------------------|-|-%-----------|-------|%-|--------|%----%-%----|-%||%%---%--|---|------------%----|-|----||%%--%---%%-|------|||-
%%%%%%%%%--|------------%%%%%------|-|-|---%----%--|-%-----||-|-----%--||----|-|%---|-|||||---|--|---|%---%-------|--%-|%|%---||||-%|--%||-|--%---|||-
|||||||||X-|XXXXXX--XXXX|||||-XXXXX|X|X|XXX|X-XX|-X|X|XXXXX||-|XXXXX|XX||XXXX|X||X-X|X|||||-XX|-X|XXX||XXX|XXXXXX-|X-|X||||XXX||X|X||--|||-|--|XXX|||X