------------------------------------------------------------------------------------------------------------------------------------------------------
------------------------------------------------------------------------------------------------------------------------------------------------------
------------------------------------------------------------------------------------------------------------------------------------------------------
------------------------------------------------------------------------------------------------------------------------------------------------------
------------------------------------------------------------------------------------------------------------------------------------------------------
------------------------------------------------------------------------------------------------------------------------------------------------------
------------------------------------------------------------------------------------------------------------------------------------------------------
------------------------------------------------------------------------------------------------------------------------------------------------------
------------------------------------------------------------------------------------------------------------------------------------------------t-----
--------------------------%--------------------------%-------------------------------------%----------------------------------------------------t-----
---------------%---%------|--------------------------|---------%---------------------------|----------------------------------------------------t-----
----------%----|---|------|--------------------------|---------|-------%-------------------|---------------%------------------%-----------------%-----
----------|----|---|-----%|%%%-----------------%%----|---------|---%---|------%--%---------|-----------%%--|-----------%%%%%--|--%--%---%-------|-----
----------|----|---|-----|||||------%----------||----|---%----%|---|---|%%----|%-|----%----|-%%---%%%%-||--|-----------|||||--|--|--|--%|-------|--%%-
%%%%%%%%%-|-%%%%---|-----|||||------|-%-------%||--%-|---|----||---|---|||----||-|%---|-%-%|-||---||||%||-%|%--%%%%-%--|||||--|--|--|-X||-------|-%||%
|||||||||-X-||||XXX|-X-XX|||XXXXXXXX|X|XXXX-X-|||XX|X|XXX|X--X||XXX|XXXX||-X--||-||X--|X|-||X||XXX|||||||-|X|XX||||-|XX|||||XXXXX|-X|XX||XX--X--|-||||