------------------------------------------------------------------------------------------------------------------------------------------------------
------------------------------------------------------------------------------------------------------------------------------------------------------
------------------------------------------------------------------------------------------------------------------------------------------------------
------------------------------------------------------------------------------------------------------------------------------------------------------
------------------------------------------------------------------------------------------------------------------------------------------------------
------------------------------------------------------------------------------------------------------------------------------------------------------
-----------------------------------------------------%------------------------------------------------------------------------------------------------
-----------------------------------------------------|-----------------------------------------------------t------------------------------------------
-----------------------------------------------------|-----------------------------------------------------t---------------------%--------------------
-------------------------%---------------------------|---------------------------------------------%-------%---------------------|--------------------
-------------------------|---------------------------|---------------------------------------------|--%----|---------------------|---------%----------
-------------------------|---------------%-----------|--------------%------------%-----------------|--|---%|---------------------|---------|----------
---------%---------------|-------%-------|-----%-----|---%-------%--|---%--%--%--|-%---------------|--|-%%||-------------%----%-%|---%-%%--|---------%
---------|--%%%---%--%-%-|-------|---%%--|%%%%-|%----|---|-------|--|---|--|--|--%%|---------------|--|-||||--------%-%--|%---|-||---|-||-%|%%----%%%|
%%%%%%%%%|%%|||---|--|-|-|------%|--%||--|||||-||----|---|-------|--%-%-|--|-%|--|||---------------|--|-||||--%-----|-|--||--%|-||---|-||-||||----||||
|||||||||||||||---|--|X|X|XXXXXX||XX|||XX|||||X||XXXX|--X|XXXXXX-|X-|X|X|X-|X||--|||XXXXXXX--XXXXX-|XX|X||||XX|XXXX-|X|XX||XX||X||-XX|X||X||||---X||||