------------------------------------------------------------------------------------------------------------------------------------------------------
------------------------------------------------------------------------------------------------------------------------------------------------------
------------------------------------------------------------------------------------------------------------------------------------------------------
------------------------------------------------------------------------------------------------------------------------------------------------------
----------------------------------------------------------------------------------------------------%-------------------------------------------------
----------------------------------------------#-----------------------------------------------------|-------------------------------------------------
----------------------------------------------#-----------------------------------------------------|-------------------------------------------------
----------------------------------------------%-----------%-----------------------------------------|---------------------------D---------%-----------
----------------------------------------------|-----------|-----------------------------------------|-------------------------------------|-----------
----------------------------------------------|-----------|-----------------------------------------|----%--------------------------------|-----------
----------------------------------------------|-----------|-----------------------------------------|----|------------------------%-------|-----------
----------------------------------------------|-----------|-----------------------------------------|-g--|------------------------|-------|-----------
-------------------%-%--%--%------%-------%%--|-----%%%---|--%%--%%%%------------------%-------C----|-%--|------------------------|--%----|%--%-%-----
-------------------|%|--|--|%-----|---%---||%-|-----|||---|--||--||||--%%---%----%-----|-%---%---%--|-|%-|%---%-----------------%-|--|---%||--|-|-----
%%%%%%%%-%%-----%--|||%-|--||%----|-%-|---|||-|-----|||---|--||--||||--||---|-%--|%--%%|-|-%%|---|--|-||%||%--|---%-%%-----%----|-|%-|---|%|--|-|-%---
||||||||X||XXXXX|XX||||X|X-|||XXX-|X|X|XX-|||X|XXXX-|||-XX|XX||XX||||XX||--XXX|XX||XX|||-|X|||-XX|-X|XX|||||XXXXXX|-||XX-XX|XXXX|X||X|XXX|||XX|-|X|XXX