------------------------------------------------------------------------------------------------------------------------------------------------------
------------------------------------------------------------------------------------------------------------------------------------------------------
------------------------------------------------------------------------------------------------------------------------------------------------------
------------------------------------------------------------------------------------------------------------------------------------------------------
------------------------------------------------------------------------------------------------------------------------------------------------------
----------------------------------------------------------------------------------------------------%-------------------------------------------------
-----------------------------%----------------------------------------------------------------------|----------------------------%----------%---------
-----------------------------|--------------------------------------------------------------%-------|----------------------------|----------|---------
-----------------------------|--------------------------------------------------------------|-------|----------------------------|----------|---------
-----------------------------|-------------------------------------%------------------------|-------|----------------------------|----------|---------
-----------------------------|-------------------------------------|------------------------|-------|------%-----------------%---|----------|---------
----------%%-------%---------|-------------------------------------|------------------------|-------%------|-------------%-%-|---|----------|---------
----------||--%----|---------|--------------%----------------------|-----------%----------%-|-------|--%%%-|%%---%-------|-|-|---|--%-------|------#--
----------||--|----|----%----|------------%-|----------%-%--%------|--------%--|---------%|-%-------|%-|||-|||---|-%---%-|-|-|---|--|------%%------%--
%%%%%%%%%-||--|----|----|----|%%--%----%%%|-|-----%-%--|-|--|------|-%------|--|-------%-||-|-------||-|||%|||---|-|%%-|-|-|-|%--|%-|%%%-%%||-%----|--
|||||||||XXXXX|X---|XXXX|X-XX|||XX|-X-X||||X|XXXXX|X|XX|-X-X|XXXXXX|X|-X----|--|XXXXXXX|X|X-|XXXXXXX||-|||||||-XX|X|||-|-|XXX||X-||-||||X||||X|--XX|-X