------------------------------------------------------------------------------------------------------------------------------------------------------
------------------------------------------------------------------------------------------------------------------------------------------------------
------------------------------------------------------------------------------------------------------------------------------------------------------
------------------------------------------------------------------------------------------------------------------------------------------------------
------------------------------------------------------------------------------------------------------------------------------------------------------
------------------------------------------------------------------------------------------------------------------------------------------------------
------------------------------------------------------------------------------------------------------------------------------------------------------
------------------------------------------------------------------------------------------------------------------------------------------------------
------------------------------------------------------------------------------------------------------------------------------------------------------
--------------------------------------------------------------------------------------------------------------%---------------------------------------
----------------------------------------------------------------------------S----------------------------%----|---------------%-----------------------
-------------------%----------------------%-------%--------------%------------------------------%------%%|%%--|---------------|-----------------------
----------%---%---%|--%%%-----------------|-------|---------%----|------%-----%-----%-%-----%%--|------|||||--|---------------|-%--------------------%
----------|--%|---||-%|||---------%------%|-------|%%-------|----|------|-----|-----|-|-----||--|------|||||-%|----%-%%-%-----|-|-----------%---%-%--|
%%%%%%%%--|%-||%-%|X-||||---------|------||%------|||-%-----|-%--|------|---%%|%----|-|-----||--|--%%--|||||-||--%-|-||-|-%%%-|-|-%--%------|---|%|--|
||||||||-X||X|||-||X-||||X-XXXXXXX|XXXXXX|||X---XX|||X|XXXXX|X|X-XXX-XX-|---||||--XX|X|XXXXX||XX|XX||XXX||||-||--|-|X||X|X|||X|X|X|XX|XXXXXX|XXX|||XXX