------------------------------------------------------------------------------------------------------------------------------------------------------
------------------------------------------------------------------------------------------------------------------------------------------------------
------------------------------------------------------------------------------------------------------------------------------------------------------
------------------------------------------------------------------------------------------------------------------------------------------------------
------------------------------------------------------------------------------------------------------------------------------------------------------
------------------------------------------------------------------------------------------------------------------------------------------------------
------------------------------------------------------------------------------------------------------------------------------------------------------
----------------%-------------------------------------------------------------------------------------------------------------------------------------
----------------|-----------------%-------------------------------------------------------------------------------------------------------------------
----------------|-----------------|---------------------------------------------%----------%-----------------------------------------------%----------
----------------|-----------------|---------------%-----------------------------|----------|-----------------------------------------------|----------
----------------|----------%------|---------------|------%-------%-------%------|----------|-----%-------------------%---------------------|----------
---------%------|----------|----%-|--------------%|------|-------|-------|------|----------|-----|---%%%%%----%------|-----%--%--------%---|----------
---------|---%%-|---------%|----|-|--%--%--------||------|%------|-------|------|----------|-----|---|||||----|------|-----|--|-----%--|---|-----%----
%%%%%%%%%|---||-|%%--%----||----|-|--|-%|--%-----||%--%--||-%%---|-------|------|------%---|-%---|---|||||----|%-----|-----|--|-----|--|---|%----|----
|||||||||XXXX||X|||XX|XXXX||XX-X|X|-X|X||XX|XXXXXX||--|XXX|X||XXXXXXX-XXXXXXX-XX|XXXXXX|-XX|X|XX-|--X|||||XXXX||XXXXX|XXXXX|XX|X-XXX|XX|-XX||XX-X|--XX