------------------------------------------------------------------------------------------------------------------------------------------------------
------------------------------------------------------------------------------------------------------------------------------------------------------
------------------------------------------------------------------------------------------------------------------------------------------------------
------------------------------------------------------------------------------------------------------------------------------------------------------
------------------------------------------------------------------------------------------------------------------------------------------------------
------------------------------------------------------------------------------------------------------------------------------------------------------
------------------------------------------------------------------------------------------------------------------------------------------------------
---------------------------------------------%------------------------------%--------------D----------------------------------------------------------
---------------------------------------------|------------------------------|-------------------------------------------------------------------------
-------------------------------%-%-----------|------------------------------|-------------------------------------------------------------------------
-------------------------------|-|-----------|------------------------------|--------------t----------------------t-----S---------------------%---%--%
-------------------------------|-|-----------|----------------------%-------|--------------t----------------------t---------------------------|---|--|
-------------------------------|-|-%----%%---|------------%---------|-------|--------------t------%-------%-------t------%---------%----%%%--%|--%|--|
----------------%---------%%---|-|%|-%--||---%------------|---%--%--|--%-%%-%-----%-----%%-%---%--|-------|-------%-----%|--------%|----|||--||--||%-|
%%%%%%%%--%%---%|-%-%----%||---|-|||-|--||---|-----%------|---|--|--|--|-||-|-----|--%%-||-|--%|%-|-------|---%---|-----||------%-||----|||%%||--|||%|
||||||||XX||XXX||X|-|XXXX|||XXX|X|||XXX-||XXX|X-XXX|XXXXXX|---|X-|XX|XX|X||X|-XX-X|XX||X||X|-X|||X|XX-XXXX|XXX|XX-|--XXX||---XXX|X||--XX|||||||XX|||||