------------------------------------------------------------------------------------------------------------------------------------------------------
------------------------------------------------------------------------------------------------------------------------------------------------------
------------------------------------------------------------------------------------------------------------------------------------------------------
------------------------------------------------------------------------------------------------------------------------------------------------------
------------------------------------------------------------------------------------------------------------------------------------------------------
---------------------%--------------------------------------------------------------------------------------------------------------------------------
---------------------|----------------------------------------------------------------------------------------------------------%---------------------
---------------------|----------------------------------------------------------------------------------------------------------|---------------------
---------------------|----------------------------------------------------------------%-----------------------------------------|---------------------
---------------------|----------------------------------------------------------------|-----------------------------------------|S--------------------
---------------------|-%-----------------------g----------%---------------------------|-------------------------------------S---|---------------------
---------------------|-|--%--------------------|----------|---------------------------|-----------------------------------------|---------------------
---------%-----------|-|--|------------------%%|----------|------%-------------%------|-%%--%%----------------------------------%------%--------------
---------|-----------|%|%%|%%------%--%------|||-------%--|-----%|-%-----------|----%%|%||-%||-----------------%---%------------|%-----|--------------
%%%%%%%%-|-%---------||||||||%-----|--|----%-||%-------|--|-----||-|--%---%----|----||||||%|||-----------------|%--|--------%%--||-%---|----------%---
||||||||X|X|-XXXXX--X|||||||||XX-X-|X-|XXXX|X|||XXXXXXX|XX|XX-XX||X|--|XXX|XXXX|XXXX||||||||||XXXXX-XXXXXXXX-XX||XX|XXXXXXXX||-X||X|XXX|XXX--XXXX-|XXX