------------------------------------------------------------------------------------------------------------------------------------------------------
------------------------------------------------------------------------------------------------------------------------------------------------------
------------------------------------------------------------------------------------------------------------------------------------------------------
------------------------------------------------------------------------------------------------------------------------------------------------------
------------------------------------------------------------------------------------------------------------------------------------------------------
------------------------------------------------------------------------------------------------------------------------------------------------------
-----------------------------------------------------------------------------------------------------------------------t------------------------------
---------------------------------------%---------------------------------------------------------------------%---------t------------------------------
---------------------------------------|---------------------------------------------------------------------|---------t------------------------------
---------------------------------------|---------------------------------------------------------------------|---------%------------------------------
-------------------------------%--%----|---------------------------------------------------------------------|---------|------------------------------
-------------------------------|--|----|---------------------------------%-----------------------------------|---------|------------------------------
------------------------%-----%|%-|----|-----------------%%----%---------|%----------------%%%-%%----%-------|%--------|---%----------------%%---%%--%
----------------%%------|-----|||-|----|----%%------%%---||%---|%--------||----------------|||-||--%-|-------||--------|---|----------%%----||-%-||--|
%%%%%%%%%--%%%--||--%--%|--%--|||-|---%|-%%-||%-----||---|||---||--------||%--------------%|||-||--|-|%------||-%%-----|---|----------||----||%|-||--|
|||||||||XX|||XX||X-|XX||XX|-X|||-|X-X||-||-X||XX-XX||X-X|||XXX||XXXXXX-XX||XXXXXX-XXXXX--||||-||XXX-||XXXX-X||X||XXXXX|XXX|X-XXX-XXX-||XXXX||||X||XX|