------------------------------------------------------------------------------------------------------------------------------------------------------
------------------------------------------------------------------------------------------------------------------------------------------------------
------------------------------------------------------------------------------------------------------------------------------------------------------
------------------------------------------------------------------------------------------------------------------------------------------------------
------------------------------------------------------------------------------------------------------------------------------------------------------
------------------------------------------------------------------------------------------------------------------------------------------------------
------------------------------------------------------------------------------------------------------------------------------------------------------
------------------------------------------------------------------------------------------------------------------------------------------------------
------------------------------------------------------------------------------------------------------------------------------------------------------
------------------%----------------------------------------------------------------------%------------------------------------------------------------
------------------|------%%--%-----%------%----------------------------------------------|----------------------------------------%-------------------
------------------|------||--|-----|-----%|------%---------------------------------------|-----------------------------%----------|-------------------
------------------|-%----||--|-----|-----||---%--|--------------%--%---------------------|%%------%%-------------------|----------|-----------%-------
---------%--------|-|----||%-|-----|--%%-||---|--|--------------|%-|-----%--%------------|||%-----||---%-%-----%-%---%-|-%--------|-------%---|-------
%%%%%%%%%|%%------|-|-%-%|||-|--%--|--||-||---|%-|%--%------%---||-|-----|--|-----%-%%---||||-%-%%||---|-|-----|-|--%|%|-|-------%|-------|%%-|-%-----
||||||||||||XXXXX-|XX-|X||||-|XX|-X|XX||-||XXX||X||-X|XX-XXX|--XX|-|XXXX-|XX|XXX--|X||XXX||||-|X||||X-X|X|XXXXX|X|XX|||XX|XX-X-X-||XXX----|||X|X|XX-XX