------------------------------------------------------------------------------------------------------------------------------------------------------
------------------------------------------------------------------------------------------------------------------------------------------------------
------------------------------------------------------------------------------------------------------------------------------------------------------
------------------------------------------------------------------------------------------------------------------------------------------------------
------------------------------------------------------------------------------------------------------------------------------------------------------
------------------------------------------------------------------------------------------------------------------------------------------------------
------------------------------------------------------------------------------------------------------------------------------------------------------
---------%-------%-----------------------------------------------------------------------------------------------------------------------------%------
---------|-------|------------------------S---------------------------------------------------------------------%------------------------------|------
---------|-------|-------%---------------------------%---------------------------------------------%------------|------------------------------|----%-
---------|-------|---%---|----------------g----------|-----------------------------------%---------|------------|------------------------------|----|-
---------|-------|---|-SC|--------------------%---%--|-----------------------------------|--------%|-------%----|-%----------------------S-----|----|-
---------|-------|---|---|-----%%---%%-%---%--|---|--|---------------%-%-----------------|-%------||-----%-|----|-|--------------%--%-%--------|----|-
---------|-------|-%-|---|-----||--%||-|---|--|%--|g-|-%-----%-------|%|%--%%-----%---%--|%|---%%-||-----|-|----|-|-----S-------%|--|%|%---%---|%---|-
%%%%%%%%%|-%--%--|-|-|---|---%%||%-|||-|--%|--||%%|%%|-|-%---|-------||||%-||-----|---|--|||%--||-||-----|-|----|%|%-------%%---||--||||---|---||---|-
||||||||||X|XX|XX|X|X|XXX|XX-|||||X|||-|XX||XX||||||||X|-|-XX|-X-XXXX|||||X||XXXX-|XXX|-X||||X-||XX|X-XXX|XX-XXX||||XXXXXXX||-XX||XX||||XX-|XXX||XXX|X