------------------------------------------------------------------------------------------------------------------------------------------------------
------------------------------------------------------------------------------------------------------------------------------------------------------
------------------------------------------------------------------------------------------------------------------------------------------------------
------------------------------------------------------------------------------------------------------------------------------------------------------
------------------------------------------------------------------------------------------------------------------------------------------------------
------------------------------------------%-----------------------------------------------------------------------------------------------------------
------------------------------------------|----------------------------------------------------------------------------S------------------------------
------------------------------------------|-----------------------------------------------------------------------------------------------------------
------------------------------------------|-----------------------------------------------------------------------------------------------------------
------------------------------------------|----------------------------------------%-----------------------------------%------%-----------------------
------------------------------------------|----------------------------------------|-------%---------------------%-----|------|--------------%%-------
------------------------------------------|------------------------------%---------|-------|---------------------|-----|------|----------%---||-------
---------------%-------%-%-%%---%---------|------%---%-----%-------------|---------|-%-----|------------%%%%%---%|%----|------|---%-%--%%|%--||---%---
---------------|-------|-|-||---|---------|------|---|-----|-------------|---------|-|----%%-%----%-----|||||---|||--%%|------|---|-|--||||--||---|%--
%%%%%%%%-%%----|-%%----|%|-||---|--%%-%---|----%-|---|-----|------------%|--%------|-|----||-|----|-----|||||---|||%%|||---%--|---|-|-%||||--||---||--
||||||||-||XXXX|-||-X-X||XX||XXX|--||X|-XX|XXXX|X|-XX|XX-XX|XXXX-XXXXXXX||XX|XX-XXX|-|-XXX||X|----|-XXXX|||||X--||||||||--X|XX|---|X|-|X|||XX||---||--