------------------------------------------------------------------------------------------------------------------------------------------------------
------------------------------------------------------------------------------------------------------------------------------------------------------
------------------------------------------------------------------------------------------------------------------------------------------------------
------------------------------------------------------------------------------------------------------------------------------------------------------
------------------------------------------------------------------------------------------------------------------------------------------------------
------------------------------------------------------------------------------------------------------------------------------------------------------
----------------S-----------------------------------------------------------------------------------------%-----------------------S-------------------
----------------------------------------------------------------------------------------------------------|-------------------------------------------
---------------------------------------------------------------------------------%------------------------|-------------------------------------------
-----------S----%----------------------------------------------------------------|------------------------|-------------------------------------------
----------------|----------------------------------------------------------------|------g--------%--------|%-------------------%--%-%------%----------
--------------%%|-----------%----------------------------------------------------|---------------|--------||---------------%G--|--|-|------|----------
--------------|||%----------|----%-%%---------%%%-----%---%----------------------|-----%---------|---%--%%||-%--%-------%--|%--|--|-|------|--%%%%--%-
-----------%%-||||--%%--%---|----|%||-%%------|||-----|-%-|%%%-------%-----------|-----|---------|%%%|--||||-|--|%%-----|--||--|--|%|------|-%||||%-|-
%%%%%%%%---||-||||%%||--|---|---%||||-||------|||-----|-|%||||-------|-----------|----%|--%------|||||--||||-|--|||-----|--||%-|-%|||--%---|-||||||%|-
||||||||XXX||XXX||||||X-|-XX|XX-|||||X||XXXXXX|||XXXXX|X||||||XXXXXX-|-XXX-X-----|-XXX||-X|XXXX-X|||||XX||||-|XX|||X----|-X|||X|X||||-X|XX-|X||||||||X