------------------------------------------------------------------------------------------------------------------------------------------------------
------------------------------------------------------------------------------------------------------------------------------------------------------
------------------------------------------------------------------------------------------------------------------------------------------------------
------------------------------------------------------------------------------------------------------------------------------------------------------
------------------------------------------------------------------------------------------------------------------------------S-----------------------
------------------------------------------------------------------------------------------------------------------------------------------------------
------------------------------------------------------------------------------------------------------------------------------------------------------
----------%-------------------------------------------------------------------------------------------------------------------%-----------------------
----------|-------------------------------------------------------------------------------------------------------------------|-----------------------
----------|------------------------------------------------------------------------------------%------------------------------|-----------------------
----------|------------------------------------------------------------------------------------|----%%------%-----------------|----%---%--------------
----------|-----------------%------------------------%-----------------------------------------|----||------|-%---------------|----|---|--------------
----------|----%-%-%%-------|------------------------|------U--%--------%----%%-%--------------|--%-||-%----|-|--------%------|----|---|--------------
----------|----|-|-||-------|-----%-----%%-----------|---------|-%%-----|--%-||%|-------------%|--|%||-|%---|-|-%------|------%--%%|---|--%-%%%-------
%%%%%%%%%%|%---|%|-||------%|-----|%----||-----------|---------|-||-%---|--|-||||--------%%---||%%||||-||---|%|-|------|-----%|--|||%--|-%|-|||--%----
||||||||||||XXX|||X||-XXX--|XXXXXX||XXXX||XXXXXXXXX-X|XX-XXXXXX|X||X|XXX|--|X||||XX-XXXXX||X-X||||||||X||X--|||X|XXXXXX|XXXXX||X-|X||--|X||X|||XX|XXXX