------------------------------------------------------------------------------------------------------------------------------------------------------
------------------------------------------------------------------------------------------------------------------------------------------------------
------------------------------------------------------------------------------------------------------------------------------------------------------
------------------------------------------------------------------------------------------------------------------------------------------------------
------------------------------------------------------------------------------------------------------------------------------------------------------
------------------------------------------------------------------------------------------------------------------------------------------------------
------------------------------------------------------------------------------------------------------------------------------------------------------
------------------------------------------------------------------------------------------------------------------------------------------------------
------------------------------------------------------------------------------------------------------------------------------------------------------
------------------------------------------------------------------------------------------------------------------------------------------------------
------------------------------------------------------------------------------------------------------------------------------------------------------
----------------------------------%----------%---------------%-------------------------------------%%-------------------------------------------------
-------------%-%%%%---%-----------|----------|----2-%%%-%----|-----------------------------%%------||-----%---%---%-%-%-%-----------%---%--%--------%-
-------------|-||||%--|--------%--|--%-------|---%--|||-|----%----%---------%--------------||------||-----|---|---|-|-|-|%%--%%%-%--|---|--|--------|%
%%%%%%%%---%%|-|||||--|--------|--|--|%%%----|---|--|||-|----|----|-------%-|--------%%%--%||----%-||-----|---|---|-|-|-|||--|||-|--|---|-%|------%-||
||||||||XXX|||-|||||X-|XXXXXXXX|XX|XXX|||-XXXXXXX|XX|X|X|---XX--XX|--XXXXX|X|X--XXXXX|||XX|||XXXX|-||XXXX-|XXXXXXX|-|X|X|||XX|||X|XX|XXX|X||XXXXXX|XX|