------------------------------------------------------------------------------------------------------------------------------------------------------
------------------------------------------------------------------------------------------------------------------------------------------------------
------------------------------------------------------------------------------------------------------------------------------------------------------
------------------------------------------------------------------------------------------------------------------------------------------------------
-----------------------------------S------------------------------------------------------------------------------------------------------------------
------------------------------------------------------------------------------------------------------------------------------------------------------
------------------------------------------------------------------------------------------------------------------------------------------------------
-----------------------------------------------------------------%------------------------------------------------------------------------------------
-----------------------------------%----------------------------C|------------------------------------------------------------------------------------
-----------------------------------|-----------------------------|-----------------------------------------------%------------------------------------
-----------------------------------|-----------------------------|-----------------------------------------------|------------------------------------
-----------------------------------|--------------------------g--|------%---------%------------------------------|-------------------%----------------
--------%%-------%--%%-%--------%--|%%-------------------%-%%---%|%-----|--%%-%---|-------------------------%-%--|-------------------|------%%------%-
--------||-------|--||-|---%----|--|||--%----------------|-||U--|||-----|--||-|---|---%------%%---%--%%-----|-|--|-------------------|-----%||------|-
%%%%%%%%||-%%%---|--||-|%%%|----|--|||%-|----%-----------|-||---|||-----|%-||-|---|---|------||---|--||---%-|-|-%|--%----%%-------%%-|----%|||------|-
||||||||||-|||XXX|XX||-|||||--XX|XX||||X|XXXX|XXXX-XXXXXX|X||XX-|||XXXXXX|X||-|-XX|XXX|XXXXXX||XXX|X-||XXX|X|X|-||XX|X-X-||XXXXX--||X|XX-X|X||XXX-X-|X