------------------------------------------------------------------------------------------------------------------------------------------------------
------------------------------------------------------------------------------------------------------------------------------------------------------
------------------------------------------------------------------------------------------------------------------------------------------------------
------------------------------------------------------------------------------------------------------------------------------------------------------
------------------------------------------------------------------------------------------------------------------------------------------------------
------------------------------------------------------------------------------------------------------------------------------------------------------
----------S-------------------------------------------------------------------------------------------------------------------------------------------
----------------------------t--------------------------------------------%----------------------------------------------------------------------------
----------------------------t--------------------------------------------|-----------------------------------------------------------T----------------
----------------------------t--%------------------------%----------------|-----------%-----------------------------------------------t----------------
----------------------------t--|--%%--------------------|%---------------|---k-------|-----------------------------------------------t%---------------
----------------------%-----%--|--||--------------------||---------------|---|-------|--------------------%--------------------------t|---------------
----------------%-----|-----|-%|--||S---------%%--------||%--------------|---|-------|-----------%------%%|------------------%%-%%-%-%|----------%----
---------------%|-----|-----|-||--||---%------||-%------|||---%----------|---|-----%-|---%-------|------|||--%---------------||-||-|-||---------%|---%
%%%%%%%%--%----||----%|-----|%||--||---|-%----||-|------|||--%|-------%--|---%----%|-|---|-------|------|||-%|--%------%%%---||-||%|-||---------||#-%|
||||||||-X|XXXX||XXXX||-XXX-X|X|X-||XXX|X|XXXX||-|X----X|||XX||XXXXXXX|XX|XXX|XXXX||-|-XX|XXX-XXX|XXXXXX|||X||XX|X-XXXX|||X-X||-||||X||XXXXX-XXX||X-||