------------------------------------------------------------------------------------------------------------------------------------------------------
------------------------------------------------------------------------------------------------------------------------------------------------------
------------------------------------------------------------------------------------------------------------------------------------------------------
------------------------------------------------------------------------------------------------------------------------------------------------------
------------------------------------------------------------------------------------------------------------------------------------------------------
----------------------------------------------------------------------------t-------------------------------------------------%-----------------------
---------------------------------------------------------------------------%t-------------------------------------------------|-----------------------
---------------------------------------------------------------------------|%-------------------------------------------------|-----------------------
---------------------------------------------------------------------------||-------------------------------------------------|-----------------------
----------%--------C----------------------%--------------------------------||-------------------------------------------------|---------------%%------
----------|-------------------------%-----|-------------%------------------||--------------------------%%---------------------|---------------||------
----------|-------------------------|-----|-------------|------------------||--------------------%%----||-------%-------------|-------------%%||----%-
----------|--%-%--%--%%-------------|----%|%%-%-%-%--%--|---%--------------||-----%--------------||---%||----%--|-%-%---------|------------%||||----|-
----------|-%|-|--|%-||---%-%-------|-%--||||-|-|%|--|-%|---|%-------------|%-%---|--------------||---|||--%-|--|-|-|---------|------------|||||---%|-
%%%%%%%%%-|-||-|--||-||---|-|-------|%|%%||||-|-|||-%|-||-%-||--%-------%--||-|%--|%%------------||---|||--|-|--|-|-|-%-------|---%--------|||||---||-
|||||||||X|X||-|-X||X||XXX|X|XXXXXXX|||||||||X|X|||X|XX||X|X|XX-|-----XX|-X||X||XX|||XXX---X-XXX-||X-X|||X-|X|XXX-|X|X|-----XX|XXX|XXX--XXX|||||---||X