------------------------------------------------------------------------------------------------------------------------------------------------------
------------------------------------------------------------------------------------------------------------------------------------------------------
------------------------------------------------------------------------------------------------------------------------------------------------------
------------------------------------------------------------------------------------------------------------------------------------------------------
------------------------------------------------------------------------------------------------------------------------------------------------------
------------------------------------------------------------------------------------------------------------------------------------------------------
------------------------------------------------------%---------------------------------------%-------------------------------------------------------
------------------------------------------------------|---------------------------------------|-------------------------------------------------------
------------------------------------------------------|---------------------------------------|-------------------------------------------------------
------------------------------------------------------|---------------------------------------|-------------------------------------------------------
------------------------------------------------------|---------------------------------------|--------------------%----------------------%-----------
-----------------------%------------------------%-----|---------------------------------------|%-------------------|----------------------|-----------
-----------------%%--%%|-----%------------------|-----|--%----%----%------------------%---%---||---%%G--%%------%--|---%%------%%-----%%--|-----------
-------------%---||--|||-----|------------------|-----|-%|----|--%-|--%---------%---%-|---|---||%%-||%--||------|-%|---||------||-----||-%|%--2-%----%
%%%%%%%%-%%%-|---||%-|||-%%--|--%%%%%%--%-------|-----|%||----|--|-|--|---------|-%-|-|---|--%||||-|||-%||------|-||---||-%--%-||%---%||%|||----|-%--|
||||||||X|||X|-X-|||X|XX-||XX|XX||||||XX|X-XXX-XX-XXXX||X|XX--|--|-|XX|XXXXXXXX-|X|X|X|XXXXXX||XXXX|XXX|||XX----|-||XXX||X|X-|X|||X-X|||||||XXXX|X|--|