------------------------------------------------------------------------------------------------------------------------------------------------------
------------------------------------------------------------------------------------------------------------------------------------------------------
------------------------------------------------------------------------------------------------------------------------------------------------------
------------------------------------------------------------------------------------------------------------------------------------------------------
------------------------------------------------------------------------------------------------------------------------------------------------------
------------------------------------------------------------------------------------------------------------------------------------------------------
-------------%----------------------------------------------------------------------------------------------------------------------------------------
-------------|----------------------------------------------------------------------------------------------------------------------------------------
-------------|----------------------------------------------------------------------------------------------------------------------------------------
-------------|----------------------------------------%-----------------------------------------------------------------------------------------------
-------------|-----------%----------------------------|-------------T-----------------------------------------%------------%--------------------------
-------------|-----------|----------------------------|-------------t------------------------------%--#-------|------------|----------------%---------
-------------|---%-----%-|----------------%-----------|----------%%%t-----------------%----%------%|--%-----%%|--%---------|%-------------%-|---------
-------------|---|-%%%%|-|--------%----%-%|---%----%-%|--%-------|||t----%------%-%---|----|-----%||--|-----|||--|---------||------%%-----|%|--------%
%%%%%%%%-----|---|-|||||-|%-----%-|%%--|-||---|----|-||--|%%-%---|||%----|--%---|-|-%-|----|-%---|||--|%----|||--|--%------||%----%||%----|||--------|
||||||||XXX--|X--|-|||||X||-XXXX|X|||XX|X||XXX|---X|X||XX|||X|XXXXX||-XXX|--|XXX|-|X|X|X-XXXX|XX-|||-X||-X--|||XXX-X|XXXXXX|||XXX-||||XX-X||XXXXX-XXX|