------------------------------------------------------------------------------------------------------------------------------------------------------
------------------------------------------------------------------------------------------------------------------------------------------------------
------------------------------------------------------------------------------------------------------------------------------------------------------
------------------------------------------------------------------------------------------------------------------------------------------------------
------------------------------------------------t-----------------------------------------------------------------------------------------------------
------------------------------------------------t------------------------------------------------------------------------------------%----------------
------------------------------------------------t------------------------------------------------------------------------------------|----------------
------------------------------------------------%-----------------------------------------------------------D------------------------|----------------
------------------------------------------------|--------------D---------------------------------------------------------------------|----------------
------------------------------------------------|--------------------------------------------------------------%---------------------|----------------
---------%--------------------------------------|------------------S------------------------%----C----------D--|----2----------------|-----%--%%-%%--%
---------|--------------------------------------|--------------S----------------------------|------------------|-%-------------------|-----|--||-||--|
---------|-----%----%---%%-%-%-%--%%---------%--|-%-----%---%%%-----%-------------%---------|-%----------------|-|-%---------------%%|-----|--||-||--|
---------|-----|---%|---||-|-|%|--||--%%-%---|-%|-|--%--|---|||r----|-------------|---------|-|----%----%---%%-|-|-|--%%-----%-%---|||-----|-%||-||%-|
%%%%%%%%%|-----|--%||---||-|%|||--||--||%|---|-||-|--|--|---|||%--%%|------%%--%--|---------|%|--%-|----|---||-|-|-|%-||-----|-|---|||-%--%|-|||-|||%|
||||||||||XXXXX|X-|||X--||XX||||X-||-X||||XX-|X||X|XX|-XX-XX|XX|X-|||XX--X-||-X|--|XXXXXXXXX||XXX|-|XXXXXXXX||X|X|X||X||XXXXX|X|-XX|||X|XX||X|||X|||||