------------------------------------------------------------------------------------------------------------------------------------------------------
------------------------------------------------------------------------------------------------------------------------------------------------------
------------------------------------------------------------------------------------------------------------------------------------------------------
------------------------------------------------------------------------------------------------------------------------------------------------------
------------------------------------------------------------------------------------------------------------------------------------------------------
------------------------------------------------------------------------------------------------------------------------------------------------------
------------------------------------------------------------------------------------------------------------------------------------------------------
----------------------%-------------------------------------------------------------------------------------------------------------------------------
----------------------|-------------------------------------------------------------------------------------------------------------------------------
----------------------|------------------------------------------------------------------------------------------------------%------------------------
----------------------|-----------------------%-t--------------------------------------------------------------%-------------|----%-------------------
----------------------|-----------------------|-t---------------------%----------------------------------------|-------------|----|------------%------
----------------------|-%--------%-----------%|%t----%--%-----%-------|---------%----%-%-%-------%-------------|-----------%-|----|------%-----|-%--%-
-----------------%-%--|-|------%-|-----------|||%----|--|-----|-------|---%--%%-|-%--|-|-|---%---|--%-------%--|--%%-------|-|---%|-%----|-----|-|--|-
%%%%%%%%%--%--%--|-|--|-|------|-|-----------||||---%|-%|-%---|-%%----|---|--||-|-|--|-|-|-%-|%--|%-|----%%-|%%|--||-------|-|---||%|--%-|-----|-|%-|-
|||||||||--|XX|-X|X|XX|X|XXX-XX|X|X-XXXXXXX-X||||--X||X||X|X-X|-||XXXX|XXX|XX||XXX|XX|X|X|X|X||XX||X|XXXX||X||||XX||--XXXX-|X|X-X||||XX|X|XXXXX|X||-|X