------------------------------------------------------------------------------------------------------------------------------------------------------
------------------------------------------------------------------------------------------------------------------------------------------------------
------------------------------------------------------------------------------------------------------------------------------------------------------
------------------------------------------------------------------------------------------------------------------------------------------------------
------------------------------------------------------------------------------------------------------------------------------------------------------
------------------------------------------------------------------------------------------------------------------------------------------------------
------------------------------------------------------------------------------------------------------------------%-----------------------------------
------------------------------------------------------------------------------------------------------------------|-----------------------------------
----------------%-------------------------------------------------------------------------------------------------|---------------------------------g-
----------------|-----------------------------------------%%---------------------%--------------------------------|-----------------------------------
----------------|-----------------------------------------||---------------------|--------------------------------|-----------------------------------
----------%-----|----------------------------%------%-----||---------------------|--------------------------------|-------------------%---------------
----------|-----|----%---------------------%-|------|%---%||%------%--------%----|------%---%----%-%-----%------%-|-------------------|---------------
----------|-----|----|--%------------------|-|--%%--||2--||||------|--------|----|--%---|-%-|----|-|----%|%---%-|-|-------------------|----------%%2--
%%%%%%%%%-|-----|----|--|-----%%%------%%%%|-|--||--||---||||-%%-%%|%-------|-%--|--|---|-|-|----|%%---%|||%--|%|-|-------------------|---------%||---
|||||||||XXXX--X|XXXX|-X|XXXXX|||XXXX--|||||-XXX||-X||X-X||||X||-||X|XXXXXXX|X|-X|XX|X-X|X|X|XXXX|||XXX|||||-X|||X|X-XXXXXXXXXXXXXXXXXX--XXXXXXX||XX-X