------------------------------------------------------------------------------------------------------------------------------------------------------
------------------------------------------------------------------------------------------------------------------------------------------------------
------------------------------------------------------------------------------------------------------------------------------------------------------
------------------------------------------------------------------------------------------------------------------------------------------------------
------------S-----------------------------S-----------------------------------------------------------------------------------------------------------
------------------------------------------------------------------------------------------------------------------------------------------------------
---------------------------------------------------------------------------------------------------------------------------#--------------------------
---------------------------------------------------------------------------------------------------------------------------%--------------------------
------------------------------------------D--------------------------------------------------------------------------------|--------------------------
--------------------------------------------------------------------------------------%------------------------------------|--------------------------
------------%----------------------------------------%------g-------------------------|------------------------------------|--------------------------
------------|----------------------------C%----------|------------------%-------------|------%-----%-----------------------|-----------%--------------
-----------%|-%----%---%---------%-----%--|%---------|-%-%%%--%----%%---|-------------|--%---|-----|--------------%%-%%%%--|-----------|--------------
-----------||-|----|--%|------%%-%%%--%|--||---%-----|-|-|||--|--%%||---|---%--%---%-%|--|---|---%-|--------%-%---||-||||--|%----------|----%---------
%%%%%%%%%%%||%|%-%-|--||------||%|||-%||%-||---|--%--|-|-|||%-|--||||--X|-%%|--|---|-||--|%%-|---|%|--------|-|-%-||-||||%-||----------|----|-------%%
||||||||||||||||X|-|XX||XX---XX||X||X|X||X||X-XXXX|XX|-|X||||X|XX||||-XX|-|||XX|XXX|-||XX|||X|XXX||XXXXXXXXX|X|X|-||X|||||X||X-X--XX--X|XX--|----XXX||