------------------------------------------------------------------------------------------------------------------------------------------------------
------------------------------------------------------------------------------------------------------------------------------------------------------
------------------------------------------------------------------------------------------------------------------------------------------------------
------------------------------------------------------------------------------------------------------------------------------------------------------
------------------------------------------------------------------------------------------------------------------------------------------------------
------------------------------------------------------------------------------------------------------------------------------------------------------
------------------------------------------------------%-----------------------------------------------------------------------------------------------
------------------------------------------------------|---------------%-------------------------------------------------------------------------------
------------------------------------------------------|---------------|----------t--------------------------------------------------------------------
------------------------------------------------------|---------------|----------t------%--------------------------------------------%----------------
---------------------------------%--------------------|----------%----|----------%%----%|---------------%-------------%-------------%|----------------
---------------------------------|--------------------|-%--------|----|----------||----||---------------|-----------%-|-------------||----------------
----------U-%---%%%%--------%----|-------%%-----%%----%%|------%-|----|----%----%||--%-||-------%-------|------%----|-|----%--------||----------------
------------|---||||--------|----|------%||-----||----|||%-----|-|----|--%-|---%|||-%|-||-------|-------|------|-%--|-|----|-%----#%||----------------
%%%%%%%%%---|---||||--%%%%%%|--%-|------|||-----||----||||-----|%|--%%|--|-|---||||-||-||---%%--|%-%-%--|------|-|--|-|-%--|-|%-%-%|||----%%%---------
|||||||||-XX|XX-||||XX|||||||-X|-|-XXXXX|||-X--X||X-XX|XX|XXXXX|||XX|||-X|X|XXX||||X||X||XX-||XX||X|X|--|-----X|X|XX|X|X|--|-||X|X||||-XX-|||XXXXXXXXX