------------------------------------------------------------------------------------------------------------------------------------------------------
------------------------------------------------------------------------------------------------------------------------------------------------------
------------------------------------------------------------------------------------------------------------------------------------------------------
------------------------------------------------------------------------------------------------------------------------------------------------------
------------------------------------------------------------------------------------------------------------------------------------------------------
---------------------------------------------------------------------------------------------------------------------------------%--------------------
---------------%-----------------------------------------------------------------------------------------------------------------|------%-------------
---------------|-----------------------------------------------------------------------------------------------------------------|------|-------------
---------------|-----------------------------------------------------------------------------------------------------------------|------|-------------
---------------|-----------------------------------------------------------------------------------------------------------------|------|-------------
---------------|-------------------------------------------------------#-----%-----------S------%-----------------%--------------|------|-------------
------------%%-|----%--------#-----------------------%---%--%----------#-----|------------------|-----------------|--------------|------|-------------
------------||-|---%|--------%-%---------------------|--%|--|%%%-------#-----|----%--%--------%%|-----------------|----------%---|------|-------------
----------%-||-%---||------%-|-|--%--%%-----%--------|%-||-%||||-----%%%%%---|--%-|--|---%%%--|||-----%-----------|-%--------|-%-|------|--%----------
%%%%%%%%--|-||-|%-%||-%-%-%|-|-|--|--||--%%-|-%--%--%||-||-|||||----%|||||-%-|--|-|--|-%-|||--|||----%|%---%------|-|--------|-|-|------|--|----------
||||||||XX|X||-||X|||-|-|-||X|X|XX|XX||XX||-|-|XX|-X|||X||X|||||XXXX||||||X|X|--|X|XX|X|-|||XX||X-XXX|||XX-|-XXXXX|X|XXXXXXXXX-|-|XXXX-X|XX|XXXXXX-XXX