------------------------------------------------------------------------------------------------------------------------------------------------------
------------------------------------------------------------------------------------------------------------------------------------------------------
------------------------------------------------------------------------------------------------------------------------------------------------------
------------------------------------------------------------------------------------------------------------------------------------------------------
------------------------------------------------------------------------------------------------------------------------------------------------------
------------------------------------------------------------------------------------------------------------------------------------------------------
------------------------------------------------------------------------------------------------------------------------------------------------------
--------------------------------D---------------------------------------------------------------------------------------------------------------------
------------------------------------------------------------------------------------------------------------------------------------------------------
------------------------------------------------------------------------------------------------------------------g-----------------------------------
-----------------------------------------------------%----------------------S----------%-------S----------------------%--------------------------%----
-----------------------------------------------------|---------------------------------|----%-------------------------|------------%---r---------|----
----------------%--%--%------------------------------|--------%-%-%-----------%%-------|----|------%------------------|---%--------|%--%-------%-|----
-------------%%-|--|%-|---%%----%-%-----------%-----%|---%----|-|-|-----------||---%%--|----|------|%%--------------%-|-%-|--------||--|--%%---|-|---%
%%%%%%%%-%--%||-|--||-|%--||----|-|-----------|%----||---|---%|-|-|----%%---%-||---||--|%%%-|%-%%%-|||---%-----%-%--|-|%|-|--------||--|%%||---|-|%%%|
||||||||X|--|||X|XX||X||XXX|X-XX|X|X--XXX-XXXX||XXXX||-XX|--X|XX|X|-XXX||X--|-||XX-||XX||||-||-|||X|X|XXX|X-XXX|X|-X|X|||X|XXXXXXXX||XX|||||-XX|-||||X