------------------------------------------------------------------------------------------------------------------------------------------------------
------------------------------------------------------------------------------------------------------------------------------------------------------
------------------------------------------------------------------------------------------------------------------------------------------------------
------------------------------------------------------------------------------------------------------------------------------------------------------
------------------------------------------------------------------------------------------------------------------------------------------------------
------------------------------------------------------------------------------------------------------------------------------------------------------
------------------------------------------------------------------------------------------------------------------------------------------------------
------------------------------------------------------------------------------------------------------------------------------------------------------
--------------------------------------------------------------------------------------------------%---------------------------------------------------
--------------------------------------------------------------------------------------------------|---------------------------------------------------
--------------------------------------------------------------%-%-------------------------D-------|---------------------------------------------------
---------------------------%----------------------------------|-|%--------------------------------|---------------------------------------------------
------------------------%--|--------%--------------%----%-%---|-||-%%-------%--%------------------|-----------%---------------%%--%%----------%---%-%-
---------%-----------%--|--%--------|--------------|%-%-|-|---|-||-||-------|--|---------%---%-%-%%%%---------|------%--------||%-||----------|-%%|-|-
%%%%%%%%%|%-----%%-%%|--|-X|%--%----|---------%----||-|-|-|%-%|-||-||----%--|--|-------%%|%--|-|-||||---------|-%%%--|-----%X-|||-||%---------|-|||-|-
|||||||||||XXXX-||X|||XXXXX||XX|XXXX|XXXXXXXXX|XXXX||-|-|X||X||X||X||XXX-|-X|XX|X-XX--X||||-X|X|X||||XXXX--XXX|X|||--|XXXX-|XX|||X|||----XXXXX|-|||X|X