------------------------------------------------------------------------------------------------------------------------------------------------------
------------------------------------------------------------------------------------------------------------------------------------------------------
------------------------------------------------------------------------------------------------------------------------------------------------------
------------------------------------------------------------------------------------------------------------------------------------------------------
------------------------------------------------------------------------------------------------------------------------------------------------------
------------------------------------------------------------------------------------------------------------------------------------------------------
------------------------------------------------------------------------------------------------------------------------------------------------------
------------------------------------------------------------------------------------------------------------------------------------------------------
------------------------------------------------------------------------------------------------------------------------------------------------------
-----------------------------------------------------------------------------------------------------------------------%------------------------------
-----------------------------------------------------------------------------------------------------------------------|----%-------------------------
----------------------------------------------------%------------------------------------------------------------------|----|-------------------------
-------------------------%%----------------%-%------|%-------%--%----%%%-%%%%--%%---%-%%---%%--%-------%---------------|----|----%------%%------------
-----------------%-------||----%-----------|-|------||-----%-|--|----|||-||||--||---|-||%--||--|-------|%------%----%%-|--%-|%---|%-----||------------
%%%%%%%%%--%-----|------%||----|--%---%%---|-|------||-----|%|--|----|||-||||--||-%-|%|||%%||-%|-------||--%%--|----||-|--|-||---||--%--||----%-%%%%%-
|||||||||XX|XXXXX|XXXXXX|||XXXXXXX|--X||--X|-|XXXXXX||XX-XX||XXX|XXXX|||-||||XX||X|X|||||||||X||XXXXXXX||XX||XX|XXXX||X|XXXX||-XXX|XX|XX||--XX|X|||||X