------------------------------------------------------------------------------------------------------------------------------------------------------
------------------------------------------------------------------------------------------------------------------------------------------------------
------------------------------------------------------------------------------------------------------------------------------------------------------
------------------------------------------------------------------------------------------------------------------------------------------------------
------------------------------------------------------------------------------------------------------------------------------------------------------
------------------------------------------------------------------------------------------------------------------------------------------------------
------------------------------------------------------------------------------------------------------------------------------------------------------
------------------------------------------------------------------------------------------------------------------------------------------------------
----------------%--------------------------------------------------------------------------------------------------------------------------------%----
----------------|------------------------------------%-----------------------------------------------------------------------C-------------------|----
----------------|------------------------------------|---------------%---------------------------------------------------------------------------|----
----------------|-----------%------------------------|--k------------|------%--------------------------%----------------------------------------%|----
----------------|%----------|---%-----------%%-------|--|-%%---------|%--%%-|----------%%%-----%-------|-%--------%------------%---------%------%|----
---------%%-----||--%%%-----|---|%%--------%||-%%---%|%-|-||---------||--||-|%---------|||-----|-------|-|--------|-%--------%-|--%%---%-|---%--||----
%%%%%%%%-||-----||%-|||%----|---|||-----%%%|||-||%--|||-|%||---------||--||-||----%-%%%|||-----|%%-----|-|----%%-%|-|--------|-|--||---|-|---|--||-%--
||||||||-||XXXX-|||X||||--XXXXXXX||X--XX||||||X|||-X|||XX|||XX-XXXX--||XX||-X|X---|X||||||-XXXX|||XXX-X|-|XXXX||X||X|XXXXXXXX|X|XX||XX-|-|XXX|XXX|-|--