------------------------------------------------------------------------------------------------------------------------------------------------------
------------------------------------------------------------------------------------------------------------------------------------------------------
------------------------------------------------------------------------------------------------------------------------------------------------------
------------------------------------------------------------------------------------------------------------------------------------------------------
------------------------------------------------------------------------------------------------------------------------------------------------------
-----------------------S------------------------------------------------------------------------------------------------------------------------------
------------------------------------------------------------------------------------------------------------------------------------------------------
------------------------------------------------------------------------------------------------------------------------------------------------------
-----------------------------------------------------%-------------------------------------------------%----------------------------------------------
-----------------------------------------------------|-------------------------------------------------|--------------------------------%-------------
-----------------------------------------------------|-------------------------------------------------|---------------%----------------|-------------
--------------------%--------------------------------|-------------------%--------------------------%--|---------------|----------------|----%--------
----------%---------|--%--%--------%----%%%-----%%%--|-------------------|%-------%-%----%-%----%%%-|--|-------2-----%%|---------------%|----|--------
----------|F----%---%--|--|--------|-%--|||-%--%|||--|-------------%---%-||------%|-|----|-|%---|||%|--|--------%----|||---%-%--------g||---%|--------
%%%%%%%%%-|%%%-%|---|--|%-|--------|-|--|||-|-%||||--|-%----------%|%--|-||%-%---||-|----|-||---|||||--|%%--%%--|----|||---|-|----%----||---||-------%
|||||||||X||||X||--XX-X||-|XX-XXXXX|XXXX|||XX-|||||XX|X|XXXXXXXXXX|||XX|XX||-|XXX||X|X-XX|-X|XXX||||XXX|||-X||XX|XX-X|||XXX|X|-X-X|XX--||-XX||XXXXXXX|