------------------------------------------------------------------------------------------------------------------------------------------------------
------------------------------------------------------------------------------------------------------------------------------------------------------
------------------------------------------------------------------------------------------------------------------------------------------------------
------------------------------------------------------------------------------------------------------------------------------------------------------
------------------------------------------------------------------------------------------------------------------------------------------------------
------------------------------------------------------------------------------------------------------------------------------------K-----------------
-------------------------------------------------------------------------------------------%----------------------------------------------------------
-------------------------------------------------------------------------------------------|----------------------------------------%-----------------
-------------------------------------------------------------------------------------------|----------------------------------------|-----------------
-----------------------%------------------C------------------------------------------------|----------------------------------------|-----------------
-----------------------|-------------------------------------------------------------------|----------------------------------------|-----------------
-----------------------|----------------%--------------------------%-----------------------|----%------------------#----------------|-----------------
---------%-------------|----------%----%|---%%%%%---------------%%-|-------------------%---|-%--|%%--%-----------%-%---%--------%---|-----------------
---------|%------------|------%%--|----||%%-|||||------------%--||-|--------------%----|---|-|--|||--|-----------|-|---|---%----|%--|--%%-------t%--%-
%%%%%%%%-||----%%----X-|%---%-||%%|---%||||-|||||---%---%----|--||-|--------------|----|---|-|--|||--|--%%%%-----|-|---|---|----||--|--||-------t|%-|-
||||||||-||XXXX||XXXXXX||-XX|X|||||XXX|||||X|||||X--|--X|--XX|XX||X|XX--XXXXXX-XXX|XXXX|XXX|X|X-|||XX|X-||||XXXXX|-|XXX|X--|XXXX||-X|--||XXXXXXXX||X|X