------------------------------------------------------------------------------------------------------------------------------------------------------
------------------------------------------------------------------------------------------------------------------------------------------------------
------------------------------------------------------------------------------------------------------------------------------------------------------
------------------------------------------------------------------------------------------------------------------------------------------------------
------------------------------------------------------------------------------------------------------------------------------------------------------
----------------------------------------------------------------------------------------------------------------------------------------------%-------
-----------------------------------------------------------------------------------------------------------------y----------------------------|-------
--------------------------------------------------------------------------------%--------------------------------%----------------------------|-------
-------------------------------------------S------------------------------------|--------------------------------|----------------------------|-------
--------------------------------------------------------------------------------|--------------------------------|----------------------------|-------
----------------------%%--------------------------------------------------------|------------y-------------------|----------------------------|-------
-------------------%--||--------------------------------%-----%----%%-----------|------------%-k-----------------|-----------------------%----|-------
-------------------|--||----%%---%%--------%------------|-%---%----||%--%%------|------------|%%%%---%-----------|-----------------------|-%%-|-------
-------------------|--||---%||---||---%----|%-----%%%--%|-|%--|%---|||--||---%%-|%---%-%%----|||||---|--------%--|------------------%%---|-||-|-------
%%%%%%%%---%%--%---|--||---|||---||---|----||-----|||--||-||--||---|||%%||--%||-||---|-||--%-|||||%%%|%%---%--|--|--------------%%%-||-%%|-||-|-------
||||||||XX-||XX|XXXXXX|X--X|||--X||XXX|XX-X||XXXXX|||--||X||X-X|XXX|||||||XX|||X||X-X|X||-X|X||X||||||||XXX|XX|-X|XXXXXX-XX-XXXX|||X||X|||X||X|-XXXXXX