------------------------------------------------------------------------------------------------------------------------------------------------------
------------------------------------------------------------------------------------------------------------------------------------------------------
------------------------------------------------------------------------------------------------------------------------------------------------------
------------------------------------------------------------------------------------------------------------------------------------------------------
------------------------------------------------------------------------------------------------------------------------------------------------------
------------------------------------------------------------------------------------------------------------------------------------------------------
---------------------------------------------------------------------------------------------------------------------%--------------------------------
---------------------------------------------------------------------------------------D-----------------------------|--------------------------------
---------------------------------------------------------------------------------------------------------------------|--------------------------------
----------------------------------------------------------t----------------------------------------------------------|--------------------------------
-------------%------g-------------------------------------t----------------------------------------------------------|%-------------------------------
-------------|--------------------%-----------------------%-------------------------------------------------------%--||---------------------------%---
------------%|--------------------|%--%-----------%%------|-----------%-----%-%--%%-----%-%%---------%%%-%%--%----|--||%%---%---------------------|%%-
-----------%||%-------------------||-%|-----------||%-----|-----------|-----|-|--||----%|-||%-------%|||%||%-|-%--|--%|||---|-------%-------------|||-
%%%%%%%%---||||-----%-------------||-||-----------|||----%|%%--%%-----|%----|-|--||-%--||%|||-%--%%-||||||||-|-|--|-%||||%%-|---%%--|-%-%%--------|||-
||||||||XXXX|||XXXXX|XXXXXXXXX-XXXX|-|XXXXXXXXX-X-|||X--X||||X-||X-X-X||XXXX|X|XX||X|XX||||||-|XX||-||||||||-|X|XX|X|||||||XXXXX||XX|X|X||XXXXXXXXX||X