------------------------------------------------------------------------------------------------------------------------------------------------------
------------------------------------------------------------------------------------------------------------------------------------------------------
------------------------------------------------------------------------------------------------------------------------------------------------------
------------------------------------------------------------------------------------------------------------------------------------------------------
------------------------------------------------------------------------------------------------------------------------------------------------------
------------------------------------------------------------------------------------------------------------------------------------------------------
------------------------------------------------------------------------------------%-----------------------------------------------------------------
-------------------------%----------------------------------------------------------|--------------------------------------------------D--------------
-------------------------|----------------------------------------------------------|-----------------------------------------------------------------
-------------------------|-------t--------------------------------------------------|------------------------------------%----------------------------
-------------------------|-------t-------------g--------------------%---------------|------------------------------------|----------------------------
-----------%%----------%%|-------t%---------------------------------|---------------|------------------------------------|-----%--------------%-------
-----------||------%---|||%-%----%%--------------------------%------|%---%----------|%------%---------%%%%%-%%----%------|--%--|%-------------|-------
---------%-||-%--%-|---||||-|----||--------------------%---%-|------||--%|----------%|-%----|---------|||||%||--%-|-----%|--|-%||----%%%-----%|------%
%%%%%%%%-|%||-|--|-|%--||||-|---%||%-----------%---%%--|%--|%|%-----||--||%----%%%--||-|----|---------||||||||--|-|-----||--|-|||%%%-|||-----||-----%|
||||||||-||||X|XX|-||XXX|||X|XXX||X|XXXXXXX-X--|X-X||XX||XXX|||XXX-X||XX|||X---|||XX|XX|XXXX|XXXXXXXX-X|||||||--|X|XXXXX||XX|X||||||-|||-X-XX|XXXX--||