------------------------------------------------------------------------------------------------------------------------------------------------------
------------------------------------------------------------------------------------------------------------------------------------------------------
------------------------------------------------------------------------------------------------------------------------------------------------------
------------------------------------------------------------------------------------------------------------------------------------------------------
---------------------------------------------------------------------------------------------------------------------------------------------------S--
------------------------------------------------------------------------------------------------------------------------------------------------------
------------------------------------------------------------------------------------------------------------------------------------------------------
-----------------------------------------------%--------------------------------------------%-----------------------------------------%---------------
-----------------------------------------------|--------------------------------------------|-----------------------------------------|---------------
------------%----------------------------------|--------------------------------------------|-----------------------------------------|---------------
------------|--------------%--------------%----|--%-----------------------------------------|-----------------------------------------|------------%--
------------|--------------|--------------|----|--|-%%---g------------------------%C--------|--%--------------------------------------|---------%--|--
------------|-%-----%------|--------------|--%-|--|-||----------------------------|---------|--|-%%-------------%%--%%----------------|-------%-|--|--
------------|-|--%--|------|---------%%%--|-%|-|--|%||------%---------------------|---------|--|-||-----%---%---||%-||--------%-%-----%-----%-|%|%-|--
%%%%%%%%----|-|--|--|---%--%-----%---|||--|-||-|--||||------|%%%-%----%----%------|-------%-|--|-||%---%|---|%-%|||-||-%%-%---|-|-----|%----|-||||-|--
||||||||XXXX|-|-X|-X|XXX|XX|XX--X|--X|||XX|X||-|XX||XX-XXXXX||||X|XXXX|X-X-|XXXXXX|X-XX---|X|X-|-|||XXX||XXX||X||||-||X||-|-XXXX|--XXX||-XXX|X||||X|XX