------------------------------------------------------------------------------------------------------------------------------------------------------
------------------------------------------------------------------------------------------------------------------------------------------------------
------------------------------------------------------------------------------------------------------------------------------------------------------
------------------------------------------------------------------------------------------------------------------------------------------------------
------------------------------------------------------------------------------------------------------------------------------------------------------
-----------------------------------------------------------------------------------D------------------------------------------------------------------
------------------------------------------------------------------------------------------------------------------------------------------------------
------------------------------------------------------------------------------------------------------------------------------------------------------
-----------------------------------------------------------------------%-----------t------------------------------%-----------------------------------
-----------%-------#------------------S-----------------------------%--|-----------t---------------------------%--|---------------------------------T-
-----------|-------#------------------g-----------------------------|--|-----------t%--------------------------|--|---------------------------------t-
-----------|------%#-------------------%--S---------------%---------|--|-----------%|----%%---------------%----|--|---------%%-------------------%--t%
-----------|---%%%|%%---%%%------------|-----------------%|-------%-|--|------%--U-||-%%-||---------------|----|--|-----%---||----------%-------%%--%|
-----------|---||||||---|||-%----------|-----%-%--%------||-------|%|--|-----%|----||-||-||---------------|#-%-|--|----S|%--||-------%%-|-------||--||
%%%%%%%%---|---||||||%%-|||-|---------%|-----|-|--|------||-%-%---|||--|-----||----||-||-||%----%---------|%-|%|%%%-----||%-||-------||-|---%%%-||--|%
||||||||-XX|XXX||X|||||X|||X|-XXXXXXX-||-XXXX|X|-X|XX---X||X|X|-X-|||XX|XXX-X||XXXX||X|X-XX|-XXX|X-XX-XXXX||X||||||X-XXX|||X|XXXX--XX||X|XXX|||X||XXX|