------------------------------------------------------------------------------------------------------------------------------------------------------
------------------------------------------------------------------------------------------------------------------------------------------------------
------------------------------------------------------------------------------------------------------------------------------------------------------
------------------------------------------------------------------------------------------------------------------------------------------------------
-----------------------------------------------------------------------------------------------#------------------------------------------------------
-----------------------------------------------------------------------------------------------#------------------------------------------------------
-----------------------------------------------------------------------------------------------#------------------------------------------------------
-----------------------------------------------------------------------------------------------%---------%--------------------------------------------
-----------------------------------------------------------------------------------------------|---------|--------------------------------------------
---------------------------------------------------------------------------------------%-------|---------|--------------------------------------------
---------------------------------------------------------------------------------------|-------|---------|--------------------------------------------
-------------------------------------------------------%-------------------------------|-------|-----%%--|---------------------------------%----------
-------------%%-----------%--------------%-------------|-----%-----%---%%%--%---%---%-%|----%%-|---%-||--|-------------%----%%-%-%%%%------|----------
----------%%-||-----------|------%-------|-------%-----|--%%-|-%---|---|||--|%--|---|-||----||-|---|-||%-%-------------|----||%|-||||------|----------
%%%%%%%%%-||-||---%---%-%-|----%-|-------|-------|-----|--||-|-|---|---|||--||--|---|%||--%%||-|---|-|||-|-----%-------|----||||-||||------|----------
|||||||||X||X||XXX|XXX|X|-|-XXX|X|XXXXXXX|XXXXXXX|X----|XX||-|-|XXX|XXX|||X-||--|XXX||||XX||||X|--X|-XX|X|XXX-X|XX-XXXX|XX--||||X||||XX--XXXXXXXXXXXXX