------------------------------------------------------------------------------------------------------------------------------------------------------
------------------------------------------------------------------------------------------------------------------------------------------------------
------------------------------------------------------------------------------------------------------------------------------------------------------
------------------------------------------------------------------------------------------------------------------------------------------------------
-----------------------------------------------------------------------------------------------------D------------------------------------------------
------------------------------------------------------------------------------------------------------------------------------------------------------
--------------------------------------------------D--------------------------------------------------k------------------------------------------------
-----------------------------------------------------------------------------------------------------%------------------------------------------------
---------------------------------------------------------%-------------------------------------------|--------2-------------------------------------%-
---------------------------------------------------------|-------------------------------------------|--------k-------------------------------------|-
---------------------------------------------------------|-------------------------------------------|---------------------%------------------------|-
----------------------------%----------------------------|-------%-----------------------------------|---------------------|-----%--------g%--------|-
-------------S--------------|---------------------%------|-------|-----------------------------------|---------------------|-----|----%-%--|------%-|-
---------%------------------|-------------------%-|------|---%---|---------%--------------%%%--------|--------%----------%%|-g---|----|-|--|------|-|%
%%%%%%%%-|--------------%---|--------------%%%--|-|%----%|---|%%-|---%-----|----%--%--%%--|||--%%%---|--------|---%------|||-----|%---|-|--|------|-||
||||||||X|XXXXXXXXXXXXX-|-X-|--XX-XXX-XXXXX|||-X|X||XXX-||XXX|||XX-XX|-X-XX|-X-X|--|XX||-X|||-X|||XXX|-XX-X-X-|XXX|XXXXX-|||XXXXXX|XXX|-|-XXX--X--|X||