------------------------------------------------------------------------------------------------------------------------------------------------------
------------------------------------------------------------------------------------------------------------------------------------------------------
------------------------------------------------------------------------------------------------------------------------------------------------------
------------------------------------------------------------------------------------------------------------------------------------------------------
------------------------------------------------------------------------------------------------------------------------------------------------------
------------------------------------------------------------------------------------------------------------------------------------------------------
--------------D-----------------------------------------------------------------------------------------------------------S---------------------------
-----------------------------------------------------------------------------------------2------------------------------------------------------------
------------------------------------------------------------------------%-----------------------------------------------------------------------------
--------------%---------------------------------------------------------|----------------------------------%-----%------------------------------------
--------------|-------------%------------------------------%------------|------------------------------%---|-----|-------%%---------------------------
--------------|-------------|------------------------------|-----%------|-%----------------------------|---|---%%|-------||---------------------------
-----------%%-|--%----%-%-%%|-%%--------G------------------|-%---|------|-|--%---%-----%%--%--%%-------|---|---||%---%---||----%-----------------%%---
---------%-||-|--|----|-|-|||-||%-------%-------%----------|-|---|--#---|-|-%|---|--%--||%-|--||-------|---|---|||-%%|%--||----|---%--------%----||-%-
%%%%%%%%-|-||-|%%|%%%-|-|-|||-|||-%-----|-------|---%------|-|%--|--%%%-|-|-||--%|-%|--|||-|--||--%%---|--%|-%%|||-||||%%||--%%|---|%-------|---%||-|-
||||||||X|X||-|||||||X|X|-|||-|||X|XX---|X-XXXXX|X-X|XXXXX-|X||-X|XX|||XXX|X|XXX||-||XX|||X|XX||X-||X--|XX||X|||||X|||X||||-X|||XX-||XX--X--|XXX|||X|-