------------------------------------------------------------------------------------------------------------------------------------------------------
------------------------------------------------------------------------------------------------------------------------------------------------------
------------------------------------------------------------------------------------------------------------------------------------------------------
------------------------------------------------------------------------------------------------------------------------------------------------------
------------------------------------------------------------------------------------------------------------------------------------------------------
---------------------------------------------------------------------------------------------------------------------------------------%--------------
---------------------------------------------------------------------------------------------------------------------------------------|--------------
--------------------------------------------------------------------------%------------------------------------------------------------|--------------
--------------------------------------------------------------------------|------------------------------%-----------------------------|--------------
------------------------------------------------%-------------------------|------------------------------|-----------%-----------------|--------------
------------------------------------------------|-------------------------|------------------------------|----------%|-----------------|-%------------
-------------------------------------------%----|-------%-----------------|-------------%----%-----------|----------||----------------%|-|------------
--------------%%--%-------%---------%%----%|--%-|-------|----#%--%%%------|---%%------%-|----|-------%---|%---------||----%-----------||-|------------
--------------||--|-----%-|U%%----%-||----||--|-|--%%---|%---#|--|||------|---|%--%%%-|-|----|-%-----|---||%-%-----%||----|---%G------||-|-%----------
%%%%%%%%-----%||--|%%%--|-|-||----|-||----||--|%|%-||%%-||--%%|--|||%--%--|--%||--|||%|-|-%--|-|-----|---|||-|%-%--|||----|---|%----%%||-|%|-----%%--%
||||||||XXXXX|||X-||||-XXX|X||XXXX|X||XXXXX|XX||||X||||X||XX|||XX||||-X|-X|XX|||XX||||XX|X|-XXX|XX--XX-X-|||X||-|-X|||-XX-|XXX||XX--||X|X|||XXXXX||X-|