------------------------------------------------------------------------------------------------------------------------------------------------------
------------------------------------------------------------------------------------------------------------------------------------------------------
------------------------------------------------------------------------------------------------------------------------------------------------------
------------------------------------------------------------------------------------------------------------------------------------------------------
------------------------------------------------------------------------------------------------------------------------------------------------------
------------------------------------------------------------------------------------------------------------------------------------------------------
------------------------------------------------------------------------------------------------------------------------------------------------------
---------------------------------------------------------------------------------t--------------------------------------------------------------------
---------------------------------------------------------------------%-----------t--------------------------------------------------------------------
---------------------------------------------------------------------|-----------%--------------------------------------------------------------------
---------------------------------------------------------------------|-----------|----------------------------------------------------------------%---
---------------------------------------------------------------------|-----------|-----------------------------%-----%----------------------------|---
--------------------%--------%-%----------%%%-----------%%%--%%------|--%--------|----------%---%--------------|-----|------------%----%%---%--%--|---
-----------g--------|-----%--|-|----------|||-----------|||--||------|--|%---%---|----------|---|-----%%-%--%--|-----|-----------%|-%--||---|%%|--|---
%%%%%%%%-%--------%-|-%---|%-|-|---%%%---%|||------%%---|||-%||%-----|--||%--|%--|---------%|%--|-----||-|--|%-|--%-%|%%%----%%%-||-|--||-%-||||%-|---
||||||||X|X-XXXXXX|X|-|-X-||-|XXXXX|||XXX||||XXXXXX||XXX|||X||||XXXXX|-X|||XX||XX|X--XXXXXX|||XX|X-X--||X|--||X|-X|X|||||-XXX|||X||-|XX||X|-|||||X|X--