------------------------------------------------------------------------------------------------------------------------------------------------------
------------------------------------------------------------------------------------------------------------------------------------------------------
------------------------------------------------------------------------------------------------------------------------------------------------------
------------------------------------------------------------------------------------------------------------------------------------------------------
------------------------------------------------------------------------------------------------------------------------------------------------------
------------------------------------------------------------------------------------------------------------------------------------------------------
------------------------------------------------------------------------------------------------------------------------------------------------------
-----------------------------------------------------------C------------------------------------------------------------------------------------------
----------------------------------------%----------------------------------------------------------------------------------%--------------------------
--------------%-------------------------|----------------------------------------------------------------------------------|--------------------------
--------------|-------------------------|----------------------------------------------------------------------------------|--------------------------
--------------|-------%---------%%%-----|------------------%-------%-------------------------------------------------------|-----------------------k--
-----------%%%|-------|%--------|||-%---|--%---------------|-%-----|--------------------%---%--%----------%-%----------%%%%%%------%----%----------|--
-----------||||-------||-------%|||-|---|--|-%----------%--|-|%----|------%---------%---|---|--|-%--------|-|----------||||||---%--|%---|----------|%-
%%%%%%%%%--||||%%%--%-||-------||||-|%-%|--|-|%---%%----|--|-||----|------|------%--|%%-|---|--|-|------%-|-|--------%-||||||---|%-||---|----------||-
|||||||||XX|||||||XX|X||XXXXXXX||||X||X||XX|X||---||-XX-|XX|X||XXXX|--X--X|X-XXXX|XX|||-|-XX|X-|-|XXXXXX|X|X|XXXXXXXX|X||||||-XX||-X|XX-|XXXXXXXXXXX|-