------------------------------------------------------------------------------------------------------------------------------------------------------
------------------------------------------------------------------------------------------------------------------------------------------------------
------------------------------------------------------------------------------------------------------------------------------------------------------
------------------------------------------------------------------------------------------------------------------------------------------------------
------------------------------------------------------------------------------------------------------------------------------------------------------
------------------------------------------------------------------------------------------------------------------------------------------------------
------------------------------------------------------------------------------------------------------------------------------------------------------
--------------------------%---------------------------------------------------------------------------------------------------------------------------
--------------------------|-------------------------------------------------------------------------------C-------------------------------------------
--------------------------|---------------------------------------------------------------------------------------------------------------------------
--------------------------|---------------------------------------------------------------------------------------------------------------------------
--------------------------|------------------------------------t-------------------------------------------------%------------------------------------
--------%---%%--%-%---%--%|---------------------%------%-------t--------%--%-------%%%---------%-%----%%%%%------|---%-%--------------%--%------------
--------|---||--|-|---|%-||--------------%-----%|------|-------t---%----|--|-------|||---------|%|----|||||--%---|---|-|%%%-----------|--|------------
%%%%%%%%|--%||--|-|%--||-||-----%-%------|-----||------|%%----%%%%-|----|--|----%%%|||%------%%|||-%%-|||||--|---|---|%||||-%%--------|-%|%--------%%-
|||||||||XX|||XX|X||-X||X||XXXXX|-|XXX--X|XXXXX||X--XXX|||--X-||||-XXXX-|XX|XXXX|||||||XXXXX-|||||X||X|||||XX|X--XX--||X|||-||-XX-XXXX|-|||XX--XXXX||X