------------------------------------------------------------------------------------------------------------------------------------------------------
------------------------------------------------------------------------------------------------------------------------------------------------------
------------------------------------------------------------------------------------------------------------------------------------------------------
------------------------------------------------------------------------------------------------------------------------------------------------------
-------------------------------------------------------------------------------%----------------------------------------------------------------------
-------------------------------------------------------------------------------|----------------------------------------------------------------------
-------------------------------------------------------------------------------|----------------------------------------------------------------------
------------------------------%------------------------------------------------|----------------------------------------------------------------------
------------------------------|------------------------------------------------|-----------D----------------------------------------------------------
------------------------------|---------------------------------%--------------|----------------------------------------------------------------------
------------------------------|-----------------%---------%-----|--------------|-------------------------------------------%--------------------------
---------------%--------------|-%---------------|---------|-----|-----%--------|-------------------------------------------|--------------------------
-------------%-|-------%----%-|%|------%---%----|--%---%%%|-----|-----|--%-----|%-----%%---%-------%-----%--%%---%%%-------|---%--%--%-----------y----
-------------|-|-------|----|-||%------|---|----|--|---||||%%%%%|-%%--|%-|--%--%|g----||---|---%---|-----|--||---|||%------|---|--|--|-%---------%%---
%%%%%%%%%----|-|%-%%---|----|-|||------|---|----|--|--%||||||||||-||--||-|--|--||-----||-%-|---|---|-----|--||---||||%--%%-|---|--|--|%|---------||---
|||||||||-XXXXX||-||XXX|XXXX|X|||-X-XXX|---|---X|XX|XX|||||||||||-||--||XXXX|XX||XX-XX||X|X|X-X|XXX|XXXXX|X-||XX-|||||X-||-|-X-|-X|XX|||--X-XXXXX||XXX