------------------------------------------------------------------------------------------------------------------------------------------------------
------------------------------------------------------------------------------------------------------------------------------------------------------
------------------------------------------------------------------------------------------------------------------------------------------------------
------------------------------------------------------------------------------------------------------------------------------------------------------
------------------------------------------------------------------------------------------------------------------------------------------------------
----------%-------------------------------------------------------------------------------------------------------------------------------------------
----------|-------------------------------------------------------------------------------------------------------------------------------------------
----------|-------------------------------------------------%-----------------------------------------------------------------------------------------
----------|-------------------------------------------------|-----------------------------------------------------------------------------------------
----------|-------------------------------------------------|-----------------------------------------------%-------------------------------------%---
----------|-------t-------%-----------------------------%---|-------------------------%---------------------|-------------------------------------|---
----------|-------t-------|-----------------------------|---|-------------------------|---------------------|------------------------g------------|---
--------%-|--%----%-------|-%------------%---%%%--%----%|---|-%------%----------------|%--------------%-----|-------------------------------------|--%
--------|-|--|----|%%-----|-|----------%%|-%-|||%-|%%%-||---|-|---%--|----------------||-----%--------|-----|---------------%---------------------|--|
%%%%%%%%|-|%%|%---|||---%-|-|--%%--%--%|||%|-||||-||||-||---|-|%%-|--|-------%%%------||-----|----%%--|-----|---%-----------|---------------------|--|
|||||||||X|||||---|||XX-|X|X|XX||XX|-X||||||X||||X||||X||X-X|X|||-|XX|XXXXXXX|||XXXXXX||-XX-XXXXXX||XX|-XX--|XXX|XXXXXXXXXXX|XXXXXXXXXXXXXXXXXXXXX|--|