------------------------------------------------------------------------------------------------------------------------------------------------------
------------------------------------------------------------------------------------------------------------------------------------------------------
------------------------------------------------------------------------------------------------------------------------------------------------------
------------------------------------------------------------------------------------------------------------------------------------------------------
------------------------------------------------------------------------------------------------------------------------------------------------------
------------------------------------------------------------------------------------------------------------------------------------------------------
------------------------------------------------------------------------------------------------------------------------------------------------------
----------------%-------------------------------------------------------------------------------------------------------------------------------------
----------------|--------------------------------------------------------------------------------------------------------------------------------%----
----------------|----------------------------------------------------------------------------------------%---------------------------------------|----
----------------|---------------------------------------------%------------------------------------------|------------------%--------------------|----
----------------|---------------------------------------------|------------------------------------------|------------------|--------%------%----|----
----------------|---------------%-U------%--------------------|%----------%-%-%-----------%-----------%%-%---------%-%%----%|--------|------|--%-|----
---------------%|--%-%----------|--------|--------------------||--%-------|-|-|%----%-----|-----------||-|-%-------|-||%---||---%----|--%--%|--|-|----
%%%%%%%%-------||--|-|%%%-------|-------%|----%---------------||--|------%|-|-||----|-----|%%---------||-|%|%--%%--|-|||---||---|----|--|--||--|-|----
||||||||XXXXXX-X|XX|X||||XXX---X|XXXXX-X||XXXX|XXXXXXX--XXXX--||X-|XXXXXX||X|X||XXXX|XXXXX|||XXXXXXXXX||-||X|XX||XX|X|||X--||-XX|XXXX|X-|-X||XX|X|XXXX