------------------------------------------------------------------------------------------------------------------------------------------------------
------------------------------------------------------------------------------------------------------------------------------------------------------
------------------------------------------------------------------------------------------------------------------------------------------------------
------------------------------------------------------------------------------------------------------------------------------------------------------
------------------------------------------------------------------------------------------------------------------------------------------------------
------------------------------------------------------------------------------------------------------------------------------------------------------
------------------------------------------------------------------------------------D-----------------------------------------------------------------
----------------------------------------------------------------------------------------------%-------------------------------------------------------
---------------------------------------------------------------%------------------------------|-------------------------------------------------------
---------------------------------------------------------------|------------------------------|-------------------------------------------------------
-------------------------------%---------------%-------------%-|------------------------------|-------------------------------------------------------
-------------------------------|-%-------------|-%%----------|-|------------------------------|---------------------------%---------------------------
----------------------------%--|-|-%--%-----%--|%||-----%-%%%|-|--%---------%---%%%-%--%%-----|-----------------%----%%---|---------%%S---------------
--------------%-%--%%-------|-%|-|-|--|-%--%|--||||-----|-||||-|--|-%------%|---|||-|--||-----|-----------------|----||---|--%------||---%-%--------%%
%%%%%%%%%-----|-|-%||-------|-||-|-|--|-|--||--||||--%-%|-||||-|-%|-|------||-%-|||-|-%||-----|-----------------|----||---r--|------||---|-|%%%-%--%||
|||||||||-XXXX|X|X|||XXXXXX-|X||XXX|XX|X|--||XX||XXXX|X||X||||X|-||X|-XX-XX||-|-|||-|X|||--XXX|XXXXXXXXXXXXX--XX|XXXX||XXXXXX|XXXXXX||XX-|X||||X|XX|||