------------------------------------------------------------------------------------------------------------------------------------------------------
------------------------------------------------------------------------------------------------------------------------------------------------------
------------------------------------------------------------------------------------------------------------------------------------------------------
------------------------------------------------------------------------------------------------------------------------------------------------------
------------------------------------------------------------------------------------------------------------------------------------------------------
----------------------------------------------------------------------------------------------D-------------------------------------------------------
------------------------------------------------------------------------------------------------------------------------------------------------------
------------------------------------------------------------------------------------------------------------------------------------------------------
-------------------------------------------------------------------------------------------------------------------------------------%----------------
---------------------------------------------------------------------------------------------------%---------------------------------|----------------
----------------------------------------------------T----------------------------------------------|---------------------------------|----------------
-------------------------------%-------------------%t-----------------------------------------%----|---------------------------------|--%-------------
----------%--------------------|-%%----%-----------|t------%----%-------%-------------%--%%%--|-%--|---%----%------------------%%--%-|--|-----%%%%%-%-
----------|--------------------|-||----|------%U---|t--%---|-%--|-----%-|-%--%%%----%-|--|||--|-|--|---|-%-%|---%--------------||--|-|--%%--%-|||||-|-
%%%%%%%%--|%-----------%%----%-|-||----|--%---|--%-|%--|---|-|--|-----|-|-|--|||----|-|--|||--|-|--|---|%|-||---|-%--%-%%--%---||%-|-|--||--|-|||||-|-
||||||||XXX|XXXXX--X--X||X--X|-|X||-XXX|XX|XX-|XX|X||XXXXXX|X|--|--XX-|X|X|XX|||XX-X|X|X-|||X-|X|-X|---X||X||--X|X|XX|-||XX|-XX|||X|-|X-X|X-|X|||||X|X