------------------------------------------------------------------------------------------------------------------------------------------------------
------------------------------------------------------------------------------------------------------------------------------------------------------
------------------------------------------------------------------------------------------------------------------------------------------------------
------------------------------------------------------------------------------------------------------------------------------------------------------
--------------------------------------------------------------------------------------------------------------------------------------%---------------
--------------------------------------------------------------------------------------------------------------------------------------|---------------
--------------------------------------------------------------------------------------------------------------------------------------|---------------
---------------------------------------------------------------------------S-----S-----------%----------------------------------------|---------------
---------------------------------------------------------------------------------------------|--------------------------------2-------|---------------
---------------------------------------------------------------------------------------------|-------------------------------yg-------|---------------
---------------------------------------------------------------------------------------------|-------------------------------%--------|---------------
------------------%-----------%---------------------------------------------%----%-----------|-------------------------------|--------|---%-----------
------------------|%%-------%-|%---%-----%%%%--------%-----%----------------|--%-|----------%|%-%-----%-%---%%---%-----------|-----%--|---%---------%-
--------%----%----|||---%%--|%||---|%----||||-%------|--%%-|---------------%|--|-|------%%--|||%|---%-|-|%--||---|%------%---%%----|--%---|---------|%
%%%%%%%%|%%--|--%-|||---||--||||%%-||----||||-|-----%|--||-|--%------------||--|-|%%----||-%|||||---|-|-||--||-%-||%----%|%--||----|--|---|---------||
|||||||||||XX|XX|XX||---||XX||||||X||XXXX||X|X|XXXX-||XX||-|XX|XXXX-XXXXXXX|XXX|-|||---X||-||||||-XX|X|X||XX||-|X|||XX--|||XX||XX-X|XX|XXX|XXXXXXX-X||