------------------------------------------------------------------------------------------------------------------------------------------------------
------------------------------------------------------------------------------------------------------------------------------------------------------
------------------------------------------------------------------------------------------------------------------------------------------------------
------------------------------------------------------------------------------------------------------------------------------------------------------
-------------------------------------------------------------------------------------------------------------------S----------------------------------
------------------------------------------------------------------------------------------------------------------------------------------------------
-------------------------------------------------------------------------------------------------------------------g----------------------------------
-------------------------------------------------------------------------------------------------------------------%----------------------------------
-----------------------------------------------r-------------------------------------------------------------------|----------------------------------
-----------------------------------------------%------------%------------------------------------------------------|----------------------------------
------------------------%----------------g-----|------------|------------------------------------------------%-----|----------------------------------
------------------------|----2-----------------|------------|------------------------------------------------|-----|----------------------------------
------------%-%%----%%--|------------%------%%-|----------%%|---------%-----%----%------%---%------%%-----%%-|-----|---------------%------------------
------------|%||%---||--|--------%%--|------||-|----------|||---------|-----|----|------|---|------||-----||-|-----|--%------%-----|%-----------%--%--
%%%%%%%%---%|||||--%||%%|--------||--|-%%%--||-|----------|||---%---%%|----%|%---|-%%---|-%%|----%-||%----||-|--%--|--|%-----|-----||-------%--%|%%|--
||||||||XXX||||||-X||||||XXXXXXXX||XX|X|||XX||X|X-XXXX--XX|||XXX|XXX|||XX-X|X|--X|-||XXX|X|||-X-X|X|||XX-X||X|-X|XX|X-||XXXXX|--XXX||--XX-X-|--|||||XX