------------------------------------------------------------------------------------------------------------------------------------------------------
------------------------------------------------------------------------------------------------------------------------------------------------------
------------------------------------------------------------------------------------------------------------------------------------------------------
------------------------------------------------------------------------------------------------------------------------------------------------------
------------------------------------------------------------------------------------------------------------------------------------------------------
------------------------------------------------------------------------------------------------------------------------------------------------------
---------------------------------------------------------------------------------------------------------------------G--------------------------------
------------------------------------------------------------------------------------------------------------------------------------------------------
------------------------------------------------------------------------------------------------------------------------------------------------------
------------------------------------------------------------------------------------------------------------------------------------------------------
------------------------------------------%----------------------#------------------------------------------------------------------------------------
----------------%-----------------------%-|----------------%-----#---------------------------------------------------%-------%------------%-----------
-------------%%%|---%-----%%------------|-|----%-----------|--%%-#%%-------%%----%-----------------------%%%---------|-----%-|--------%---|--------%--
------------%||||%--|-%---||--------%-%-|-|----|----------%|--||-%||----%--||----|--------%---%-------%%%|||-----%---|---%-|-|%%%%%%--|--%|--------|--
%%%%%%%%%---||||||-%|-|---||--------|-|-|-|----|----------||--||-|||----|--||-%--|--------|---|-----%-||||||-----|---|---|-|-|||||||--|--||%--%%%--|--
|||||||||XXX|||||X-||X|XXX||XXXXXXX-|X|XXX|XXXX|-XXX----XX|X-X||X|||XXXX|-X||-|--|XX-X-XXX|XXX|--XX-|X||||||-XXX-|XXX|XXX|X|-|||||||XX|XX|||--|||--|XX