------------------------------------------------------------------------------------------------------------------------------------------------------
------------------------------------------------------------------------------------------------------------------------------------------------------
------------------------------------------------------------------------------------------------------------------------------------------------------
------------------------------------------------------------------------------------------------------------------------------------------------------
------------------------------------------------------------------------------------------------------------------------------------------------------
------------------------------------------------------------------------------------------------------------------------------------------------------
-------------------------------------------------------------------------------------------------------------------------------%--------------%-------
-------------------------------------------------------------------------------------------------------------------------------|--------------|-------
-----------------------------------------------------------------------------S-------------------------------------------------|--------------|-------
------------------------------------------%---%------------------------------g-------------------------------------------------|--------------|-------
-----------------------S------------------|---|----------------------------------------------------------------------%---------|--------------|-------
---------------#----------%--------------%|---|---%#-----------------------%----g------------------------------------|---------|--------------|t-----%
----------%----%----------|----%---------||--S|---|%------%----------------|--%%-----------%----%%-----%--%----------|---------|--------------|t%--%-|
----------|---%|---%%--%--|----|---------||---|---||------|--%%----%%%-----|-%||-----%-----|---%||--%--|%-|----------|------%%%|----------g---|t|--|-|
%%%%%%%%%%|--%||%%-||--|--|-%--|------%--||---|-%%||-%%---|--||---%|||-%---|-|||----%|--%--|-%%|||--|%-||-%-%%-------|------||||------%-------|%|--|-|
|||||||||||XX|X|||X||XX|--|X|XX|XXXXXX|XX||-XXXX||||X||-X-XXX||X-X||||X|XXX|X|||-XXX|XX-|--XX|||||XX||X||X|X||XXXXXXX|--X--XXXX|----XX|XX-XXXX|||XX|X|