------------------------------------------------------------------------------------------------------------------------------------------------------
------------------------------------------------------------------------------------------------------------------------------------------------------
------------------------------------------------------------------------------------------------------------------------------------------------------
------------------------------------------------------------------------------------------------------------------------------------------------------
------------------------------------------------------------------------------------------------------------------------------------------------------
------------------------------------------------------------------------------------------------------------------------------------------------------
----------------------------------------S-------------------------------------------------------------------------------------------------------------
------------------------------------------------------------------------------------------------------------------------------------------------------
-----------------------%------------------------------------------------------------------------------------------------------------------------------
-----------------------|------------------------------------%-----------------------------------------------------------------------------------------
-----------------------|---------%------%-------------------|------------------------------#--------------------------g-------------------------------
-----------------------|-------%-|------|-------------------|------------------------------#-%--------------------------------------------------------
--------%--------------|------t|%|--%---|%%-%-%---------%---|------%---------------------%%%-|------------------%------------%------------------------
--------|---%---------%|-----%t|||--|---|||-|%|--%-----%|---|------|------------------%--|||-|-----------%---%--|------%%----|----------%%-%-----%-%--
%%%%%%%%|--%|---------||-----|t|||--|%--|||-|||--|---%%||-%-|-----%|%--%%-----%----%--|--|||-|-%%%--%----|-%%|--%-----%||----|%---------||-|-----|-|-%
|||||||||XX||XXXX-----||XX---|XX||XX||X-|XXX|||X-|XXX||||-|X|XX-XX|||XX||XXXXX|XX--|XX|X-|||-XX|||XX|XXXX|-|||-X|X-X--|||-X--||XXXXXXX-XX|-XXXXXX|-|X|