------------------------------------------------------------------------------------------------------------------------------------------------------
------------------------------------------------------------------------------------------------------------------------------------------------------
------------------------------------------------------------------------------------------------------------------------------------------------------
------------------------------------------------------------------------------------------------------------------------------------------------------
------------------------------------------------------------------------------------------------------------------------------------------------------
---------------------------------------------------------------------------------------------------------------------------------%--------------------
----------------------%----------------------------------------------------------------------------------------------------------|--------------------
----------------------|----------------------------------------------------------------------------------------------------------|--------------------
----------------------|------------------------------------%---------------------------------------------------------------------|--------------------
----------%-----------|------------------------------------|---%-----------------------------------------------------------------|--------------------
----------|-----------|------%-----------k%----------------|---|-----------------------------------------------------------------|------------%-------
----------|-----------|------|--%%--------|----------------|---|--------------------------------%--------------------------------|------------|-------
----------|---%-%---%%|------|--||--------|-%--------------|---|---%----------------------------|-----%-%%%%--%----%-------%-----|------------|-------
----------|---|-|---|||--%---|--||%--%----|-|%-----------%-|---|--%|%--------%------U----%%%----|%%-%-|-||||--|----|-------|%%-%-|-%----------|-------
%%%%%%%%%%|---|-|---|||%%|-%-|--|||--|--%%|-||-----------|-|%--|%-|||------%%|-%---------|||----|||%|-|%||||-%|----|---%--%|||-|-|-|%%--------|---%%--
|||||||||||XXX|X|---||||||-|-|--|||-XXXX|||XX|-XXXXXXXXXX|X||XXX|X|||--XXXX||XX|XX-XX-XXX|||X---X||||X||||||X||XXXX|--X|XX||||-|X|X|||---XXXXX|XX-||XX