------------------------------------------------------------------------------------------------------------------------------------------------------
------------------------------------------------------------------------------------------------------------------------------------------------------
------------------------------------------------------------------------------------------------------------------------------------------------------
------------------------------------------------------------------------------------------------------------------------------------------------------
---------------t--------------------------------------------------------------------------------------------------------------------------------------
---------------t----------k---------------------------------------------------------------------------------------------------------------------------
---------------%------D---%----------------------------%----------------------------------------------------------------------------------------------
---------------|----------|----------------------------|----------------------------------------------------------------------------------------------
---------------|----------|----------------------------|---------------------------------------------------------S------------------------------------
---------------|------%---|----------------------------|----------------------S---------------------------%-------------------------------------------
---------------|------|---|----------------------------|--------------------------------------------------|-------------------------------------------
---------------|-%----|---|----------------------%-----|----------------------------------%---------------|------%---------%--------------------------
---------------|%|----|%--|-------%--------------|%----|%-%%--%--%------------------------|%------%-------|------|---------|-------%-------%%---------
---------%-----|||----||-%|%------|---%%---%-----||----||-||--|%-|----%---------%---------||------|---%-%-|---%--|---------|-------|-------||%--%%----
%%%%%%%%-|-----|||%%%-||%|||------|---||--%|%%%%-||-%--||-||-%||-|-%--|%%------%|%-%%%----||------|---|-|%|---|--|--%------|-------|-------|||%-||----
||||||||-|-XXX-||||||-||||||X-XXXX|XXX||-X||||||X||X|-X||-||X|||X|X|--|||XXX--X|||-|||XXXXXXX----X|-XX|X|||XXX|XX|XX|-XXXX-XXXXXXXXXXXXX-XX||||X||XXXX