------------------------------------------------------------------------------------------------------------------------------------------------------
------------------------------------------------------------------------------------------------------------------------------------------------------
------------------------------------------------------------------------------------------------------------------------------------------------------
------------------------------------------------------------------------------------------------------------------------------------------------------
------------------------------------------------------------------------------------------------------------------------------------------------------
--------------------------------------------------------------------------------------------D---------------------------------------------------------
------------------------------------------------------------------------------------------------------------------------------------------------------
------------------------------------------------------------------------------------------------------------------------------------------------------
------------------------------------------------------------------------------------------------------------------------------------------------------
--------%---%-------------------------------------------------------------------------C------------------------------------------t-----%--------------
--------|---|----------------------------------------------%------------------------%-----------------------------------------%--t-----|--------------
--------|---|------------------%%--------------------------|------------------------|-------%-----%---------------------------|--t----%|--------------
--------%-%%|%-----%-%---------||--%----------------------%|---------------%--------|--%----|%----|-------------------%-------|-%%----||-%---------%--
--------|-||||---%-|-|---------||%%|--------%%%%%-----%%%-||-%---%%-------%|--------|--|%---||----|--%-----%----------|-------|-||-%--||-|--%----%-|--
%%%%%%%%|-||||---|-|-|---------|||||--------|||||-----|||-||-|---||---%%%-||-%%--%%-|--||-%%||-%%%|--|-----|----------|-------|-||%|-%||%|--|----|-|%%
|||||||||-||||XXX|X|X|XXX-XXXXX|||||XXXXXXXX|||||XX--X|||-||-|XXX||XXX|||-X|X||XX||-|XX||X||||-||||--|XXXXX|XXXXXXX--X|XXXXXXX|X||||X||||X--|-X-X|X|||