------------------------------------------------------------------------------------------------------------------------------------------------------
------------------------------------------------------------------------------------------------------------------------------------------------------
------------------------------------------------------------------------------------------------------------------------------------------------------
------------------------------------------------------------------------------------------------------------------------------------------------------
------------------------------------------------------------------------------------------------------------------------------------------------------
------------------------------------------------------------------------------------------------------------------------------------------------------
------------------------------------------------------------------------------------------------------------%-------------------------%---------------
------------------------------------------------------------------------------------------------------------|----%--------------------|---------------
------------------------------------------------------------------------------------------------------------|----|--------------------|---------------
-----------------------------------------------------------------------------------------------------------S|----|--------------------|---------------
---------------------------------k---------------------------------------------%-----------------S----------|----|--------------%-----|---------------
-----------------------------------------------------------------------------%%|----------------------k-k---|----|--------------|-----|---------------
----------------%-------%%-----%--------------g-------------------%----------|||---%------------------%%|---|---%|--------------|-----|--------------%
----------------|-------||-----|---%%%--%--%-------------%----%-%-|----------|||---|-------%--------%-|||--%|%%-||%%-------%%---|-%---|---%----------|
%%%%%%%%--------|-----%-||-----|-%-|||--|--|--%-----%----|----|%|%|-----%----|||%%%|-------|-%---%%-|-|||--||||-||||------%||%--|-|%%-|%-%|---------%|
||||||||XX-XXXXX|XXXXX|X||-XXXX|X|-|||-X|X-|XX|XXX-X|XXXX|XXXX|||||XXXXX|XXXX|||||||XX-XX-X|X|X-X||X|-|XX-X||||-||||-XX--X||||-X|X|||X||X||XXXXXXXXX||