------------------------------------------------------------------------------------------------------------------------------------------------------
------------------------------------------------------------------------------------------------------------------------------------------------------
------------------------------------------------------------------------------------------------------------------------------------------------------
------------------------------------------------------------------------------------------------------------------------------------------------------
---------------------------------------------------------------------------S--------------------------------------------------------------------------
-----------------------------------------------------t-----------------------------------------------------------------------%------------------------
-----------------------------------------------------t-----------------------------------------------------------------------|------------------------
-----------------------------------------------------t-----------------------------------------------------------------------|------------------------
-----------------------------------------------------%-----------------------------------------------------------------------|-------------------%----
--------------------%--------------------------------|--------------S------%---------%---------------------------------------|-------------------|----
--------------------|--------------------------------|--------%------------|---------|---------------------------------------|-------------------|----
------------%-------|--------------------%----------%|--------|------------|---------|-------------%%------------------%-----|--------------2----|----
------------|-------|%%----------%%------|---%-%----||--------|----%-------|----%%%--|---------%---||--------%-------%-|-%%-%|-----%-------------|----
------------|-------||%-%----%---|%----%-|---|-|%---|%%--%%---|--%-|-------|%---|||-%|-------%-|---||--%-----|-------|-|-||-||--%%-|---%--%------|----
%%%%%%%%%-%-|------%|||%|----|---||----|-|---|-||---|||--||%--|--|-|%----%%%|---|||-||-------|-|---||--|%%---|---%---|-|-||-||-%||%|-%%|--|---%-%|----
|||||||||X|XXXXXXXX|||X||XXXX|XXXXXXXX-|XXXXXXX||XXX|||-X|||-X|XX|X||XX--||||XX-|||X||XX--XXX|-|XX-XX-X|||XXX|XXX|X-X|X|X||-||X|||||X|||-X|XXX|-||XXXX