------------------------------------------------------------------------------------------------------------------------------------------------------
------------------------------------------------------------------------------------------------------------------------------------------------------
------------------------------------------------------------------------------------------------------------------------------------------------------
------------------------------------------------------------------------------------------------------------------------------------------------------
------------------------------------------------------------------------------------------------------------------------------------------------------
------------------------------------------------------------------------------------------------------------------------------------------------------
------------------------------------------------------------------------------------------------------------------------------------------------------
------------------------------------------------------------------------------------------------------------------------------------------------------
-------------------------------------------------------------------------------------------------------------------------------------------%----------
-------------------------------------------------------------------------------------------------------------------------------------------|----------
--------------------------------%----------------------------------------------------------------------------------------------------------|----------
--------------------------------|-------------%%-------------------------------------------------------------------------K-----------------|-------%--
----------%--------%%-----------|------%--%---||%--%----------------------------------------%---------------%----------%-%--------------%--|-------|%-
----------|--------||-------%--%|------|--|--%|||--|%---------%-----------------------------|-%-------%-----|----------|%|---------%----|--|-------||-
%%%%%%%%--|--------||--%----|--||------|--|--||||--||%----%---|----------%------------------|-|-------|-----|---%%%----|||---------|----|--|%-%%--%||-
||||||||X-|XXXXXX-X|XX-|-XXX|X-||XXXXXX|XX|XX|XX|--|||XXXX|XXX|-XXXXXXXXX|XXXXXXXXXXX--XX--X|X|XX--XXX|XXXXX|---|||XXXX||XXXXXX----|X--X|XX||-||XX|||-