------------------------------------------------------------------------------------------------------------------------------------------------------
------------------------------------------------------------------------------------------------------------------------------------------------------
------------------------------------------------------------------------------------------------------------------------------------------------------
------------------------------------------------------------------------------------------------------------------------------------------------------
------------------------------------------------------------------------------------------------------------------------------------------------------
-----------------------------------%------------------------------------------------------------------------------------------------------------------
-----------------------------------|------------------------------------------------------------------------------------------------------------------
-----------------------------------|------------------------------------------------------------------------------------------------------------------
-----------------------------------|------------------------------------------------------------------------------------------------------------------
---------------%%%%----------------|-----------------------------------------t------------------------------------------------------------------------
-------------%-||||----------------|-----%-------r----------------%----------T--------------------------------------------------------S---------------
-------------|-||||----------------%---g-|-------%----------------|----------t------------------------%-%-%-------------------------------------------
--------%-%--|%||||------%---------|%----|-----%-|--------------%-|---%%-----%--------%--%-------%--%-|-|-|%-----------------------%%------%------%---
--------|%|--||||||---%--|--%------||----|-----|%|--------------|-|---||-----|----%---|--|------%|-%|-|-|%||-------%--------%--%---||------|------|---
%%%%%%%%|||%-||||||---|--|-%|-%%-%-||%--%|%%%%%|||--------------|-|---||---%-|%%%-|%--|--|------||%||%|-||||%------|--------|--|--%||-%-%%%|%--%--|---
||||||||||||X||||||XXX|XX|X||X||X|X|X|XX||||||||||XXXXXXX--XX---|X|XX-X|XX-|X||||-||--|--|XXXXX-||||||XX||X||---X--|XXXXXXXX|XX|--|||X|X|||||-X|XX|--X