------------------------------------------------------------------------------------------------------------------------------------------------------
------------------------------------------------------------------------------------------------------------------------------------------------------
------------------------------------------------------------------------------------------------------------------------------------------------------
------------------------------------------------------------------------------------------------------------------------------------------------------
------------------------------------------------------------------------------------------------------------------------------------------------------
------------------------------------------------------------------------------------------------------------------------------------------------------
------------------------------------------------------------------------------------------------------------------------------------------------------
------------------------------------------------------------------------------------------------------------------------------------------------------
----------------------S-------------------------------------------------------------%-%---------------------------------------------------------------
----------------------------------------------------------------------------%-------|-|---------------------------------------------------------------
-------------------------------------------%--------------------------------|-------|-|---------------------------------------------------------------
----------------------------------%--------|-------------%------------------|-------|-|------------------------------------------------%--------------
----------------------%----%%----%|--------|------%------|-%-%-----%----%%--|-------|-|--------%%%--%-----%--%%--------%%----%---%--%--|-------%---%--
--------%-------------|-%--||-%%-||----%--%|------|------|-|-|---%%|----||--|--%----|-|------%-|||--|-----|--||--------||----|%--|--|--|-------|---|--
%%%%%%%%|-%--%%%%--%--|-|--||-||-|%----|--||%-----|------|-|%|---|||----||--|--|-%%-%-|------|%|||--|%%--%|--||--------||%---||--|%-|%-|-------|---|--
|||||||||-|XX||||XX|X-|X|XX||X||X||XX-X|-X|||XXX-X|XXXXXX|-|||--X|||XXXX||-X|XXXX||X|X|XXXXXX|||||XX|||--||XX||X-XXXXXX|||X-X||XX||X||XXX-XXXXX|XXX|XX