------------------------------------------------------------------------------------------------------------------------------------------------------
------------------------------------------------------------------------------------------------------------------------------------------------------
------------------------------------------------------------------------------------------------------------------------------------------------------
------------------------------------------------------------------------------------------------------------------------------------------------------
---------------------------------------------------------------------------------------------------------------------------------------------------#--
---------------------------------------------------------------------------------------------------------------------------------------------------%--
---------------------------------------------------------------------------------------------------------------------------------------------------|--
---------------------------------------------------------------------------------------------------------------------------------------------------|--
----------------------------------------------------%---------------------------------------------------------------%------------------------------|--
----------------------------------------------------|---------------------------------------------------------------|----------------------------%-|--
----------------------------------------------------|-------------------%-------------------------------------------|----------------------------|-|--
----------------------------------------------------|-------------------|----%----------------%---------------------|----------------------------|-|--
--------------%%--------%-%-%-%%--------%-----------|----%-%-----%------|---%|------%---------|----------------%----|---%--%%----------%---------|-|--
---------%----||--------|-|-|%||--------|--------%--|-%%-|-|-----|------|---||%-----|------%--|--------%%----S-|----|---|--||----------|-%%---%--|-|--
%%%%%%%%-|%---||%%%-%---|%|%||||-%%-----|%----%-%|%%|-||-|-|-----|%---%%|---|||-----|---%--|--|-----%%%||-----%|-%%%|--%|--||--%%-%%%%-|%||---|--%-|--
||||||||X||XXX|||||X|XXX||||||||-||XXX-X||XX-X|X|||||X||X|X|XXXXX||XXX|||XXX|||XXXXX|XXX|XX|-X|-XXXX|||||XXXXX||-||||XX||--||-X||-||||X||||XXX|--|-|X-