------------------------------------------------------------------------------------------------------------------------------------------------------
------------------------------------------------------------------------------------------------------------------------------------------------------
------------------------------------------------------------------------------------------------------------------------------------------------------
------------------------------------------------------------------------------------------------------------------------------------------------------
--------------------------------------S-------------------------------------------------------------------S-------------------------------------------
------------------------------------------------------------------------------------------------------------------------------------------------------
-------------------------------------------------------------S---C------------------------------------------------------------------------------------
----------------------------------------------------------------------------------------------------------%-------------------------------------------
--------------------------------------%----------------------t--------------------------------------------|-------------------------------------------
-------------------------%------------|----------------------t-%------------------------------------------|-------------------------------------------
-------------------------|------------|------------------%---%-|%%----------------------------------------|----------------------%--------------------
------------------C------|---%--------|------------------|---|-|||----------------------------------------t---------------------%|-----------------G--
-----------%----%--------|---|--------|-%----------------|---|-|||-----%----------------------------------t---%-%--%%--%--------||---------------%-%--
-----------|----|----%-%-|---|-%------|-|-%-----%----%---|---|-|||--%--|%%-------------------%%--%g-------%---|-|--||--|--%-----||-----%-%-------|-|--
%%%%%%%%%%%|%%--|---%|%|-|-%-|-|------|-|-|-----|----|---|---|%|||%%|--|||--%%--%------------||--|-%%--%%%|%-%|-|--||--|%%|-----||-%%--|-|-------|-|--
||||||||||||||XX|XXX||||X|-|X|X|XXXXXX|X|X|XXXX-|XXXX|XXX|--X||||||||XX|||XX||X-|-XXXX--XXXXX||XX|-||XX|||||X||-|-X||X-||||X-XX-X|X||X-|X|X--XXXX|X|XX