------------------------------------------------------------------------------------------------------------------------------------------------------
------------------------------------------------------------------------------------------------------------------------------------------------------
------------------------------------------------------------------------------------------------------------------------------------------------------
------------------------------------------------------------------------------------------------------------------------------------------------------
------------------------------------------------------------------------------------------------------------------------------------------------------
------------------------------------------------------%---%-D-----------------------------------------------------------------------------------------
------------------------------------------------------|---|-------------------------------------------------------------------------------------------
---------------------------------------%--------------|---|-------------------------------------------------------------------------------------------
---------------------------------------|--------------|---|-------------------------------------------------------------------------------------------
---------------------g-----------------|--------------|---|---------------------------------------------------------------------%---------------------
---------------------|-----------------|--------------|---|---------------------------------------------------------------------|--------------------%
---------------------|-----------------|--------------|---|%%-----------------------------------------%-------------------------|--------------------|
---------------------|----%------------|-----------%--|---|||-%---------%-----------------%--%--------|--------%-%%------------%|%-%--------%--------|
--------------------%%----|------------%-----------|--%--%|||-|---%-----|%%--%---%-%%-%%--|--|--------|---%----|-||------------|||-|--------|----%---|
%%%%%%%%----%-------||----|-----%------|-----%----%|--|%%||||-|%%-|%----|||--|---|%||-||-%|--%--%-----|--%|----|-||%%----%-----|||-|--------|%%%%|%--%
||||||||XX--|XXXX-XX||--XX|XX---|X--X--|X--XX|-XXX||X-|||X|||X|||-||--XX|||XX|XXX||||-||X||XX|XX|XXXXX|X-||XXXXXX||||XXXX|XX-XX|||-|XXXXX-XX|||||||XX|