------------------------------------------------------------------------------------------------------------------------------------------------------
------------------------------------------------------------------------------------------------------------------------------------------------------
------------------------------------------------------------------------------------------------------------------------------------------------------
------------------------------------------------------------------------------------------------------------------------------------------------------
------------------------------------------------------------------------------------------------------------------------------------------------------
-------------------------------------------------------------------------------------------------------------------------------------------------%----
-------------------------------------------g-----------------------------------------------------------------------------------------------------|----
-------------------------------------------S-----------------------------------------------------------------------------------------------------|----
-------------------------------------------------------------------------------------------------------------------------------------------------|----
-------------------------------------------------------------------------------------------------------------------------------------------------|%---
------------------------------------------------------------------------------------%----------------%-------------------------------------------||---
--------------%----g--%-%-----------------%-----------------------------------------|--r-------------|--------------------%%---SS----------------||---
----------#---|-------|-|-----------------|----------------%-----------------%----%-|--%-------------|---%---%%%---%------||-------#-------------||-%-
----------%---|------#|-|-%------%--------%%--------------%|-----%-%---------|%%%-|-|--|-------------|---|---|||--%|--%%--||-------#-------------||-|-
%%%%%%%%%-|---|-%----%|-|-|---%%-|-----%--||--------------||-%%-%|-|--%%%--%-||||-|-|%-|-%%%---------%---|---|||--||--||--||-----%%%-------%%----||-|-
|||||||||-|XXX|-|XXXX||XXX|XX-||X|XXXX-|-X||X--X---XXXXXXX||X||X||X|XX|||XX|X||||X|X||-|X|||XXXXXXXX-|XXX|--X|||-X||XX||XXX|XXXXX|||--X-XXX||-X-X||X|X