------------------------------------------------------------------------------------------------------------------------------------------------------
------------------------------------------------------------------------------------------------------------------------------------------------------
------------------------------------------------------------------------------------------------------------------------------------------------------
------------------------------------------------------------------------------------------------------------------------------------------------------
------------------------------------------------------------------------------------------------------------------------------------------------------
---------------------------------------------------------------%-------------------------------------------------------------------------S---------%--
---------------------------------------------------------------|-----------------------------------C-----------------------------------------------|--
---------------------------------------------------------------|-----------------------------------------------------------------------------------|--
---------------------------------------------------------------|-------------------------------------------------------------------D-----t---------|--
---------------------------------%-----------------------------|-------------------------------------------------------------------------t---------|--
---------------------------------|-----------------------------|------------------%----------C-----%-------------------------------------%---------|--
---------------------------------|-----------------%%--------%-|------------------|----------------|-------------------------------------|---------|--
------------------------%--%-%---|-%-%-------------||--------|-|-%%---%--%------%%|--%--%----------|--------------------------%----%---t-|%--------|-%
--------%------%%------%|--|-|---|%|-|-%-----------||--------|%|-||---|--|------|||--|--|--%------%|--------------------------|----|---t-||--------%-|
%%%%%%%%|------||%-----||--|-|%--|||-|-|-----------||-------%|||-||---|--|------|||--|--|--|-%---%||%%----%--%%---------%%%---|----|---t-||--------|-|
|||||||||XXXXXX|||-XXXX||X-|X||--|||X|X|XX-XXXXXXXX||XX--XXX||||-||XXX|XX|X-XXXX|||XX|XX|XX|X|XXX|||||-XXX|XX||XXXXXXXX-|||--X|-XXX|XXXX-|XXXX-XXXX|X|