------------------------------------------------------------------------------------------------------------------------------------------------------
------------------------------------------------------------------------------------------------------------------------------------------------------
------------------------------------------------------------------------------------------------------------------------------------------------------
------------------------------------------------------------------------------------------------------------------------------------------------------
------------------------------------------------------------------------------------------------------------------------------------------------------
------------------------------------------------------------------------------------------------------------------------------------------------------
-------------------------------------------------------------------------------%----------------------------------------------------------------------
-------------------------------------S----t------------------------------------|----------------------------------------------------------------------
------------------------------------------t------------------------------------|----------------------------------------------------------------------
----------------%-------------------------t------------------------------------|---------------%C---------------t-------------------------------------
----------------|------------------%------%%-%%%%%-----%--%--------------------|---------------|----------------t-------------------------------------
----------------|------------------|-----%||-|||||-----|--|--%-----------------|---------------|----------------t------------------%------------------
----------------|-%----------------|-----|||-|||||-----|--|--|-----------------|----%----------|-----------%%%--%%%--%-%K-%------%-|------%%----------
----------------|-|---------%------|-%-%-|||%|||||-----|--|--|----%-------%%%--%----|%---------|--%--------|||--|||%-|-|%-|------|-|------||--%----%--
%%%%%%%%------%-|-|--------%|%%%%-%|-|-|-|||||||||-----|--|--|----|---%---|||--|----||-------%-|--|---%%---|||--||||-|-||-|----%%|%|---%--||--|----|--
||||||||XXXXXX|X|X|XXXX--XX||||||X||-|X|X|||||||||XXX-X|X-|XX|X-XX|-XX|XXX|||XX|XXXX||XXXXXXX|X|XX|--X||XXX|||X-||||X|X||X|-X-X||||XXXX|XX||XX|-XXX|XX