------------------------------------------------------------------------------------------------------------------------------------------------------
------------------------------------------------------------------------------------------------------------------------------------------------------
------------------------------------------------------------------------------------------------------------------------------------------------------
------------------------------------------------------------------------------------------------------------------------------------------------------
------------------------------------------------------------------------------------------------------------------------------------------------------
------------------------------------------------------------------------------------------------------------------------------------------------------
------------%-----------------------------------------------------------------------------------------------------------------------------------------
------------|-----------------------%-----------------------------------------------------------------------------------------------------------------
------------|-----------------------|------------------------------------------------------------------------------%----------------------------------
------------|-----------------------|------------------------------------------------------------------------------|----------------------------------
------------|-----------------------|-----------------------------------------------------------------------%---%--|---------%-%----------------------
------------|-%-----Cg%-----%-------|-----------------------------------------------------------------------|---|gG|---------|-|-%--------------------
------------|-|-------|-----|--%----|----%---%-----%----------%--------------------------------%------------|---||%|----%----|-|-|--%-----------------
------------|-|-%%%--%|--%%-|--|----|---%|---|%%%%-|%%%%------|---------%%------%--------------|------------|%--||||%---|%-%%|-|-|--|----------%%-----
%%%%%%%%--%-|-|-|||--||-%||%|--|----|---||-%%|||||-|||||------|-------%-||-----%|--%----------%|-------%----||--|||||---||%|||-|-|--|----------||-----
||||||||X-|XXXXX|||XX|XX||||XXX|XXXX|XXX||X|||||||X|||||-XXXXX|----X-X|-||XXXXX|XXX|--XX-XXXXX||XXXXXXX|-XX-||X-|X|||-X-||||||X|XXXX|XXXX-XXXX-||X-XX-