------------------------------------------------------------------------------------------------------------------------------------------------------
------------------------------------------------------------------------------------------------------------------------------------------------------
------------------------------------------------------------------------------------------------------------------------------------------------------
------------------------------------------------------------------------------------------------------------------------------------------------------
------------------------------------------------------------------------------------------------------------------------------------------------------
------------------------------------------------------------------------------------------------------------------------------------------------------
------------------------------------------------------------------------------------------------------------------------------------------------------
-------------------------------------------------------------------------------S------------------------------------------------------t---------------
-------------------------------------------------------------------------------------t------------------------------------------------t---------------
-------------------------C-----------------------------------------------------------T------------------------------------------------%---------------
-------------%-------------------------------------------------------------------%---t------------------------------------------------|---------------
-------------|-------%-------------------------%---------------------%-----------|---%------------------------------------------------|---------------
-------------|-------|--------%-t--------------|%--------------------|r----------|---|-%%------------------------------------%%%------|-%--------%----
----------%%%|%-%----|---%----|-t--%%----------||----%%--------------|%--------%%|---|-||-----%--------%-----------%--%%%%%--|||%%%%-%|%|--------|----
%%%%%%%%%-|||||-|----|---|%---|-t--||%---------||%%--||---%%-----%---||-%------|||---|-||-----|--------|---%-%--%--|--|||||--|||||||-||||---%--%-|---%
|||||||||X|||||X|--X-|XXX||XX-|XXXX|||-XXXXXX--||||--||-XX||XXXXX|-XXX|X|------|||XXX|X||X-X--|XX--XXXX|XXX|X|XX|XX|XX|||||XX||X||||X||||---|--|X|XXX|